+-+-+-+-+-+-+-+
|     |     | |
+ +-+ +-+ + + +
| |   |   |   |
+-+-+ + +-+ +-+
|   |   |     |
+ + +-+-+ +-+-+
| |   | | |   |
+-+ + + + + +-+
| | |     |   |
+ +-+ +-+-+ +-+
|   |       | |
+-+ +-+ + + + +
|       | |   |
+-+-+-+-+-+-+-+