+-+-+-+-+-+-+-+-+-+-+-+-+-+-+-+-+-+-+-+-+
|     |   | | | | | |         |     |   |
+-+-+ +-+ + + + + + + +-+-+-+-+ +-+-+ +-+
|                   |       |       |   |
+-+ +-+ +-+-+-+ + + +-+ + +-+ +-+-+-+ +-+
| | | | |     | | | |   |     |     |   |
+ + + + + +-+-+-+-+-+ +-+-+-+ + +-+-+ +-+
|     |     |       | |         |       |
+-+ +-+ +-+-+ +-+ + +-+ +-+ +-+ + + + + +
|   |   | |     | | |     |   |   | | | |
+-+ +-+ + +-+ +-+-+ + +-+-+ + +-+ +-+-+ +
|   |         |       | |   |   |   |   |
+-+ +-+ +-+ +-+ +-+ + + +-+-+-+ + + +-+-+
| | | | |   |   | | |   |   | | | | | | |
+ + + +-+ +-+-+ + + +-+ + +-+ +-+ +-+ + +
|   |   |   | | | |   |   |           | |
+-+-+ + + +-+ +-+ + +-+-+-+ + + +-+ +-+ +
| |   | |   |       |   |   | |   |     |
+ +-+-+ + +-+ +-+-+ +-+ +-+-+-+ + + +-+ +
|   |     |   |     | | |     | | | |   |
+ +-+-+ +-+ +-+-+-+ + + + + +-+ +-+ +-+ +
|     | |   | |   |     | |   |   |   | |
+-+ +-+-+-+ + +-+ +-+ + +-+-+ +-+-+ +-+ +
| | |             | | | |   |   |   |   |
+ + +-+ +-+-+-+ + + + +-+-+ + +-+ +-+ +-+
|       |   |   |   |   |       | |   | |
+-+ +-+-+-+ +-+-+-+-+-+-+ + +-+ +-+ +-+ +
| |   |   |   |     | |   | |   | | | | |
+ + + +-+ +-+ +-+ +-+ + +-+ +-+-+ + + + +
|   | |   |       |   |   | | |       | |
+ + +-+ +-+ +-+ +-+ + + + +-+ +-+ +-+-+ +
| |     |     |   | |   |   |     |   | |
+-+ + + + +-+ +-+ +-+-+ +-+-+ + + + +-+ +
| | | |   |     | |   |   |   | | |     |
+ +-+-+-+ + +-+ +-+ +-+ + +-+ +-+-+-+ + +
|         |   |     | | | |   |     | | |
+ +-+ + +-+-+-+-+-+-+ + +-+-+ +-+ + + + +
| | | |       |           | |   | |   | |
+ + +-+ + +-+ + +-+-+-+ + + +-+ +-+-+ + +
|   |   | |       |     |   |         | |
+-+-+-+-+-+-+-+-+-+-+-+-+-+-+-+-+-+-+-+-+