+-+-+-+-+-+-+-+-+-+-+-+-+-+-+-+-+-+-+-+-+-+-+-+-+-+-+-+-+-+-+-+-+-+-+-+-+-+-+-+-+-+-+-+-+-+-+
|                                                                                           |
+ +-+-+ +-+-+ + + +-+ + + +-+ +-+-+ + + +-+ + +-+ + +-+ + + +-+-+-+-+ + + +-+-+ +-+ + + + + +
|     |     | | |   | | |   |     | | |   | |   | |   | | |         | | |     |   | | | | | |
+ +-+-+-+-+ +-+ + +-+-+ +-+-+-+ +-+ +-+-+-+-+-+ + +-+-+-+ +-+-+ +-+-+ +-+-+-+ +-+ +-+ + +-+-+
|         |   | |     |       |   |           | |       |     |     |       |   |   | |     |
+ +-+-+-+-+-+ +-+ +-+-+ +-+ +-+ + +-+ + + +-+ + + + + +-+ +-+-+-+ +-+-+-+ +-+ + +-+ +-+ + + +
|           |   |     |   |   | |   | | |   | | | | |   |       |       |   | |   |   | | | |
+ + + + + +-+ +-+-+-+-+-+-+ + +-+ +-+-+-+ +-+ +-+ + +-+ + + + +-+-+ +-+-+ +-+ +-+-+ + + + +-+
| | | | |   |             | |   |       |   |   | |   | | | |     |     |   |     | | | |   |
+ +-+ + + + +-+-+-+-+ +-+ + + + + +-+ +-+ +-+ +-+-+ +-+-+-+ +-+-+ + +-+ + + +-+ + +-+-+ + +-+
|   | | | |         |   | | | | |   |   |   |     |       |     | |   | | |   | |     | |   |
+ +-+-+-+ +-+ + +-+ + +-+ + +-+-+-+-+-+ + +-+ +-+-+-+ + + +-+-+ +-+-+-+ + +-+ +-+ +-+ + +-+ +
|       |   | |   | |   | |           | |   |       | | |     |       | |   |   |   | |   | |
+ + +-+ + +-+-+-+ + +-+-+ +-+-+-+ + +-+-+ +-+ +-+ +-+ + + + + +-+ + + +-+ + +-+-+ + + +-+ +-+
| |   | |       | |     |       | |     |   |   |   | | | | |   | | |   | |     | | |   |   |
+ + +-+ + + + + + +-+-+ + +-+ + +-+-+ +-+-+-+ +-+-+-+-+-+-+-+-+-+-+-+-+ + +-+ + + + +-+-+-+-+
| |   | | | | | |     | |   | |     |       |                         | |   | | | |         |
+ + + + + +-+-+-+-+-+-+-+-+-+-+-+ +-+ +-+ +-+ +-+ + + +-+ +-+-+ +-+-+-+-+-+ +-+-+ + +-+-+ +-+
| | | | |                       |   |   |   |   | | |   |     |           |     | |     |   |
+ + + +-+-+ + +-+ +-+-+ + + +-+-+ + + +-+-+-+ + +-+-+-+ +-+-+ +-+-+-+-+-+-+-+ +-+-+-+ + + +-+
| | |     | |   |     | | |     | | |       | |       |     |               |       | | |   |
+ +-+-+-+-+ +-+-+ + +-+ +-+ + + +-+ +-+ + + + +-+-+ +-+ + + +-+ + + +-+ + +-+-+-+ + +-+-+-+ +
|         |     | |   |   | | |   |   | | | |     |   | | |   | | |   | |       | |       | |
+ + + +-+-+ +-+-+ + + + +-+-+ + +-+ + +-+-+-+ +-+ +-+ + +-+-+-+-+-+ + +-+ + + + + + +-+ +-+-+
| | |     |     | | | |     | |   | |       |   |   | |           | |   | | | | | |   |     |
+ + +-+-+ +-+ + + + + + + +-+ +-+-+-+-+ +-+ + +-+ +-+ +-+-+-+-+-+ +-+-+ +-+-+ + +-+-+-+-+ +-+
| |     |   | | | | | | |   |         |   | |   |   |           |     |     | |         |   |
+ + +-+-+ + +-+ +-+-+-+-+-+ + +-+ + + +-+ +-+ +-+ + + +-+ + + + +-+-+-+ + +-+ +-+ +-+-+ +-+-+
| |     | |   |           | |   | | |   |   |   | | |   | | | |       | |   |   |     |     |
+ + +-+-+ +-+ +-+-+ + +-+ + +-+ +-+-+-+ +-+-+ + + + +-+-+-+ +-+ + + +-+ + +-+ + +-+-+-+-+-+ +
| |     |   |     | |   | |   |       |     | | | |       |   | | |   | |   | |           | |
+ + +-+ + + + +-+-+ + + +-+-+-+ + +-+-+ + + +-+ + +-+-+-+ + + + +-+-+-+ +-+ +-+ +-+-+ + + +-+
| |   | | | |     | | |       | |     | | |   | |       | | | |       |   |   |     | | |   |
+ + + + +-+-+-+-+ +-+ +-+-+-+ +-+-+ + +-+ + +-+-+ + +-+-+-+-+ + +-+ + +-+-+ +-+-+ + + +-+-+ +
| | | |         |   |       |     | |   | |     | |         | |   | |     |     | | |     | |
+ +-+ + +-+ + +-+ +-+ + + + +-+-+ +-+-+ +-+-+-+ + +-+-+ + +-+-+ +-+-+ + +-+ +-+-+-+-+ +-+ +-+
|   | |   | |   |   | | | |     |     |       | |     | |     |     | |   |         |   |   |
+ + + + + +-+ + +-+ +-+ + +-+ + + +-+-+-+ +-+ + +-+-+-+ + + + + + + + + + + +-+-+-+ +-+ + +-+
| | | | |   | |   |   | |   | | |       |   | |       | | | | | | | | | | |       |   | |   |
+ + +-+-+ +-+ + + +-+ + + +-+ + + + +-+-+ +-+ + + + +-+-+ + +-+-+-+ +-+-+ + + +-+-+-+ + +-+-+
| |     |   | | |   | | |   | | | |     |   | | | |     | |       |     | | |       | |     |
+ + + +-+-+ +-+ +-+ + +-+ +-+-+-+ +-+-+-+ +-+-+-+-+-+ + +-+-+-+-+ + + +-+ +-+ + + +-+-+ + + +
| | |     |   |   | |   |       |       |           | |         | | |   |   | | |     | | | |
+ +-+ + + +-+ + + +-+ + + +-+-+-+ +-+-+-+-+-+-+ +-+ +-+ +-+-+ + +-+-+-+ +-+-+-+ +-+-+-+ +-+-+
|   | | |   | | |   | | |       |             |   |   |     | |       |       |       |     |
+ +-+-+ +-+ +-+ +-+ +-+-+ + +-+-+-+-+-+-+ + + + +-+-+ + + + +-+ + +-+ +-+ +-+-+ + +-+-+ + +-+
|     |   |   |   |     | |             | | | |     | | | |   | |   |   |     | |     | |   |
+ +-+ + +-+ + + +-+ + + + + +-+-+ + +-+ +-+ +-+ + + + +-+ + + +-+-+ +-+ +-+ + + +-+-+ + +-+-+
|   | |   | | |   | | | | |     | |   |   |   | | | |   | | |     |   |   | | |     | |     |
+ +-+-+-+-+ + + + + +-+ +-+ + +-+ +-+-+-+ +-+-+ + +-+ + +-+ + +-+-+-+ + + +-+ +-+-+ +-+ + +-+
|         | | | | |   |   | |   |       |     | |   | |   | |       | | |   |     |   | |   |
+ +-+ +-+ + + + +-+-+ +-+ + +-+ +-+ +-+ + + +-+-+ +-+-+-+ + + + + +-+-+-+ +-+-+-+ + +-+-+-+-+
|   |   | | | |     |   | |   |   |   | | |     |       | | | | |       |       | |         |
+ +-+-+-+ +-+ +-+ + +-+-+-+ +-+ +-+-+-+ + +-+ +-+-+-+-+-+-+ + + +-+-+-+-+-+-+-+ +-+ +-+-+-+-+
|       |   |   | |       |   |       | |   |             | | |               |   |         |
+ +-+ +-+-+ +-+ +-+ +-+ +-+-+ + + +-+-+-+ +-+ + +-+ + + +-+ +-+-+-+-+-+ +-+ +-+ + +-+ +-+ +-+
|   |     |   |   |   |     | | |       |   | |   | | |   |           |   |   | |   |   |   |
+ +-+ +-+-+-+-+-+-+ +-+-+ + + + +-+-+-+-+ +-+-+-+ + +-+ + +-+-+ + + +-+-+-+ +-+ + +-+-+-+-+-+
|   |             |     | | | |         |       | |   | |     | | |       |   | |           |
+ +-+ + + + + + +-+-+-+ +-+ + +-+ + + + +-+ + + +-+ +-+ + +-+-+ +-+ + +-+-+-+-+ +-+ + + + +-+
|   | | | | | |       |   | |   | | | |   | | |   |   | |     |   | |         |   | | | |   |
+ + + +-+-+ +-+ +-+ + +-+-+ + +-+ +-+ + +-+ +-+ + + +-+ + + +-+-+ + +-+ + + + + +-+-+-+-+-+-+
| | |     |   |   | |     | |   |   | |   |   | | |   | | |     | |   | | | | |             |
+ + + +-+ +-+-+-+ +-+ +-+ +-+-+-+-+-+ +-+-+ +-+-+ + + + +-+-+ + + +-+-+ + + +-+-+ +-+-+-+ +-+
| | |   |       |   |   |           |     |     | | | |     | | |     | | |     |       |   |
+ + + +-+-+ +-+-+-+ +-+-+-+-+-+-+-+-+-+ +-+ +-+ +-+ +-+ +-+ + +-+ + +-+-+-+-+ +-+ + +-+-+-+-+
| | |     |       |                   |   |   |   |   |   | |   | |         |   | |         |
+ + +-+ + + + +-+-+-+-+-+ +-+ +-+-+ +-+ +-+ + +-+ +-+-+-+-+-+ +-+-+-+-+-+-+ + +-+-+ +-+ +-+-+
| |   | | | |           |   |     |   |   | |   |           |             | |     |   |     |
+ +-+-+ + +-+ + +-+-+-+ + + +-+ + +-+ + +-+ + + + + +-+ +-+-+ + + +-+ +-+-+-+ +-+-+ + +-+ + +
|     | |   | |       | | |   | |   | |   | | | | |   |     | | |   |       |     | |   | | |
+ +-+ +-+-+-+ + + + +-+ + +-+ + +-+-+-+-+ +-+-+-+-+ +-+ + + + + +-+-+-+-+ + + +-+ + + +-+-+ +
|   |       | | | |   | |   | |         |         |   | | | | |         | | |   | | |     | |
+ + +-+ + +-+-+ + + + + + + + + + +-+ +-+ + +-+ +-+-+ +-+-+-+-+-+-+-+ +-+-+ + + +-+ +-+ + +-+
| |   | |     | | | | | | | | | |   |   | |   |     |               |     | | |   |   | |   |
+ + + + +-+-+ +-+-+-+-+-+ + + + + + +-+ +-+-+-+-+-+ + +-+ + + + + + +-+-+ +-+-+-+ +-+-+-+ +-+
| | | |     |           | | | | | |   |           | |   | | | | | |     |       |       |   |
+ + +-+-+-+ +-+-+-+-+ +-+-+ + +-+-+-+-+ +-+-+ + + +-+-+-+-+ + + +-+-+ +-+-+ + +-+ +-+ + +-+-+
| |       |         |     | |         |     | | |         | | |     |     | |   |   | |     |
+ + + +-+-+ + + + +-+ + + +-+ + + + + +-+-+-+ + +-+-+-+-+ + +-+-+-+ +-+ +-+-+ + +-+ + + + +-+
| | |     | | | |   | | |   | | | | |       | |         | |       |   |     | |   | | | |   |
+ + + + + +-+ +-+ + +-+-+-+ + + +-+-+-+ +-+-+-+-+ + +-+-+ +-+-+-+ + + +-+-+ + + +-+ + +-+ + +
| | | | |   |   | |       | | |       |         | |     |       | | |     | | |   | |   | | |
+ + + +-+ +-+-+ +-+-+-+ +-+-+ +-+ +-+ +-+ +-+ + + + + + +-+-+-+-+ +-+-+-+ + +-+ +-+-+ + +-+ +
| | |   |     |       |     |   |   |   |   | | | | | |         |       | |   |     | |   | |
+ +-+ +-+-+-+-+ +-+ +-+ +-+-+ + + +-+ +-+-+-+ + + + +-+-+-+ +-+-+-+ + + + + + + +-+ + +-+ + +
|   |         |   |   |     | | |   |       | | | |       |       | | | | | | |   | |   | | |
+ + +-+ +-+-+ +-+ +-+-+-+-+ + + + +-+-+ + + +-+-+-+ +-+ + + +-+-+ + +-+ +-+ +-+ + + + + +-+-+
| |   |     |   |         | | | |     | | |       |   | | |     | |   |   |   | | | | |     |
+ + + +-+ +-+-+ +-+-+ + +-+ +-+-+-+-+-+ + + +-+ +-+ + +-+ + +-+-+ +-+ + + +-+ +-+-+ + + + +-+
| | |   |     |     | |   |           | | |   |   | |   | |     |   | | |   |     | | | |   |
+-+-+-+-+-+-+-+-+-+-+-+-+-+-+-+-+-+-+-+-+-+-+-+-+-+-+-+-+-+-+-+-+-+-+-+-+-+-+-+-+-+-+-+-+-+-+