+-+-+-+-+-+-+-+
|             |
+ +-+ + + + +-+
|   | | | |   |
+ +-+-+ +-+-+-+
|     |       |
+ + + + +-+ +-+
| | | |   | | |
+-+-+-+-+-+-+-+
| | | | | | | |
+-+-+-+-+-+-+-+
| | | | | | | |
+-+-+-+-+-+-+-+
| | | | | | | |
+-+-+-+-+-+-+-+