+-+-+-+-+-+-+-+
|             |
+ + + + + + + +
| | | | | | | |
+ +-+ +-+ +-+-+
| |     |     |
+ + +-+ + + +-+
| |   | | |   |
+ + +-+ +-+ + +
| | |   |   | |
+-+ +-+ + +-+ +
|     | | |   |
+ +-+ +-+ +-+ +
|   | |   |   |
+-+-+-+-+-+-+-+