+-+-+-+-+-+-+-+-+-+-+-+-+-+-+-+-+-+-+-+-+-+-+-+-+-+-+-+-+-+-+-+-+-+-+-+-+-+-+-+-+-+-+
|                                                                                   |
+ +-+ + + + +-+-+ + + + + +-+-+ + + +-+ + +-+ + + +-+ +-+-+-+-+ + + + + +-+-+ + + +-+
|   | | | |     | | | | |     | | |   | |   | | |   |         | | | | |     | | |   |
+ +-+ +-+ +-+ +-+-+-+-+-+ + +-+-+ +-+ +-+ +-+ +-+-+-+-+ +-+-+-+-+-+ + +-+-+ +-+ +-+ +
|   |   |   |           | |     |   |   |   |         |           | |     |   |   | |
+ +-+ + +-+ + + + + +-+ +-+-+-+-+ +-+-+-+-+-+-+-+-+-+-+-+ +-+ + +-+ + + +-+ +-+-+-+-+
|   | |   | | | | |   |         |                       |   | |   | | |   |         |
+ + +-+ +-+ +-+-+ + +-+ + + +-+-+-+ + + + + +-+-+ +-+-+ +-+-+ + +-+ + + + + + + +-+-+
| |   |   |     | |   | | |       | | | | |     |     |     | |   | | | | | | |     |
+ +-+ +-+-+-+-+ +-+ +-+ + +-+ +-+ +-+-+-+-+ +-+ +-+ +-+ + +-+-+-+-+-+-+-+-+ + + + +-+
|   |         |   |   | |   |   |         |   |   |   | |                 | | | |   |
+ + + + +-+ + + +-+-+-+ +-+-+ +-+ + +-+ + +-+ + +-+-+-+-+ +-+ +-+ +-+ + + + +-+ + +-+
| | | |   | | |       |     |   | |   | |   | |         |   |   |   | | | |   | |   |
+ + + +-+ +-+-+-+ + + + +-+-+ +-+-+-+-+ + + +-+-+ +-+-+ + +-+-+-+-+ + + +-+-+ +-+ +-+
| | |   |       | | | |     |         | | |     |     | |         | | |     |   |   |
+ +-+-+-+ + +-+-+ +-+ + + + + +-+ +-+-+-+-+ + +-+-+-+ + + +-+-+-+ +-+ + + +-+ + + +-+
|       | |     |   | | | | |   |         | |       | | |       |   | | |   | | |   |
+ + + +-+-+-+-+ +-+ + +-+-+-+-+-+-+-+ +-+-+ + + + + +-+-+ + +-+ + +-+-+-+-+-+ +-+-+-+
| | |         |   | |               |     | | | | |     | |   | |           |       |
+ +-+-+-+-+ +-+ +-+-+ + + + + +-+-+-+-+-+-+-+ +-+ +-+ + + +-+-+-+-+ +-+ +-+ +-+-+ +-+
|         |   |     | | | | |               |   |   | | |         |   |   |     |   |
+ +-+ +-+-+ +-+ +-+ + + +-+-+-+-+ +-+-+-+-+-+-+-+-+-+-+ +-+ +-+ +-+-+-+-+-+-+ +-+ +-+
|   |     |   |   | | |         |                     |   |   |             |   |   |
+ + +-+-+-+-+ + + + + +-+ + + + +-+ + +-+-+-+-+-+-+-+-+-+ + + + +-+-+-+-+ + +-+-+ +-+
| |         | | | | |   | | | |   | |                   | | | |         | |     |   |
+ +-+ +-+-+-+-+-+ + +-+ +-+-+ + +-+-+-+-+-+-+-+-+-+ + + + +-+ +-+ +-+-+ + + + + +-+ +
|   |           | |   |     | |                   | | | |   |   |     | | | | |   | |
+ +-+ + +-+-+-+ + +-+-+-+-+-+ + +-+ +-+ +-+ + +-+ +-+ +-+ +-+-+ + +-+ + +-+-+ + +-+-+
|   | |       | |           | |   |   |   | |   |   |   |     | |   | |     | |     |
+ + +-+ +-+ +-+-+-+-+-+ +-+-+ + +-+-+ +-+-+-+-+ + + + +-+-+-+ +-+ +-+-+-+-+ +-+ + +-+
| |   |   |           |     | |     |         | | | |       |   |         |   | |   |
+ + +-+ +-+ +-+ +-+ +-+-+ +-+ + + +-+ +-+-+ + +-+-+ +-+-+ + +-+-+-+ +-+-+-+ +-+-+-+ +
| |   |   |   |   |     |   | | |   |     | |     |     | |       |       |       | |
+ +-+ +-+ +-+-+-+-+-+ +-+-+ + +-+-+-+-+ +-+ + + +-+ + + + +-+-+-+ + + + +-+-+ + +-+-+
|   |   |           |     | |         |   | | |   | | | |       | | | |     | |     |
+ +-+ + +-+ + + + +-+-+ + +-+ + + +-+-+ + +-+ +-+ + +-+-+-+ + + +-+-+ + + + + +-+-+-+
|   | |   | | | |     | |   | | |     | |   |   | |       | | |     | | | | |       |
+ + +-+-+ +-+ + +-+ + +-+-+-+ + + + +-+-+-+-+-+-+ + +-+-+ +-+ + +-+-+ + + +-+ + + + +
| |     |   | |   | |       | | | |             | |     |   | |     | | |   | | | | |
+ + + + + +-+-+-+ + + +-+ + +-+ + + +-+ +-+-+-+-+-+-+-+ +-+ + + +-+-+ +-+ + +-+-+ + +
| | | | |       | | |   | |   | | |   |               |   | | |     |   | |     | | |
+ + + +-+-+-+-+-+-+-+-+-+-+ +-+ + +-+-+-+ +-+-+ + + + +-+-+-+-+ +-+-+ + +-+-+ +-+ +-+
| | |                     |   | |       |     | | | |         |     | |     |   |   |
+ + +-+-+ +-+ + +-+ +-+ + + + +-+-+-+ +-+-+-+-+ + + + + +-+-+-+ + +-+ +-+ +-+-+ +-+-+
| |     |   | |   |   | | | |       |         | | | | |       | |   |   |     |     |
+ + + + + + +-+-+ +-+ +-+-+ +-+ + +-+ + +-+-+-+ + +-+ +-+ +-+ +-+ +-+-+ + +-+ +-+-+-+
| | | | | |     |   |     |   | |   | |       | |   |   |   |   |     | |   |       |
+ +-+ + + + +-+ +-+ +-+ +-+ + +-+-+ +-+-+ + + +-+ + +-+-+ + +-+-+ + +-+ +-+-+ + + + +
|   | | | |   |   |   |   | |     |     | | |   | |     | |     | |   |     | | | | |
+ +-+-+ +-+ +-+-+ + +-+-+ +-+-+-+-+ +-+ + + + +-+-+ + +-+ +-+-+-+ +-+-+ + +-+ + +-+ +
|     |   |     | |     |         |   | | | |     | |   |       |     | |   | |   | |
+ + + +-+ +-+ +-+ + + + +-+-+-+-+ +-+ + +-+ + + +-+ + + + + + + + + + +-+ + +-+ + + +
| | |   |   |   | | | |         |   | |   | | |   | | | | | | | | | |   | |   | | | |
+ +-+ +-+-+-+ + + +-+-+ +-+ + + + +-+ + +-+ +-+ +-+ +-+-+-+ +-+ + +-+-+ + + +-+ + + +
|   |       | | |     |   | | | |   | |   |   |   |       |   | |     | | |   | | | |
+ + +-+-+-+-+ +-+-+ + + + +-+ +-+ +-+ + +-+ + +-+-+ +-+-+ +-+ +-+-+-+-+ +-+-+-+-+ +-+
| |         |     | | | |   |   |   | |   | |     |     |   |         |         |   |
+ +-+-+-+ +-+-+-+ + +-+-+ + + + +-+ +-+-+-+ + + + +-+ + +-+-+-+ + + + +-+ +-+-+ + + +
|       |       | |     | | | |   |       | | | |   | |       | | | |   |     | | | |
+ +-+ + + + + +-+ +-+-+ + +-+ + + +-+-+ +-+ + + + + + +-+-+-+-+-+-+-+ + + + + +-+ + +
|   | | | | |   |     | |   | | |     |   | | | | | |               | | | | |   | | |
+ + + + + + +-+-+ + +-+ + +-+-+ +-+ +-+ +-+ + + + + + + + + +-+-+ + +-+ +-+ +-+ + + +
| | | | | |     | |   | |     |   |   |   | | | | | | | | |     | |   |   |   | | | |
+ + +-+ + +-+ + +-+-+-+-+ + +-+-+ +-+ + +-+-+ +-+-+ + +-+ + +-+ +-+ + +-+-+-+ + + + +
| |   | |   | |         | |     |   | |     |     | |   | |   |   | |       | | | | |
+ +-+-+ +-+ + +-+ +-+-+-+-+ + + +-+-+-+ +-+ + +-+-+-+ + + +-+ +-+-+ + + +-+-+-+ + + +
|     |   | |   |         | | |       |   | |       | | |   |     | | |       | | | |
+ +-+ + +-+-+-+-+ + + + + + + + + +-+ +-+-+ +-+-+ +-+ +-+-+-+-+ + + +-+-+-+ + +-+-+-+
|   | |         | | | | | | | | |   |     |     |   |         | | |       | |       |
+ + + + + +-+-+-+ +-+ + +-+ + + + + +-+-+-+ + +-+-+ + +-+-+-+ +-+-+ +-+-+-+ + + +-+-+
| | | | |       |   | |   | | | | |       | |     | |       |     |       | | |     |
+ + +-+ + + +-+ +-+ +-+ + +-+ + +-+ + +-+ +-+ + +-+-+ +-+ +-+-+ +-+-+ +-+ +-+-+ + + +
| |   | | |   |   |   | |   | |   | |   |   | |     |   |     |     |   |     | | | |
+ +-+ +-+ + +-+-+-+ +-+-+-+-+-+-+ +-+ +-+ +-+ + + + + +-+-+-+ + +-+ +-+ +-+ +-+ +-+-+
|   |   | |       |             |   |   |   | | | | |       | |   |   |   |   |     |
+ +-+-+ +-+-+ +-+-+ +-+-+-+-+-+ +-+ + + +-+ + +-+ +-+ +-+ + +-+ +-+ + +-+-+ +-+ +-+ +
|     |     |     |           |   | | |   | |   |   |   | |   |   | |     |   |   | |
+ +-+ + + + + + +-+ + + + +-+-+ +-+ +-+-+ +-+ +-+-+-+ + + + +-+-+-+-+ + + + +-+ +-+-+
|   | | | | | |   | | | |     |   |     |   |       | | | |         | | | |   |     |
+ + +-+ +-+-+-+ + +-+-+ + +-+-+ + + +-+ + +-+-+ +-+ + +-+ + +-+-+ +-+-+ +-+ +-+-+-+-+
| |   |       | |     | |     | | |   | |     |   | |   | |     |     |   |         |
+ +-+-+ + +-+ +-+-+-+-+-+ + + +-+ +-+-+ + +-+ + +-+-+ + +-+ + +-+ + +-+ + + + + + + +
|     | |   |           | | |   |     | |   | |     | |   | |   | |   | | | | | | | |
+-+-+-+-+-+-+-+-+-+-+-+-+-+-+-+-+-+-+-+-+-+-+-+-+-+-+-+-+-+-+-+-+-+-+-+-+-+-+-+-+-+-+