+-+-+-+-+-+-+-+-+-+-+-+-+-+-+-+-+-+-+-+-+-+-+-+-+-+-+-+-+-+-+-+-+-+-+-+-+-+-+-+-+-+-+-+-+-+-+-+-+-+-+
|                                                                                                   |
+ + +-+-+ + +-+-+-+-+ +-+-+ +-+-+ +-+-+ + + + +-+-+ + + + + +-+ + +-+-+ +-+ + +-+ +-+-+ +-+-+-+-+ +-+
| |     | |         |     |     |     | | | |     | | | | |   | |     |   | |   |     |         |   |
+ + +-+ + +-+-+ + +-+-+-+ +-+-+ +-+ + + +-+ + +-+ +-+-+-+-+-+ + +-+ + + + + + +-+-+-+-+-+ +-+ +-+-+-+
| |   | |     | |       |     |   | | |   | |   |           | |   | | | | | |           |   |       |
+ + + +-+ +-+-+-+-+ + +-+-+ +-+ +-+ +-+ +-+-+-+ +-+-+-+-+-+-+-+-+ + +-+ + +-+-+-+ + + + + +-+-+-+ + +
| | |   |         | |     |   |   |   |       |                 | |   | |       | | | | |       | | |
+ + + + +-+-+-+-+-+-+ + +-+-+-+ + +-+ +-+ + +-+-+-+ + +-+ + + +-+-+ + +-+-+ + +-+-+ + + + +-+ +-+ +-+
| | | |             | |       | |   |   | |       | |   | | |     | |     | |     | | | |   |   |   |
+ + +-+ + +-+ + +-+ +-+ + + + + + + + + +-+ +-+ +-+-+ +-+-+ +-+ +-+ + + + +-+ +-+-+-+-+ + +-+ +-+ + +
| |   | |   | |   |   | | | | | | | | |   |   |     |     |   |   | | | |   |         | |   |   | | |
+ +-+ + + +-+-+ +-+ +-+ +-+-+-+ +-+ + + +-+ + +-+-+-+-+ + +-+ +-+-+-+-+-+ +-+ +-+ + +-+-+-+ + +-+-+ +
|   | | |     |   |   |       |   | | |   | |         | |   |           |   |   | |       | |     | |
+ + + + +-+-+-+ +-+-+ +-+-+-+-+ +-+-+ + + +-+ +-+ +-+-+-+ + + +-+ +-+-+ + + +-+-+ + + +-+ + + + +-+ +
| | | |       |     |         |     | | |   |   |       | | |   |     | | |     | | |   | | | |   | |
+ + + +-+-+-+ +-+-+-+ +-+-+ + + + +-+-+ +-+-+ +-+ +-+-+ + +-+-+ +-+-+ +-+ + +-+-+-+-+ +-+ +-+-+ +-+ +
| | |       |       |     | | | |     |     |   |     | |     |     |   | |         |   |     |   | |
+ + +-+-+ + +-+ + + + + + +-+ +-+ +-+-+ + + +-+ +-+ + +-+ +-+ +-+ + + + + + + +-+ + + + +-+-+-+-+-+-+
| |     | |   | | | | | |   |   |     | | |   |   | |   |   |   | | | | | | |   | | | |             |
+ +-+ + +-+ +-+ + +-+ + +-+-+-+ + + + +-+ + +-+-+ + + +-+-+-+-+-+ +-+ +-+ +-+ + + +-+ +-+ + + +-+ + +
|   | |   |   | |   | |       | | | |   | |     | | |           |   |   |   | | |   |   | | |   | | |
+ + +-+ +-+ + +-+-+ + +-+ + + + +-+-+ +-+-+-+-+-+ +-+-+-+-+ +-+-+-+-+-+-+ +-+ + + + + + + +-+ +-+-+ +
| |   |   | |     | |   | | | |     |           |         |             |   | | | | | | |   |     | |
+ + +-+-+-+ + + + + +-+ +-+ + +-+ + +-+-+-+ +-+ + +-+-+ + + +-+-+ + +-+-+-+-+ + +-+-+ + +-+ +-+ + + +
| |       | | | | |   |   | |   | |       |   | |     | | |     | |         | |     | |   |   | | | |
+ + + + +-+-+ + +-+-+ + + +-+ + + + + + + +-+-+ + +-+-+ +-+ +-+-+ +-+ + + + + +-+ +-+-+-+ + + +-+ + +
| | | |     | |     | | |   | | | | | | |     | |     |   |     |   | | | | |   |       | | |   | | |
+ + + + +-+ + + +-+-+ + +-+-+-+ + + +-+-+ +-+ + +-+ + + +-+ +-+-+ + +-+ + +-+-+-+ +-+ +-+ + +-+ +-+ +
| | | |   | | |     | |       | | |     |   | |   | | |   |     | |   | |       |   |   | |   |   | |
+ +-+ + +-+-+ +-+-+-+ + +-+ +-+-+-+-+-+-+ +-+-+-+-+ +-+-+ +-+-+ + + + +-+ + +-+-+-+ +-+-+-+ + +-+ +-+
|   | |     |       | |   |             |         |     |     | | | |   | |       |       | |   |   |
+ +-+-+-+-+ +-+-+ + +-+-+ + +-+-+-+-+-+-+ +-+-+ +-+-+ + + +-+-+-+-+-+-+ + + +-+-+ +-+-+ + +-+-+ + + +
|         |     | |     | |             |     |     | | |             | | |     |     | |     | | | |
+ +-+ +-+ + + + + +-+ +-+ +-+ + +-+ + + +-+-+-+ +-+ +-+ +-+-+-+ + +-+-+ +-+-+-+ +-+ + + +-+ +-+ +-+ +
|   |   | | | | |   |   |   | |   | | |       |   |   |       | |     |       |   | | |   |   |   | |
+ +-+ + +-+-+ +-+ +-+-+ + +-+-+-+-+ + + + + + + +-+ + + + +-+ +-+ + + +-+-+-+ +-+-+ + + +-+-+-+-+ +-+
|   | |     |   |     | |         | | | | | | |   | | | |   |   | | |       |     | | |         |   |
+ +-+ +-+ + + + +-+-+ +-+ + +-+-+-+-+ + + +-+ +-+ +-+-+-+-+-+ + + + + + +-+ +-+ + + +-+-+-+ + + +-+ +
|   |   | | | |     |   | |         | | |   |   |           | | | | | |   |   | | |       | | |   | |
+ +-+ +-+-+ +-+-+ + +-+ + + +-+ + +-+-+-+-+ + + + +-+ + + +-+ +-+ +-+-+-+-+-+ + +-+-+-+-+ + +-+ +-+-+
|   |     |     | |   | | |   | |         | | | |   | | |   |   |           | |         | |   |     |
+ + + + +-+ + + + + + + +-+-+-+-+-+-+-+-+-+-+ + +-+ + +-+ +-+ +-+ + +-+-+ +-+-+ +-+ +-+ + +-+ + + + +
| | | |   | | | | | | |                     | |   | |   |   |   | |     |     |   |   | |   | | | | |
+ + +-+-+ + + + + +-+ +-+ +-+ + +-+-+-+-+ + + +-+-+ + + +-+-+ +-+ +-+ +-+ + + + + + +-+ +-+ +-+-+-+ +
| |     | | | | |   |   |   | |         | | |     | | |     |   |   |   | | | | | |   |   |       | |
+ + + +-+-+-+-+-+ + + +-+-+ +-+-+ + +-+ +-+-+-+-+-+-+-+ + + + + + +-+-+ + + +-+ + +-+ + + + + + +-+-+
| | |           | | |     |     | |   |               | | | | | |     | | |   | |   | | | | | |     |
+ +-+-+-+ +-+ +-+-+ +-+-+ +-+ + +-+-+-+-+-+ +-+-+ + + +-+ + +-+ +-+ +-+ + + + +-+ + + +-+ +-+-+-+ + +
|       |   |     |     |   | |           |     | | |   | |   |   |   | | | |   | | |   |       | | |
+ +-+-+ + +-+-+ +-+ + +-+ +-+ + +-+-+-+-+ +-+ + +-+ +-+-+-+ +-+-+ +-+-+-+-+ +-+-+ +-+-+-+-+-+ + + + +
|     | |     |   | |   |   | |         |   | |   |       |     |         |     |           | | | | |
+ +-+ + + +-+-+ + + +-+-+ + +-+-+ +-+-+-+-+ + + + + +-+ + + + +-+-+ + +-+-+ +-+ + + + + +-+ + + +-+ +
|   | | |     | | |     | |     |         | | | | |   | | | |     | |     |   | | | | |   | | |   | |
+ + + +-+-+ +-+ + + + +-+-+ +-+-+ + + + +-+-+-+ + +-+-+ + + + +-+-+ + +-+ + +-+-+-+ + + +-+-+-+-+-+-+
| | |     |   | | | |     |     | | | |       | |     | | | |     | |   | |       | | |             |
+ +-+-+ +-+-+-+-+-+-+ +-+ +-+-+ +-+ + +-+ +-+ + + +-+-+-+ +-+ + +-+-+ +-+-+-+ + +-+ +-+ + +-+ + + +-+
|     |             |   |     |   | |   |   | | |       |   | |     |       | |   |   | |   | | |   |
+ +-+ + +-+-+-+-+ +-+-+-+-+-+ + +-+-+-+-+-+ +-+-+-+ + + +-+ +-+-+ +-+ + +-+ + + +-+-+ +-+ +-+-+ + +-+
|   | |         |           | |           |       | | |   |     |   | |   | | |     |   |     | |   |
+ + +-+-+ +-+-+ + + +-+-+ + + + + +-+-+ + +-+ +-+ + + + +-+-+ + + + + + + + +-+-+-+ +-+ + +-+ +-+ + +
| |     |     | | |     | | | | |     | |   |   | | | |     | | | | | | | |       |   | |   |   | | |
+ +-+ +-+-+-+-+ + + + +-+ +-+-+-+-+ + +-+ +-+-+ + + + +-+-+ + +-+ +-+ +-+-+-+-+ + + + +-+-+ + + + +-+
|   |         | | | |   |         | |   |     | | | |     | |   |   |         | | | |     | | | |   |
+ +-+ +-+ +-+ +-+ +-+-+ +-+-+ +-+ + + +-+-+-+-+-+-+ +-+-+-+-+-+ +-+-+ + + + +-+-+-+ + +-+-+-+-+-+ +-+
|   |   |   |   |     |     |   | | |             |           |     | | | |       | |           |   |
+ + + + + + + + + +-+-+-+-+-+ + + + + +-+ +-+-+-+-+-+-+ +-+-+ +-+-+ + + + +-+-+ +-+-+ + +-+-+ + + +-+
| | | | | | | | |           | | | | |   |             |     |     | | | |     |     | |     | | |   |
+ +-+ +-+-+-+ +-+ + + +-+ +-+-+-+-+ +-+ + +-+-+-+ + + +-+-+ + + + +-+ +-+ +-+-+ +-+-+-+ + + + +-+ +-+
|   |       |   | | |   |         |   | |       | | |     | | | |   |   |     |       | | | |   |   |
+ + + + +-+-+-+-+-+-+-+-+-+ + + +-+-+ + + +-+-+-+-+ + +-+-+ +-+ + +-+-+ +-+ + +-+ + + +-+ + + +-+-+ +
| | | |                   | | |     | | |         | |     |   | |     |   | |   | | |   | | |     | |
+ +-+-+-+ +-+-+ +-+ + + + +-+ + +-+ +-+ +-+-+ + + + +-+-+ +-+-+-+-+ + + + + + +-+ + +-+ + +-+ + +-+-+
|       |     |   | | | |   | |   |   |     | | | |     |         | | | | | |   | |   | |   | |     |
+ + + + + + +-+-+-+-+ +-+ +-+-+-+ +-+-+ +-+ + + + +-+ + + + + + + +-+-+ +-+ +-+-+ + + + +-+ + + +-+ +
| | | | | |         |   |       |     |   | | | |   | | | | | | |     |   |     | | | |   | | |   | |
+ +-+ +-+ +-+-+-+ +-+-+-+ +-+-+-+-+ + + +-+-+ +-+ + + +-+ +-+-+-+-+ +-+ +-+-+-+ + +-+-+-+-+-+ +-+ + +
|   |   |       |       |         | | |     |   | | |   |         |   |       | |           |   | | |
+ +-+-+ + + +-+ + +-+ +-+ +-+ + + + +-+-+-+ +-+ +-+ + +-+ +-+-+-+-+-+-+-+-+-+ + +-+ +-+ + + + + +-+-+
|     | | |   | |   |   |   | | | |       |   |   | |   |                   | |   |   | | | | |     |
+ + +-+-+-+-+ + + +-+-+ + + +-+ +-+-+-+-+-+ + + + +-+-+-+-+ +-+ +-+ + +-+ + +-+-+ +-+-+ + + + + + + +
| |         | | |     | | |   |           | | | |         |   |   | |   | |     |     | | | | | | | |
+ +-+-+-+-+-+ +-+-+ + + + +-+ +-+ +-+-+ + + + + + + + + +-+ + + +-+ + + +-+-+ + + +-+ + +-+ +-+ + +-+
|           |     | | | |   |   |     | | | | | | | | |   | | |   | | |     | | |   | |   |   | |   |
+ + + +-+ +-+ +-+-+ + +-+-+-+ + +-+ +-+-+ + +-+ + +-+-+ +-+-+-+ +-+-+-+ + +-+ + +-+ +-+-+ + +-+-+ + +
| | |   |   |     | |       | |   |     | |   | |     |       |       | |   | |   |     | |     | | |
+ + + +-+-+-+-+ +-+-+-+ +-+ +-+-+-+ +-+ + +-+-+ +-+-+ + + + +-+ + + +-+ +-+-+ +-+ +-+ + + +-+-+ +-+-+
| | |         |       |   |       |   | |     |     | | | |   | | |   |     |   |   | | |     |     |
+ + + +-+-+ +-+-+ +-+-+-+ +-+ + + +-+ + + +-+-+-+ +-+-+ +-+-+ +-+-+ +-+ + +-+-+-+-+ + + + +-+-+-+-+ +
| | |     |     |       |   | | |   | | |       |     |     |     |   | |         | | | |         | |
+ + +-+-+-+-+-+-+-+ +-+-+ +-+ + +-+-+-+-+ + +-+ + + +-+ +-+-+ + + +-+-+ + +-+-+ +-+ + + + +-+-+ + +-+
| |               |     |   | |         | |   | | |   |     | | |     | |     |   | | | |     | |   |
+ +-+-+-+ + + +-+-+ +-+ + + + +-+-+ +-+-+ +-+ +-+-+ + +-+-+ +-+ +-+ + + + +-+-+-+-+-+ + + + + +-+ +-+
|       | | |     |   | | | |     |     |   |     | |     |   |   | | | |           | | | | |   |   |
+ +-+ +-+-+-+-+-+ + + +-+-+-+ + +-+-+-+-+ + + +-+-+ + +-+-+-+-+-+ +-+-+-+ +-+ +-+-+ +-+-+-+-+ +-+-+ +
|   |           | | |       | |         | | |     | |           |       |   |     |         |     | |
+ +-+ + + +-+ + +-+-+-+ +-+-+-+-+-+ + +-+-+-+ +-+ + +-+ + + + + +-+ + +-+-+-+ + +-+ + +-+ +-+-+ +-+ +
|   | | |   | |       |           | |       |   | |   | | | | |   | |       | |   | |   |     |   | |
+ +-+-+ + + +-+ + +-+ + +-+ +-+ + + +-+-+-+ + +-+-+ +-+ + + + + + +-+-+-+ + + +-+-+ + +-+-+-+ + +-+ +
|     | | |   | |   | |   |   | | |       | |     |   | | | | | |       | | |     | |       | |   | |
+-+-+-+-+-+-+-+-+-+-+-+-+-+-+-+-+-+-+-+-+-+-+-+-+-+-+-+-+-+-+-+-+-+-+-+-+-+-+-+-+-+-+-+-+-+-+-+-+-+-+