+-+-+-+-+-+-+-+
|             |
+ + +-+ +-+ + +
| |   |   | | |
+ + +-+ + + + +
| | |   | | | |
+ + + + + +-+ +
| | | | | |   |
+-+ +-+ + +-+ +
|   |   | |   |
+-+-+ +-+ + + +
|       | | | |
+ + + +-+ +-+ +
| | |   | |   |
+-+-+-+-+-+-+-+