+-+-+-+-+-+-+-+
| |         | |
+ + +-+-+ + + +
| |     | |   |
+ +-+-+-+ +-+ +
| |     | | | |
+ + +-+ + + + +
|   | | | | | |
+-+-+ + + + + +
|     |   |   |
+ +-+ +-+-+ +-+
|   |     |   |
+-+ + +-+-+-+ +
|   |         |
+-+-+-+-+-+-+-+