+-+-+-+-+-+-+-+-+-+-+-+-+-+
|                         |
+-+-+-+-+-+-+-+-+-+-+-+-+-+
|.|.|.|.|.|.|.|.|.|.|.|.|.|
+-+-+-+-+-+-+-+-+-+-+-+-+-+
|.|.|.|.|.|.|.|.|.|.|.|.|.|
+-+-+-+-+-+-+-+-+-+-+-+-+-+
|.|.|.|.|.|.|.|.|.|.|.|.|.|
+-+-+-+-+-+-+-+-+-+-+-+-+-+
|.|.|.|.|.|.|.|.|.|.|.|.|.|
+-+-+-+-+-+-+-+-+-+-+-+-+-+
|.|.|.|.|.|.|.|.|.|.|.|.|.|
+-+-+-+-+-+-+-+-+-+-+-+-+-+
|.|.|.|.|.|.|.|.|.|.|.|.|.|
+-+-+-+-+-+-+-+-+-+-+-+-+-+
|.|.|.|.|.|.|.|.|.|.|.|.|.|
+-+-+-+-+-+-+-+-+-+-+-+-+-+
|.|.|.|.|.|.|.|.|.|.|.|.|.|
+-+-+-+-+-+-+-+-+-+-+-+-+-+
|.|.|.|.|.|.|.|.|.|.|.|.|.|
+-+-+-+-+-+-+-+-+-+-+-+-+-+
|.|.|.|.|.|.|.|.|.|.|.|.|.|
+-+-+-+-+-+-+-+-+-+-+-+-+-+
|.|.|.|.|.|.|.|.|.|.|.|.|.|
+-+-+-+-+-+-+-+-+-+-+-+-+-+
|.|.|.|.|.|.|.|.|.|.|.|.|.|
+-+-+-+-+-+-+-+-+-+-+-+-+-+