+-+-+-+-+-+-+-+-+-+-+-+-+-+-+-+-+-+-+-+-+-+-+-+-+-+-+-+-+-+-+-+-+-+-+-+-+-+-+-+-+-+-+-+-+-+
|       |             |               |       |                 |     |     |           | |
+-+-+-+ + +-+-+-+-+ + +-+-+ +-+-+-+-+ + +-+ + + +-+-+-+-+-+-+-+ + +-+-+ +-+ + +-+ +-+-+ + +
|       |   |       |     | |     |   | |   | | |     |     |   |   |   | |   |   |   |   |
+ +-+-+-+ +-+ +-+-+-+-+-+ + + +-+-+ +-+ + +-+ + + +-+ + +-+ + +-+-+ + +-+ +-+-+ +-+ + +-+ +
|     |   |   |       |   | | |   | |   |   |   | |   |   |   |   | |   |     |     | |   |
+-+-+ +-+-+ +-+ +-+-+ + +-+ + + + + +-+-+ + +-+-+ + + +-+ +-+-+ + + +-+ + +-+ +-+-+-+ +-+-+
|   | |   |   |     | |   | |   | |     | |   |   | | |   |     | | |   |   | |   | |     |
+-+ + + + + + +-+-+ + +-+ + +-+ + +-+-+ +-+-+ + +-+ + + +-+ +-+-+ + + +-+-+ + + + + +-+-+ +
|   |   | | | |     |   | |   | | |   |       |   | | |   |     |   | |     |   |     |   |
+ +-+-+-+ +-+ +-+-+-+ +-+ + + + + + + +-+-+-+-+ +-+ +-+-+ +-+-+ +-+-+ + +-+-+-+-+ +-+-+ +-+
|       |     |       |   | | | |   |   |       |   |     |     |   | | |         |   |   |
+ + +-+ +-+-+-+ +-+-+ + +-+-+ + +-+-+ + +-+-+-+-+ +-+ +-+-+ +-+-+ + + + +-+ +-+-+-+ + + + +
| | | | |     |   |   | |     | | |   |         | |   |     |     |   |   |     |   | | | |
+-+ + + + + + +-+ + +-+ + +-+-+ + + +-+-+-+-+-+ + + +-+-+ +-+ +-+-+-+-+-+ + +-+-+ +-+ + + +
|   |   | | |     | |   | |   | | |   |       |   | |     |   |           | |   | | | | | |
+ +-+-+-+ + +-+-+-+ + +-+ + + + + +-+ +-+ +-+-+ +-+ + +-+-+ +-+-+ +-+-+-+-+ + + + + + + + +
|   |   | |       | | |   | | |     | |   |     |   |       |   |   |     | | |   |   | | |
+-+ + + + +-+-+-+ + + +-+ + +-+-+-+ + + +-+ +-+-+ +-+-+-+ +-+ + +-+ + +-+ + + +-+-+ +-+-+ +
|   | |   |       | | |   | |       | |     |     |     |     |   | | |   | |     |       |
+ +-+ +-+-+ +-+-+-+ + + +-+ + +-+-+-+ + +-+-+ +-+-+ +-+ +-+-+-+-+ + + +-+ + +-+-+ +-+-+-+ +
|     | |   |     | | | |     |     | |     | |   | |   |   |   |   |   | |     |       | |
+ +-+-+ + +-+-+ + + + + +-+ +-+ +-+ + +-+-+-+ + + + + +-+ + + + + +-+-+ + +-+-+ +-+-+-+ +-+
|       |     | | | | |   | |     | |   |     | |   | |   |   | | |   | | | |   |     |   |
+-+ +-+-+-+-+ +-+ + + +-+ + + +-+ +-+-+ + +-+-+ +-+-+ + +-+-+-+ +-+ + + + + + +-+ +-+ +-+ +
|   |       | |   | |     | | | |     | |     | |   |   |     |   | |   | |   |   |   |   |
+ +-+ +-+-+ + + +-+ +-+-+-+ + + +-+ + + +-+-+ + +-+ +-+-+-+-+ +-+ + +-+-+ + +-+ + +-+-+ + +
|   | |   | | | |       |   |     | | |     |   |       |   |   | |   |   |     | |     | |
+-+ + + +-+ + + + +-+-+-+ +-+-+-+ + +-+-+-+ +-+-+ +-+-+ + + +-+ + +-+ +-+ +-+-+ +-+ +-+-+ +
|   | |       |   |       |     | |       |       |       | |   |   |   |     | |   |   | |
+ +-+ + +-+-+-+-+-+ +-+-+-+ +-+ + +-+-+ + +-+ +-+ +-+-+-+-+ + +-+-+ + + +-+-+ +-+ +-+ + + +
| |   | |   |     |   |     |   | | |   | |   |   |     |   | |   | | | |   |   | |   |   |
+ + +-+ + + + +-+ +-+ +-+-+ + +-+ + + +-+-+ +-+-+-+ +-+ + +-+ + + + +-+ + + +-+ + +-+ +-+-+
| |   | | | |   |   |   |   |   | | | |     |     | | | | |     | |     | |   | |   |     |
+ +-+ +-+ + +-+ +-+ +-+ + +-+-+-+ + + + +-+ + +-+ + + + + +-+-+ + +-+-+-+ + +-+ + + +-+-+ +
| |   |   |   | | | |   |           | | |   |   | | | | |     | |     |   |   | | | |     |
+ + +-+ +-+ +-+ + + + +-+-+-+-+-+-+-+ + +-+-+-+ + + + + +-+-+ + +-+ + + +-+-+ + + + +-+ +-+
| |       | |   | | | |         |     |         |     |     | |   | | |   | |   | |   |   |
+ +-+-+-+-+ + +-+ + + + + +-+-+ + +-+ +-+-+-+-+-+-+-+-+-+-+ + +-+-+ + +-+ + +-+-+-+-+ +-+-+
| |   |     | |   |   | | |     | |   |         |   |   |   | |     | | | |     |   |     |
+ +-+ + +-+-+ +-+ +-+-+ + +-+ +-+ + +-+-+ +-+-+ + + + + + +-+ + +-+-+ + + +-+ + + + +-+-+ +
|     | |     |     |   |   | |   |     | |     | | | |   |     |   |   |     |   |     | |
+-+ +-+ + +-+-+ +-+ +-+-+-+ + + + +-+-+ + +-+-+ +-+ + + +-+-+-+-+ + +-+ +-+-+-+-+-+-+-+ + +
| | |   | |     |   |     | |   | |   |   |   |     | | |   | |   |     | |   |     | | | |
+ + + + + + +-+ + +-+ +-+ + +-+-+ + + +-+-+ + +-+-+ + + + + + + +-+-+-+-+ + + + + + + + + +
|   | | | | |   |     |   |     | | |   |   | |   | | | | | | | |         | |   | |   |   |
+ +-+ +-+ +-+ +-+-+-+-+ +-+ +-+ +-+ +-+ + +-+ + + +-+ +-+ + + + + + +-+-+-+ +-+-+ +-+ +-+ +
|   |     |   |       |   | |   |     | | | |   |   |     | |   | |         |   | |     | |
+-+ +-+-+-+ + +-+-+-+ +-+ +-+ +-+ +-+-+ + + +-+-+-+ +-+-+-+ + +-+ +-+-+-+-+-+ + + + +-+-+ +
|   |       | |   |     |   | |   | |   |     |   | |     | | |           |   | | | |   | |
+ +-+ +-+-+ + + + + +-+ +-+ + + +-+ + +-+-+-+ + + + + +-+ + + +-+-+ +-+-+-+ +-+ + + + + + +
|   | |   | | | | | |   |   | | |   |         | |   | | | | |     | |   |   | |   | | | | |
+-+ + +-+ + +-+ + + + +-+ +-+ + + + +-+-+-+-+-+ +-+-+ + + + +-+-+ + + + + +-+ +-+-+ + + + +
|   |     | |   | | |   | |   | | |   | |     |   |   | | |   | | | | |   |         | |   |
+ +-+-+ +-+ + +-+ + +-+-+ + + + +-+ + + + +-+ +-+ + +-+ + +-+ + + + + +-+-+ +-+-+-+-+ +-+-+
|     | |   |   | |       | | |     |   | |     |       | |   | | | |     |       | | |   |
+-+-+ + + + +-+ + +-+-+-+ +-+ +-+-+-+-+ + +-+-+ + +-+-+-+ + +-+ + +-+-+-+ +-+-+-+ + + + + +
| |   | | | |   |       |   |         | |   | | | |       | |             |     | | |   | |
+ + +-+ + + + +-+-+-+-+ +-+ +-+ +-+-+ + +-+ + + +-+ +-+-+-+ +-+-+-+-+-+-+-+ +-+ + + +-+-+ +
| | |   | | |     | |   | |   | | |   |   | |   |   |   |   |         |   |   |         | |
+ + + +-+ +-+-+-+ + + +-+ +-+ + + + +-+-+ + + +-+ +-+ + + +-+ +-+-+-+ + + +-+-+-+-+-+-+ + +
| | |   |       |   |   |     |   | |     | | |   |   |   |   |       | |             | | |
+ + +-+-+-+-+-+ +-+ +-+ + +-+-+-+-+ + +-+-+ + +-+ + +-+-+-+ +-+ +-+-+ + +-+-+-+-+-+-+ +-+ +
| |     |   |     |   | | |         | | |   | |   |       |   | |   | |       |     |     |
+ +-+-+ + + + + +-+ +-+ + + +-+-+-+-+ + + +-+ + + +-+-+-+ +-+ + + + + +-+-+-+ +-+-+ +-+-+-+
|     | | |   | |   |   | |   |       | | |   | | |     |     |   | |       |     |   |   |
+ +-+-+ + +-+-+-+ +-+ +-+ +-+ + +-+-+-+ + + +-+ +-+ + + +-+-+-+-+-+ +-+-+-+-+-+-+ +-+ + + +
|       | |   |   |   |       |   |     | |   | |   | |   |   |   |     |       |   |   | |
+ +-+-+-+ + + + +-+ +-+-+-+-+-+-+ +-+ +-+ +-+ + + +-+ +-+ + + + +-+-+-+ + +-+ +-+-+ + +-+ +
| |       | | |   |   |         |     |   |   |     |   |   | |     |   | |   |     |   | |
+ +-+ +-+ + + +-+ +-+ + +-+-+-+ +-+-+ + +-+ +-+-+-+-+ + +-+-+ +-+-+ + +-+ + +-+ +-+-+-+-+ +
|   | |   | |       | | |     | |     |   | |       | |   |         |   | |     |     |   |
+-+ + + +-+ +-+-+-+-+ + + +-+ + + +-+-+-+ + +-+ +-+ + +-+ +-+-+-+-+ +-+ + +-+-+-+ +-+ + +-+
|   | |   | |     |   | |   | |     |     |     |   |   |         |   |   |         | |   |
+ +-+-+ + + +-+-+ + + + +-+-+ +-+-+-+ +-+-+-+-+-+ +-+-+-+-+-+-+-+ +-+ +-+-+ +-+-+-+ + + + +
|     | |   |   | | | | |     |     |         | | |         |     |   |         |   | | | |
+-+-+ +-+ +-+ + + + +-+ + +-+-+ +-+ + +-+-+-+ + + +-+ +-+-+ + +-+-+ +-+-+-+-+-+ + +-+ + + +
|   |   | |   | | |     |     |   | |   |     | |     |   | | |   | |       |   | |   | | |
+ +-+-+ + + + + + +-+-+-+-+-+ +-+ + +-+-+ +-+-+ +-+-+-+ + + + + + + + +-+-+ +-+-+ + +-+ + +
|     | | | | |               |   |       |           | | |   | | | | |   | |     |   | | |
+ +-+ + + + + +-+-+-+ +-+-+-+-+ +-+-+-+-+-+-+-+ +-+-+ + + +-+-+ + + + + +-+ + +-+-+-+ +-+ +
| | |   | | | | |     |         |   |       |   | |   | |       | |   |   |   |     |     |
+ + +-+-+ +-+ + + +-+-+ +-+-+-+-+ + + +-+-+ + +-+ + +-+ + +-+-+-+ +-+-+-+ +-+-+ + + +-+-+ +
| |   | |     |   |   | | |       |   |   | | | |   |   |   |     |       |   | | | |   | |
+ + + + +-+-+-+ +-+ + + + + + +-+-+ +-+ + + + + + +-+ +-+-+ + +-+-+-+-+ +-+ + + + + + + + +
|   | |   |     |   | | |   |     | |   | |   |     |     | |           |   |   | |   | | |
+-+-+ + + + +-+-+ +-+ + + +-+-+-+ +-+ +-+ +-+-+-+-+-+-+-+ + +-+-+-+-+-+-+ +-+-+-+ + +-+-+ +
|   | | |   |   | | | | |   |   |     | |     |         | |     |         |     | | |     |
+ + + +-+-+-+ + + + + + +-+ + + +-+-+-+ +-+-+ + +-+-+-+ + +-+-+ + +-+-+-+-+ +-+ + +-+ +-+-+
| |           |   |     |     |             |         |       |             |   |         |
+-+-+-+-+-+-+-+-+-+-+-+-+-+-+-+-+-+-+-+-+-+-+-+-+-+-+-+-+-+-+-+-+-+-+-+-+-+-+-+-+-+-+-+-+-+