+-+-+-+-+-+-+-+
|             |
+ + +-+ + + + +
| |   | | | | |
+ + + + + +-+ +
| | | | |   | |
+ + + + + + + +
| | | | | | | |
+ + +-+ + + + +
| | |   | | | |
+-+ + + + + + +
|   | | | | | |
+ + + + + +-+ +
| | | | |   | |
+-+-+-+-+-+-+-+