+-+-+-+-+-+-+-+
|   |         |
+ +-+-+-+ + +-+
|   |   | | | |
+-+ +-+ +-+ + +
|         |   |
+-+ + +-+ +-+ +
|   | |       |
+ +-+-+ + +-+-+
| | |   |   | |
+-+ +-+-+ +-+ +
|   |   |     |
+-+ +-+ +-+ +-+
|             |
+-+-+-+-+-+-+-+