+-+-+-+-+-+-+-+
|             |
+ +-+ + +-+ + +
|   | |   | | |
+ + + +-+ + + +
| | |   | | | |
+ + + +-+ + + +
| | |   | | | |
+ + + +-+ +-+-+
| | |   |     |
+ + +-+-+ + + +
| |     | | | |
+ +-+-+ +-+-+ +
|     |     | |
+-+-+-+-+-+-+-+