+-+-+-+-+-+-+-+-+-+-+-+-+-+-+-+-+-+-+-+
|           | | | | |           |     |
+-+-+ +-+-+-+ + + + + +-+-+-+-+-+-+ +-+
|   | |   |       |   |       | | |   |
+-+ + + +-+-+-+ +-+ +-+-+ +-+ + + +-+ +
|         |       |   |     |         |
+ +-+-+ + +-+ +-+-+-+ + + +-+-+-+-+ + +
|     | |         |     |   |   | | | |
+ + + +-+-+ + +-+-+-+ + + + +-+ + + +-+
| | |     | |     |   | | |       |   |
+-+-+-+ +-+-+ +-+-+-+-+ +-+-+-+ + +-+ +
|   |   |   |     |     | |   | |   | |
+ + +-+ +-+ + +-+-+ + + + +-+ +-+ + +-+
| | | |   | |   |   | |   | |     |   |
+-+ + +-+ + +-+-+-+-+-+ + + +-+-+-+ + +
|     |           | | | |     |     | |
+-+ +-+ + +-+-+ +-+ + +-+ +-+-+-+-+ + +
| |   | |     |   |   |     | | |   | |
+ + +-+ +-+-+ +-+-+-+ + + +-+ + + +-+ +
| |   |   | | |         |   |   |   | |
+ + +-+-+-+ + +-+ +-+ +-+-+-+ +-+-+ + +
|       |           |       |     | | |
+-+ +-+ + +-+-+ +-+-+-+ + +-+-+ +-+ +-+
| |   |   |   |   |   | |       | |   |
+ +-+ +-+-+ +-+-+-+-+ + +-+-+-+ + +-+-+
| |   |       | |       |     |   |   |
+ + +-+ +-+ + + +-+-+-+-+ +-+-+-+ + + +
|   |   |   | | | |             |   | |
+ +-+ +-+ +-+ + + + +-+-+-+-+ + + + + +
| | | | | |   |   |     | |   |   | | |
+ + +-+ +-+-+ + +-+ + + + + + +-+ +-+ +
|   |       |       | | |   |   | | | |
+-+ +-+-+ +-+-+ + +-+-+-+ + +-+ +-+ +-+
| | |         | | |   |   |   |       |
+ +-+ +-+-+-+ + +-+ + + +-+ + +-+ +-+ +
|     |     |     | |     | | |   |   |
+ + +-+-+ +-+ +-+ + + +-+-+ +-+ +-+-+-+
| |     |       | | | |       |       |
+-+-+-+-+-+-+-+-+-+-+-+-+-+-+-+-+-+-+-+