+-+-+-+-+-+-+-+-+-+-+-+-+-+-+-+-+-+-+-+-+-+-+-+-+-+-+-+-+-+-+-+-+-+-+-+-+-+-+-+-+-+-+-+-+-+-+-+-+-+-+
|                                                                                                   |
+ + +-+-+ + +-+-+ + +-+ + + + +-+ + + + +-+-+-+ + + + +-+-+-+ + + +-+ +-+-+-+ +-+-+-+-+ + +-+-+ + +-+
| |     | |     | |   | | | |   | | | |       | | | |       | | |   |       |         | |     | |   |
+ +-+-+-+-+ + + +-+-+-+ + +-+-+-+ +-+-+ + +-+ + + +-+-+-+ + +-+-+ + + +-+-+ + + + + + +-+-+-+ + +-+ +
|         | | |       | |       |     | |   | | |       | |     | | |     | | | | | |       | |   | |
+ +-+-+ + +-+-+-+ + + + + +-+ + +-+-+-+ +-+ +-+-+-+ +-+ + + +-+ + + +-+-+ + + +-+-+-+ + + + + + +-+-+
|     | |       | | | | |   | |       |   |       |   | | |   | | |     | | |       | | | | | |     |
+ + + +-+-+-+-+-+ +-+ +-+-+ + + +-+ + + + + + +-+-+ + + +-+ +-+ + +-+ +-+ +-+-+ +-+-+-+-+ + + +-+ + +
| | |           |   |     | | |   | | | | | |     | | |   |   | |   |   |     |         | | |   | | |
+ +-+-+-+ +-+-+-+ + + +-+-+ +-+ + +-+-+-+ + + + +-+ +-+-+-+ + +-+ +-+ +-+-+ + + + +-+ +-+-+ + + +-+ +
|       |       | | |     |   | |       | | | |   |       | |   |   |     | | | |   |     | | |   | |
+ + + + + +-+-+ + +-+-+ + +-+-+-+-+ +-+-+ +-+-+ + +-+ + +-+ +-+-+-+-+-+-+-+ + +-+-+-+ + + +-+ +-+-+ +
| | | | |     | |     | |         |     |     | |   | |   |               | |       | | |   |     | |
+ +-+ +-+-+-+ + +-+ + + +-+ + + + +-+ + + +-+-+ +-+ + + + + +-+ + + + + +-+-+-+ + +-+-+ +-+ +-+-+-+ +
|   |       | |   | | |   | | | |   | | |     |   | | | | |   | | | | |       | |     |   |       | |
+ + + + +-+ + + +-+ + +-+-+-+ + + + +-+ + + +-+ +-+ + +-+ + +-+ + +-+-+-+-+ +-+ + +-+-+ +-+-+-+-+ + +
| | | |   | | |   | |       | | | |   | | |   |   | |   | |   | |         |   | |     |         | | |
+ +-+-+ + +-+-+-+ + +-+ +-+-+ + + +-+ + +-+ + + +-+ + +-+-+ +-+ +-+-+-+-+ +-+ + + +-+ +-+-+-+-+ + + +
|     | |       | |   |     | | |   | |   | | |   | |     |   |         |   | | |   |         | | | |
+ +-+-+ +-+-+ +-+ + + + + +-+ +-+-+ +-+ +-+ +-+-+ +-+ +-+-+ +-+ +-+-+-+ + + +-+-+-+ + + +-+ +-+ +-+ +
|     |     |   | | | | |   |     |   |   |     |   |     |   |       | | |       | | |   |   |   | |
+ + + + + + + +-+-+ + + +-+-+-+-+-+-+-+ + +-+-+ + +-+ +-+ +-+-+ +-+ +-+ + + +-+-+ + +-+-+-+-+ + + + +
| | | | | | |     | | |               | |     | |   |   |     |   |   | | |     | |         | | | | |
+ +-+ +-+ +-+-+-+-+-+ +-+-+-+ + +-+-+-+ + + + + + +-+-+ +-+ + +-+ + +-+-+-+-+-+ +-+ + + + + +-+-+-+-+
|   |   |           |       | |       | | | | | |     |   | |   | |           |   | | | | |         |
+ +-+-+-+-+ + + +-+-+-+ +-+ +-+-+-+ +-+ +-+ +-+ + +-+ + +-+ + + +-+ + + +-+ + +-+ +-+-+-+-+ +-+-+ +-+
|         | | |       |   |       |   |   |   | |   | |   | | |   | | |   | |   |         |     |   |
+ + + + +-+ + +-+ + + + +-+ + + +-+-+-+-+-+ +-+-+-+ + +-+-+-+-+-+-+-+-+-+ +-+ + + + + + +-+-+ +-+-+-+
| | | |   | |   | | | |   | | |           |       | |                   |   | | | | | |     |       |
+ + + + +-+-+-+ + + + + + +-+-+-+-+-+-+-+ + +-+ +-+-+-+-+ +-+ +-+ +-+-+-+ +-+ + + + + +-+ +-+-+ + + +
| | | |       | | | | | |               | |   |         |   |   |       |   | | | | |   |     | | | |
+ + + + + +-+ +-+-+-+ +-+-+-+-+ +-+-+ +-+ +-+-+-+ + +-+ +-+ +-+ +-+ + +-+ + + +-+ +-+-+ +-+-+-+-+ + +
| | | | |   |       |         |     |   |       | |   |   |   |   | |   | | |   |     |         | | |
+ +-+-+-+ +-+-+-+-+ + +-+-+-+ + + +-+ + + + + +-+-+-+-+ + +-+-+ +-+-+-+-+ + +-+ + +-+-+ +-+ + +-+-+-+
|       |         | |       | | |   | | | | |         | |     |         | |   | |     |   | |       |
+ +-+ + + +-+-+-+-+ + +-+-+ +-+-+-+-+ +-+-+-+ + +-+-+ + + + +-+-+ +-+ +-+-+ +-+-+-+ +-+ + +-+ +-+-+-+
|   | | |         | |     |         |       | |     | | | |     |   |     |       |   | |   |       |
+ +-+-+-+-+ +-+-+ + +-+ + +-+-+ + +-+-+-+ + + +-+-+-+ + + + +-+-+ + + + +-+ + +-+-+ +-+-+ + +-+ + +-+
|         |     | |   | |     | |       | | |       | | | |     | | | |   | |     |     | |   | |   |
+ +-+-+-+-+-+-+ + + + +-+-+ +-+-+ + +-+-+ +-+ + + +-+-+ + + +-+-+ +-+-+ +-+ + + +-+-+-+-+-+ +-+-+-+ +
|             | | | |     |     | |     |   | | |     | | |     |     |   | | |           |       | |
+ + + + +-+-+ +-+-+ + +-+ + +-+-+-+ + +-+ +-+-+-+ + + +-+-+ + +-+ + + +-+ + + + +-+-+ +-+-+ +-+ +-+-+
| | | |     |     | |   | |       | |   |       | | |     | |   | | |   | | | |     |     |   |     |
+ +-+-+-+ + + + + + + +-+ + + +-+ + + + +-+-+-+ + + + +-+-+-+ +-+ + + +-+-+-+ +-+ +-+-+ +-+-+ + + + +
|       | | | | | | |   | | |   | | | |       | | | |       |   | | |       |   |     |     | | | | |
+ +-+-+ +-+-+ + +-+-+ +-+-+-+ + + + +-+ +-+-+-+-+-+ +-+-+ + + +-+-+-+ +-+-+-+ + +-+-+-+-+-+-+ + + +-+
|     |     | |     |       | | | |   |           |     | | |       |       | |             | | |   |
+ +-+ + + +-+ + + +-+ + +-+-+ +-+ +-+ +-+-+ +-+-+-+ + + +-+ + +-+ +-+ + + +-+-+-+-+ + + +-+ +-+-+ + +
|   | | |   | | |   | |     |   |   |     |       | | |   | |   |   | | |         | | |   |     | | |
+ +-+ + + + +-+-+-+-+-+ +-+ + + +-+ +-+ + + +-+-+-+ +-+ +-+-+ +-+-+ +-+ +-+ + +-+-+-+ +-+-+ +-+-+-+ +
|   | | | |           |   | | |   |   | | |       |   |     |     |   |   | |       |     |       | |
+ +-+ +-+ + + + + +-+ +-+ +-+-+ + +-+ +-+ + + + + +-+-+-+ +-+ + +-+-+-+ + + +-+ +-+ + + +-+-+ +-+-+ +
|   |   | | | | |   |   |     | |   |   | | | | |       |   | |       | | |   |   | | |     |     | |
+ + +-+-+-+-+-+-+-+-+-+-+ + + +-+ +-+-+-+-+ + +-+ +-+ +-+-+-+-+ + +-+ + +-+ +-+-+-+-+-+ +-+-+-+-+-+-+
| |                     | | |   |         | |   |   |         | |   | |   |           |             |
+ +-+-+ +-+ + + + + +-+-+ +-+-+-+ + +-+-+-+-+ + +-+ +-+-+ + + +-+ +-+-+-+ + +-+-+-+ +-+-+-+ + +-+ +-+
|     |   | | | | |     |       | |         | |   |     | | |   |       | |       |       | |   |   |
+ +-+-+ + + + +-+-+-+-+ +-+-+-+ + +-+-+ +-+ + + + + + +-+ +-+ +-+-+ +-+-+ +-+-+-+ + + + +-+-+-+ +-+ +
|     | | | |         |       | |     |   | | | | | |   |   |     |     |       | | | |       |   | |
+ + + +-+ + +-+-+-+-+-+-+ +-+ +-+ + +-+-+-+-+ +-+ +-+ + + +-+-+ + +-+ +-+ +-+-+-+-+ +-+-+-+ + +-+ + +
| | |   | |             |   |   | |         |   |   | | |     | |   |   |         |       | |   | | |
+ +-+ + +-+ +-+-+ +-+ + +-+-+-+-+-+ +-+-+ + + + +-+-+ +-+-+ + +-+-+ +-+-+ + + + + +-+-+-+-+ + +-+-+ +
|   | |   |     |   | |           |     | | | |     |     | |     |     | | | | |         | |     | |
+ + +-+-+ +-+ + + + +-+-+-+-+-+ +-+ + +-+-+-+-+-+ +-+-+ + +-+-+-+ +-+-+-+-+-+ + +-+ +-+ +-+-+-+ + +-+
| |     |   | | | |           |   | |           |     | |       |           | |   |   |       | |   |
+ +-+ +-+-+-+-+-+-+-+ +-+-+ +-+-+ + + +-+-+-+-+-+-+-+-+-+-+ +-+ +-+ + + +-+-+-+-+ + + + +-+-+ + +-+ +
|   |               |     |     | | |                     |   |   | | |         | | | |     | |   | |
+ + +-+-+-+ + +-+ + +-+ +-+ + + + + +-+-+-+ +-+ +-+-+-+ + + + +-+-+ +-+-+-+ +-+-+-+-+ + + + + +-+-+ +
| |       | |   | |   |   | | | | |       |   |       | | | |     |       |         | | | | |     | |
+ + +-+-+ + + + +-+-+ +-+-+ +-+-+ + +-+-+-+-+-+-+ +-+-+-+ + +-+ +-+ +-+ +-+-+ +-+-+ +-+ +-+ + +-+-+-+
| |     | | | |     |     |     | |             |       | |   |   |   |     |     |   |   | |       |
+ + + +-+ + + +-+ + + +-+-+-+ + +-+ + +-+ +-+ + + +-+ +-+ +-+-+ + +-+ + +-+-+ + +-+ + +-+-+-+ + +-+ +
| | |   | | |   | | |       | |   | |   |   | | |   |   |     | |   | |     | |   | |       | |   | |
+ +-+-+ + + + +-+ +-+ + + + + + +-+ +-+ +-+-+-+ +-+-+-+ + + + + + + +-+-+-+-+ + + + +-+ +-+-+-+ +-+ +
|     | | | |   |   | | | | | |   |   |       |       | | | | | | |         | | | |   |       |   | |
+ +-+ + +-+ +-+-+ +-+ +-+ + +-+ + +-+-+ + +-+-+ +-+ + + + + + + +-+ + +-+-+-+ +-+ + + +-+ +-+-+ + + +
|   | |   |     |   |   | |   | |     | |     |   | | | | | | |   | |       |   | | |   |     | | | |
+ + +-+-+-+-+-+-+-+ +-+ + +-+-+ +-+ + + +-+ +-+-+-+ + +-+ + + +-+-+ +-+ + +-+-+ + +-+-+-+-+-+-+-+ +-+
| |               |   | |     |   | | |   |       | |   | | |     |   | |     | |               |   |
+ + +-+-+-+ + + + + +-+ +-+ +-+ +-+ + +-+-+-+-+-+-+-+-+ + +-+ +-+-+ + + + +-+ + +-+ +-+ +-+-+-+ + + +
| |       | | | | |   |   |   |   | |                 | |   |     | | | |   | |   |   |       | | | |
+ + +-+-+ +-+-+ + +-+ +-+ + + +-+-+ + + + + + + +-+-+ +-+ +-+-+-+-+-+ + + + +-+ +-+-+ + +-+ + +-+ + +
| |     |     | |   |   | | |     | | | | | | |     |   |           | | | |   |     | |   | |   | | |
+ +-+-+ + + + + + +-+-+ +-+-+ + +-+ +-+-+-+ +-+-+-+ + +-+ +-+-+-+ +-+ +-+-+ + + +-+ + + +-+ + + +-+ +
|     | | | | | |     |     | |   |       |       | |   |       |   |     | | |   | | |   | | |   | |
+ +-+-+ +-+-+ + + +-+ +-+ +-+-+ + +-+ +-+ + +-+-+ + + + + + + + + +-+-+ + +-+ + + + + + +-+-+ + +-+ +
|     |     | | |   |   |     | |   |   | |     | | | | | | | | |     | |   | | | | | |     | |   | |
+ + +-+ + +-+-+-+ + +-+ +-+ +-+ + +-+ + + + +-+ + + +-+ + + + + + +-+ +-+-+-+ + +-+-+ +-+ +-+-+ + + +
| |   | |       | |   |   |   | |   | | | |   | | |   | | | | | |   |       | |     |   |     | | | |
+ + + + + +-+-+ + + +-+ + + +-+-+ +-+-+ +-+ + +-+-+-+-+ + + +-+ +-+-+-+-+ +-+-+ +-+ +-+-+ +-+-+ +-+-+
| | | | |     | | |   | | |     |     |   | |         | | |   |         |     |   |     |     |     |
+ + +-+ +-+ + + +-+-+ + +-+ +-+-+-+ + +-+-+ +-+-+ +-+ + + +-+ + + + +-+-+-+ + +-+-+-+-+ + +-+ + + +-+
| |   |   | | |     | |   |       | |     |     |   | | |   | | | |       | |         | |   | | |   |
+ +-+-+-+-+ + +-+-+-+-+-+ +-+-+ +-+-+-+-+ +-+ + +-+ + + + + + + + + + + + + + +-+ +-+-+-+ + +-+ + +-+
|         | |           |     |         |   | |   | | | | | | | | | | | | | |   |       | |   | |   |
+ + + + + + + + + + + +-+-+ +-+ + + +-+ + +-+-+-+-+ +-+-+-+ + +-+-+ +-+ +-+-+ + + + +-+-+ +-+ +-+ + +
| | | | | | | | | | |     |   | | |   | |         |       | |     |   |     | | | |     |   |   | | |
+ +-+-+-+ +-+-+-+ +-+-+ + +-+-+-+ + + + + +-+ +-+-+-+ +-+ +-+ + + + +-+ + + + + + +-+ + +-+-+-+ + +-+
|       |       |     | |       | | | | |   |       |   |   | | | |   | | | | | |   | |       | |   |
+-+-+-+-+-+-+-+-+-+-+-+-+-+-+-+-+-+-+-+-+-+-+-+-+-+-+-+-+-+-+-+-+-+-+-+-+-+-+-+-+-+-+-+-+-+-+-+-+-+-+