+-+-+-+-+-+
|         |
+ + +-+ +-+
| |   |   |
+ +-+ +-+ +
|   |   | |
+ + +-+-+-+
| |       |
+ + +-+ +-+
| |   |   |
+-+-+-+-+-+