+-+-+-+-+-+-+-+-+-+-+-+-+-+-+-+-+-+
| |     |     |     |       |     |
+ + + + + +-+ + +-+ + +-+ + +-+-+ +
| | | |   |   |   |   |   |   |   |
+ +-+ +-+-+ +-+-+-+ +-+ +-+-+ + + +
|     |   | |     | |   |   | | | |
+-+-+-+ +-+ +-+ + +-+ +-+ +-+ + +-+
|   |       |   | |   | |   | |   |
+ + + +-+-+-+ +-+ + +-+ + + + +-+ +
| | |     |   | |   |     | |     |
+-+ +-+-+ + + + +-+-+ +-+-+ +-+-+ +
|       | | | | |   |   | |   |   |
+ + +-+-+ +-+ + + + +-+ + + +-+ +-+
| | |     |   | | |   |   |     | |
+ +-+ +-+-+ +-+ + + +-+-+ +-+-+-+ +
| |   |     |   | |   |   |       |
+ + +-+ +-+-+-+ + +-+ + +-+-+ +-+ +
| |     |       |   | |       |   |
+ +-+-+-+ + +-+ +-+ + +-+-+-+-+ +-+
|     |   |   |   | |         | | |
+ +-+-+ +-+-+ +-+-+ +-+ +-+-+-+ + +
| |   | |     |   | | | |     |   |
+ + + + + + +-+ + + + + + +-+ +-+ +
|   |   | | |   | | | |     |   | |
+ +-+-+-+ +-+ +-+ + + +-+-+-+ +-+ +
|   |   |     | |   |     |   |   |
+-+ + + +-+-+-+ +-+-+ +-+ + +-+ +-+
|   | |         |       | |     | |
+ +-+-+-+ +-+-+ +-+-+-+-+ +-+-+-+ +
| |     |   | |   |   |   |   |   |
+ +-+ + + + + +-+ + + + + + + + + +
| |   | | | |   |   |   |   | | | |
+ + +-+ +-+ + +-+-+-+-+-+-+-+ +-+ +
|   |       |                     |
+-+-+-+-+-+-+-+-+-+-+-+-+-+-+-+-+-+