+-+-+-+-+-+
| |       |
+ +-+-+ + +
|     | | |
+-+-+ + + +
| |   | | |
+ + +-+-+ +
| | |   | |
+ + + + + +
|     |   |
+-+-+-+-+-+