+-+-+-+-+-+
|         |
+-+-+-+-+ +
|       | |
+-+-+-+ + +
|.|.|.|   |
+-+-+-+-+-+
|.|.|.|.|.|
+-+-+-+-+-+
|.|.|.|.|.|
+-+-+-+-+-+
|.|.|.|.|.|
+-+-+-+-+-+
|.|.|.|.|.|
+-+-+-+-+-+
|.|.|.|.|.|
+-+-+-+-+-+
|.|.|.|.|.|
+-+-+-+-+-+
|.|.|.|.|.|
+-+-+-+-+-+
|.|.|.|.|.|
+-+-+-+-+-+
|.|.|.|.|.|
+-+-+-+-+-+
|.|.|.|.|.|
+-+-+-+-+-+
|.|.|.|.|.|
+-+-+-+-+-+
|.|.|.|.|.|
+-+-+-+-+-+
|.|.|.|.|.|
+-+-+-+-+-+
|.|.|.|.|.|
+-+-+-+-+-+
|.|.|.|.|.|
+-+-+-+-+-+
|.|.|.|.|.|
+-+-+-+-+-+
|.|.|.|.|.|
+-+-+-+-+-+
|.|.|.|.|.|
+-+-+-+-+-+
|.|.|.|.|.|
+-+-+-+-+-+
|.|.|.|.|.|
+-+-+-+-+-+
|.|.|.|.|.|
+-+-+-+-+-+
|.|.|.|.|.|
+-+-+-+-+-+
|.|.|.|.|.|
+-+-+-+-+-+
|.|.|.|.|.|
+-+-+-+-+-+
|.|.|.|.|.|
+-+-+-+-+-+
|.|.|.|.|.|
+-+-+-+-+-+
|.|.|.|.|.|
+-+-+-+-+-+