+-+-+-+-+-+-+-+-+-+-+-+-+-+-+-+-+-+-+-+-+-+-+-+-+-+-+-+-+-+-+-+-+-+-+-+-+-+-+-+-+
|                                                                               |
+ +-+-+-+ + +-+ +-+-+ + + + + +-+ +-+-+-+-+-+-+-+-+-+-+-+-+ +-+ + +-+ + + + + +-+
|       | |   |     | | | | |   |                         |   | |   | | | | |   |
+ +-+ +-+ + + +-+-+ + +-+ +-+-+-+ + +-+ + +-+ + + +-+ +-+-+-+ +-+ + +-+-+-+ +-+ +
|   |   | | |     | |   |       | |   | |   | | |   |       |   | |       |   | |
+ +-+ +-+-+-+ + +-+ + + + + +-+-+ + +-+ + + + + + +-+-+-+ +-+-+ +-+-+ + +-+ + +-+
|   |       | |   | | | | |     | |   | | | | | |       |     |     | |   | |   |
+ +-+-+ + + + + + +-+-+-+-+-+-+-+ +-+-+ +-+ +-+ +-+-+ + + + +-+-+-+-+-+-+ + +-+ +
|     | | | | | |               |     |   |   |     | | | |             | |   | |
+ +-+-+ + +-+-+ + +-+ + + +-+ +-+ + + +-+-+-+-+-+-+-+-+-+-+ +-+-+ + +-+ +-+ +-+ +
|     | |     | |   | | |   |   | | |                     |     | |   |   |   | |
+ +-+-+ + +-+-+-+ +-+-+-+-+-+ + +-+ +-+-+-+ + + + + +-+ +-+-+ + +-+ + +-+ + + + +
|     | |       |           | |   |       | | | | |   |     | |   | |   | | | | |
+ + +-+-+ +-+ + +-+-+-+ +-+-+-+-+-+-+ + +-+-+ + +-+ +-+-+-+-+-+ +-+ +-+ +-+ + +-+
| |     |   | |       |             | |     | |   |           |   |   |   | |   |
+ + +-+-+-+ +-+ +-+ + + +-+ + +-+-+-+ +-+ + +-+-+-+ + +-+ +-+ + + + +-+-+-+ +-+ +
| |       |   |   | | |   | |       |   | |       | |   |   | | | |       |   | |
+ +-+-+ + + +-+ + + + +-+ +-+ +-+ + +-+-+-+ + +-+-+ + + + + + +-+-+-+ + +-+ + + +
|     | | |   | | | |   |   |   | |       | |     | | | | | |       | |   | | | |
+ + + +-+-+ +-+ +-+ +-+ +-+ + +-+-+-+-+ +-+ +-+-+ + + +-+-+ + + + +-+ +-+ + +-+ +
| | |     |   |   |   |   | |         |   |     | | |     | | | |   |   | |   | |
+ + + +-+-+ + +-+ + + +-+ + + + +-+-+-+ + +-+ +-+ + +-+ +-+ + +-+-+ +-+-+ + +-+ +
| | |     | |   | | |   | | | |       | |   |   | |   |   | |     |     | |   | |
+ +-+ +-+-+ + + + +-+ +-+ +-+ + + +-+-+ + +-+ +-+-+-+-+-+ +-+ +-+-+-+ + +-+ +-+-+
|   |     | | | |   |   |   | | |     | |   |           |   |       | |   |     |
+ +-+-+ +-+-+-+ +-+ + + + +-+-+-+-+ +-+-+-+ +-+-+-+ + + + + + +-+ + + + +-+-+-+ +
|     |       |   | | | |         |       |       | | | | | |   | | | |       | |
+ + +-+ + +-+-+ +-+-+ +-+-+-+ +-+-+ + +-+-+-+ + +-+ + +-+-+-+ +-+ + + +-+ +-+ +-+
| |   | |     |     |       |     | |       | |   | |       |   | | |   |   |   |
+ + +-+ + + +-+ +-+ +-+-+ + +-+ +-+-+ + + + +-+ +-+-+ + +-+-+ +-+ +-+-+ + +-+ +-+
| |   | | |   |   |     | |   |     | | | |   |     | |     |   |     | |   |   |
+ +-+ +-+-+-+-+-+ + +-+ + +-+-+-+ +-+-+-+ +-+ +-+ + + +-+-+ +-+-+ + + + +-+ + + +
|   |           | |   | |       |       |   |   | | |     |     | | | |   | | | |
+ +-+ + +-+-+-+ + +-+ +-+-+ +-+ + + + + + + +-+ +-+-+ +-+ +-+ +-+ +-+-+ +-+-+ + +
|   | |       | |   |     |   | | | | | | |   |     |   |   |   |     |     | | |
+ + +-+-+ + + + +-+-+-+ + + + +-+ +-+-+ + + + +-+ + + +-+-+-+-+ + + + +-+-+ +-+-+
| |     | | | |       | | | |   |     | | | |   | | |         | | | |     |     |
+ +-+-+ +-+-+-+ + +-+ +-+ +-+-+ +-+ + +-+ +-+ +-+-+ + + +-+ +-+ + + +-+ +-+ +-+ +
|     |       | |   |   |     |   | |   |   |     | | |   |   | | |   |   |   | |
+ + + +-+ +-+-+-+-+ +-+-+-+ + +-+ + +-+-+ +-+-+-+-+-+ +-+-+ +-+-+-+-+ +-+-+-+-+ +
| | |   |         |       | |   | |     |           |     |         |         | |
+ + + + + + + + + +-+ +-+-+-+-+-+ + + +-+-+ + +-+ + + + +-+ + + +-+ + +-+ +-+-+-+
| | | | | | | | |   |           | | |     | |   | | | |   | | |   | |   |       |
+ +-+-+ +-+-+ + +-+-+ + +-+ + + + + +-+ + + + + + +-+-+ +-+-+-+-+ + +-+-+ +-+-+-+
|     |     | |     | |   | | | | |   | | | | | |     |         | |     |       |
+ +-+ + + + + +-+-+ + +-+-+ +-+ + + +-+-+-+-+ + +-+-+-+ +-+-+-+-+ +-+ + + +-+-+-+
|   | | | | |     | |     |   | | |         | |       |         |   | | |       |
+ + +-+-+ + +-+-+ + +-+ +-+ + + + +-+-+-+ +-+ + + + + + +-+-+ + + +-+ + + + + + +
| |     | |     | |   |   | | | |       |   | | | | | |     | | |   | | | | | | |
+ + +-+ + + + +-+ +-+ +-+ +-+-+-+-+ +-+ + + +-+-+ +-+ +-+-+ +-+-+ + + + + +-+-+-+
| |   | | | |   |   |   |         |   | | |     |   |     |     | | | | |       |
+ +-+-+-+ +-+-+ + + +-+-+-+-+ + + + + +-+ +-+-+-+-+-+ +-+-+ +-+ + + + +-+-+-+-+ +
|       |     | | |         | | | | |   |           |     |   | | | |         | |
+ + + + +-+ + +-+ +-+-+ +-+ + + + +-+ + +-+ +-+-+ +-+-+ +-+-+-+-+-+ + +-+ + +-+-+
| | | |   | |   |     |   | | | |   | |   |     |     |           | |   | |     |
+ +-+-+ +-+ +-+-+-+ +-+-+-+-+ + + + + +-+-+-+ + + +-+ + + +-+-+ +-+ + +-+ + +-+ +
|     |   |       |         | | | | |       | | |   | | |     |   | |   | |   | |
+ + +-+-+ + +-+ +-+-+ + +-+-+-+-+-+-+-+ +-+-+ + + + + +-+-+ +-+ + + + +-+-+ +-+-+
| |     | |   |     | |               |     | | | | |     |   | | | |     |     |
+ +-+-+ + + + + + + +-+ + + +-+ +-+-+ +-+-+-+ +-+ + +-+-+-+ +-+ + + +-+-+ +-+-+-+
|     | | | | | | |   | | |   |     |       |   | |       |   | | |     |       |
+ +-+-+-+-+ +-+ + + +-+ +-+ + +-+ + +-+-+ + + + + +-+-+-+-+-+-+ + + +-+ + + + + +
|         |   | | |   |   | |   | |     | | | | |             | | |   | | | | | |
+ +-+ +-+ + +-+ +-+-+-+ + +-+ + +-+ +-+ + +-+-+-+-+ +-+ +-+ + + +-+ +-+ +-+-+ +-+
|   |   | |   |       | |   | |   |   | |         |   |   | | |   |   |     |   |
+ + +-+ +-+ + +-+ +-+-+-+ +-+ +-+-+-+-+ + +-+-+-+-+ + +-+ + +-+ + + +-+-+ +-+ + +
| |   |   | |   |       |   |         | |         | |   | |   | | |     |   | | |
+ +-+ +-+ +-+-+-+ + +-+-+ +-+ +-+ + +-+ +-+-+-+ +-+ + +-+ +-+-+ + + + + +-+-+ + +
|   |   |       | |     |   |   | |   |       |   | |   |     | | | | |     | | |
+ +-+ + + +-+-+-+-+ + + +-+-+ + + +-+ +-+ + +-+-+-+ +-+ +-+-+ + + + + + + +-+-+ +
|   | | |         | | |     | | |   |   | |       |   |     | | | | | | |     | |
+ +-+ + + + +-+-+ + +-+ + + + +-+-+-+-+-+ + +-+-+-+ +-+ + +-+-+-+-+ +-+-+-+-+-+-+
|   | | | |     | |   | | | |           | |       |   | |         |             |
+ +-+-+-+-+-+ +-+-+ + + + +-+ + +-+ +-+-+-+-+ +-+-+ +-+-+-+-+-+ + + + + + +-+ + +
|           |     | | | |   | |   |         |     |           | | | | | |   | | |
+ + +-+-+ + + + +-+-+ +-+-+ +-+-+-+-+ + + +-+ +-+-+ + + +-+ + + + +-+ +-+ +-+ + +
| |     | | | |     |     |         | | |   |     | | |   | | | |   |   |   | | |
+ + + +-+ +-+-+-+ +-+-+ +-+ + + + +-+ + +-+-+-+ +-+ +-+-+ + + +-+-+-+-+-+-+-+ +-+
| | |   |       |     |   | | | |   | |       |   |     | | |               |   |
+-+-+-+-+-+-+-+-+-+-+-+-+-+-+-+-+-+-+-+-+-+-+-+-+-+-+-+-+-+-+-+-+-+-+-+-+-+-+-+-+