+-+-+-+-+-+-+-+
|     | |   | |
+-+ + + + +-+ +
|   |       | |
+ + +-+ +-+-+ +
| | |         |
+-+-+-+ + +-+ +
|     | |   | |
+-+-+ +-+-+ + +
| | |       | |
+ + + + +-+ + +
| |   | |   | |
+ +-+ + +-+ +-+
|     | |     |
+-+-+-+-+-+-+-+