+-+-+-+-+-+-+-+-+-+-+-+-+-+-+-+-+-+-+-+-+-+-+-+-+-+-+-+-+-+-+-+-+
|                                                               |
+ + +-+-+-+-+ + + + +-+ +-+ +-+ +-+ + + + + + +-+ +-+ + +-+ +-+ +
| |     |     | | | |     | |   |   | | | | | |     | |   | |   |
+ +-+ +-+ + + +-+-+ + +-+ +-+ + +-+ + +-+ +-+-+-+-+ +-+ + + +-+ +
|   | |   | |     | |   | |   | |   | |     |       |   | | |   |
+-+ +-+-+ + + + +-+ +-+-+-+-+ +-+-+ + + +-+-+ +-+-+ + +-+ +-+ + +
|       | | | |   |     |     |     | | |     |     | |     | | |
+-+ +-+-+ +-+ + + + + + + + + + + +-+-+ +-+ + + + + + + +-+ +-+ +
|     |   |   | | | | | | | | | |   |     | | | | | | | |     | |
+ + + + + +-+ +-+-+-+-+-+-+-+ +-+ + + +-+ + + + +-+-+ + +-+ +-+-+
| | | | | |   |               |   | | |   | | |   |   | |       |
+ +-+-+ +-+ +-+-+ +-+-+ +-+-+ + +-+ + +-+ + + + + + + + +-+-+ + +
|     |   | |         |     | | |   | |   | | | | | | |     | | |
+ + + + + + + +-+ + + + +-+ + + +-+ + + + +-+ +-+-+ +-+ + + + + +
| | | | | | |   | | | | |   | | |   | | |   | |       | | | | | |
+ +-+ +-+ + + + +-+ + +-+ +-+-+-+ +-+ + +-+ +-+ + + +-+ + + + + +
| |     | | | | |   |   |     |     | | |     | | |   | | | | | |
+-+ +-+ + +-+ +-+ + +-+ +-+ +-+ + + + + + + +-+ +-+ + + + + + + +
|     | | |   |   |   |   |   | | | | | | |   |   | | | | | | | |
+ + + + + +-+ + +-+ + +-+ +-+ +-+-+ +-+ +-+-+ +-+-+ + + + +-+ + +
| | | | |   | | |   | |   |       | |   |         | | | |   | | |
+ + + + + + +-+ + + +-+-+ +-+-+ +-+ +-+-+-+-+-+-+ + + + + + +-+ +
| | | | | |   | | | |     |       |       |       | | | | | |   |
+-+ + +-+ +-+ +-+ +-+ + + +-+-+ + + + +-+-+ +-+ +-+-+ + + + + + +
|   | |     |   |   | | |     | | | |   |   |       | | | | | | |
+ + + + + + + + +-+-+ + + + +-+-+ +-+ + +-+-+ + + +-+-+-+ +-+ + +
| | | | | | | | |     | | |     |   | | |     | |       |   | | |
+ + + +-+-+ +-+-+-+ + + + + + + +-+ + + + + +-+-+ +-+ +-+ +-+ + +
| | | |           | | | | | | |   | | | | |   |     | |     | | |
+ +-+ +-+ + +-+ + + + +-+ +-+ +-+ + + +-+-+ +-+-+-+-+ +-+ + + +-+
|   | |   | |   | | |   | |     | | |   |           |   | | |   |
+-+-+ +-+-+ + +-+ +-+ +-+ + + + + +-+-+ + + +-+-+ +-+ +-+ +-+-+-+
|     |     |   |   | |   | | | | |     | |     | |   |         |
+-+ + + +-+ + + + + + +-+-+ +-+-+ +-+-+ + + +-+ + + +-+ +-+ + +-+
|   | | |   | | | | |     |   |     |   | | |   | | |     | |   |
+-+-+-+ +-+ + + +-+ +-+ + +-+ + + + + + + +-+ +-+-+ + + +-+ + + +
|         | | | |     | |   | | | | | | | |   |     | |   | | | |
+ +-+ + + +-+ +-+ +-+ + + + +-+ + + +-+-+-+-+ +-+ + + + +-+-+ + +
|   | | | |   |     | | | | |   | |   |         | | | | |     | |
+ + + +-+ + + + +-+ + + + +-+-+ +-+-+ + + +-+ + + +-+ +-+ +-+-+-+
| | |   | | | |   | | | |     |     | | |   | | |   | |         |
+ + +-+-+-+ + + + + + + + +-+-+-+ + + + +-+ + + + +-+ + +-+ + + +
| | |       | | | | | | |       | | | | |   | | | |   | |   | | |
+ + + + + + +-+ + + + +-+ +-+-+ + +-+-+ + +-+-+ + + + + + + + + +
| | | | | | |   | | |   |     | | |     | |     | | | | | | | | |
+ + + +-+ + + + +-+-+ + + + + + +-+ + + + +-+ +-+ + +-+ + + + + +
| | | |   | | |   |   | | | | | |   | | | |     | |   | | | | | |
+ + +-+ + +-+ + +-+ + +-+ + + +-+-+ + + + + + +-+-+ +-+ + + +-+-+
| |   | |   | |   | |   | | |     | | | | | | |     |   | |     |
+ + +-+ + +-+ + +-+-+ + + + + + + +-+ + + + +-+ +-+ + +-+ + + + +
| |   | | |   | |     | | | | | |   | | | |   | |   |   | | | | |
+ + + + + +-+ + + + +-+-+ +-+-+ +-+ + +-+-+ + + + + + + + + + +-+
| | | | |   | | | | |       |   |   |   |   | | | | | | | | |   |
+ + +-+ +-+ + + + + + +-+ +-+ +-+-+ +-+ + +-+ + +-+ + +-+-+-+-+ +
| |   | |   | | | | |   | |     |   |   |   | | |   |         | |
+ +-+ +-+ + + + + + + +-+ +-+ +-+ +-+-+ + + +-+ + +-+ + + + +-+ +
| |   |   | | | | | | |     |   |   |   | | |   |   | | | |   | |
+-+-+ + + + + + + +-+ + + + +-+ +-+-+-+ +-+-+ + + + +-+-+-+ + + +
|     | | | | | |   | | | |   |   |         | | | |       | | | |
+ + + + +-+-+ + + +-+ + + +-+-+ + + + + +-+-+ + + + +-+ + + + + +
| | | |     | | |   | | | |     | | | |   |   | | | |   | | | | |
+ + +-+-+ + + + + + +-+-+-+-+ +-+ + + + + +-+-+ + +-+ + + + +-+ +
| |     | | | | | |   |       |   | | | |     | |   | | | |   | |
+-+-+-+-+-+-+-+-+-+-+-+-+-+-+-+-+-+-+-+-+-+-+-+-+-+-+-+-+-+-+-+-+