+-+-+-+-+-+-+-+-+-+-+-+-+-+-+-+-+-+-+-+-+-+-+-+-+-+-+-+-+-+-+-+-+
|                                                               |
+ + +-+-+-+ + + + +-+-+-+ + +-+-+ + +-+-+-+ + + + +-+-+ + + +-+-+
| |       | | | |       | |     | |       | | | |     | | |     |
+ + + +-+ + + + + +-+ +-+ +-+ +-+ + + + + +-+-+ + + + + +-+-+-+ +
| | |   | | | | |   |   |   |   | | | | |     | | | | |       | |
+ +-+-+ + +-+-+-+ +-+ + + + + +-+-+-+ + +-+ + +-+-+-+ +-+ + +-+ +
|     | |       |   | | | | |       | |   | |       |   | |   | |
+ +-+ + + +-+ +-+ + +-+-+ + +-+-+-+ + + +-+ +-+ + +-+ +-+-+-+ + +
|   | | |   |   | |     | |       | | |   |   | |   |       | | |
+ + + + + + + +-+-+-+ + + +-+ +-+ + +-+ +-+-+ +-+-+-+ +-+-+ + +-+
| | | | | | |       | | |   |   | |   |     |       |     | |   |
+ + + + +-+-+ + + +-+-+ + +-+ + +-+-+ + +-+ +-+ +-+-+-+-+-+-+ +-+
| | | |     | | |     | |   | |     | |   |   |             |   |
+ +-+-+ +-+-+ + + +-+-+ + +-+ + + + + +-+-+ + + +-+ + + + + +-+ +
|     |     | | |     | |   | | | | |     | | |   | | | | |   | |
+ + +-+ +-+-+ + +-+-+-+ + +-+ +-+-+-+-+ +-+ +-+-+-+ +-+-+-+ +-+ +
| |   |     | |       | |   |         |   |       |       |   | |
+ +-+-+-+-+ + +-+ + + +-+ +-+ +-+ +-+-+-+-+ + +-+-+ + + + +-+-+ +
|         | |   | | |   |   |   |         | |     | | | |     | |
+ +-+ +-+ +-+ +-+-+-+-+ + +-+-+ + +-+-+ + +-+ + + + + +-+-+-+-+ +
|   |   |   |         | |     | |     | |   | | | | |         | |
+ +-+-+-+-+ +-+ + + + +-+-+-+ + +-+-+ +-+-+ + + + + + +-+ + +-+ +
|         |   | | | |       | |     |     | | | | | |   | |   | |
+ + +-+ + +-+ +-+-+ + +-+-+-+ + + + +-+ +-+ +-+-+ +-+-+-+-+-+-+ +
| |   | |   |     | |       | | | |   |   |     |             | |
+ + + +-+-+-+ +-+ +-+ +-+ + + + +-+-+ +-+-+ +-+-+ + +-+ + +-+ +-+
| | |       |   |   |   | | | |     |     |     | |   | |   |   |
+ +-+-+-+-+ + +-+-+-+ + +-+-+-+-+-+ + +-+-+-+ + +-+ + + +-+ + + +
|         | |       | |           | |       | |   | | |   | | | |
+ + + +-+-+ +-+ +-+-+-+ +-+-+-+ + +-+-+-+-+-+ + + +-+-+ + +-+-+-+
| | |     |   |       |       | |           | | |     | |       |
+ +-+ + + + + +-+ + + +-+ +-+ + +-+ + +-+ + +-+ +-+-+-+ +-+-+-+ +
|   | | | | |   | | |   |   | |   | |   | |   |       |       | |
+ +-+ + + +-+-+ + +-+-+ +-+ +-+-+-+-+ + +-+-+-+-+-+-+ + + + +-+-+
|   | | |     | |     |   |         | |             | | | |     |
+ +-+ +-+ + + +-+ + +-+-+ + + + + +-+ + +-+ +-+ +-+-+-+ + +-+-+ +
|   |   | | |   | |     | | | | |   | |   |   |       | |     | |
+ + +-+-+-+-+-+-+ +-+-+-+-+-+-+-+-+-+ + +-+-+-+-+ + +-+ +-+-+ + +
| |             |                   | |         | |   |     | | |
+ + + +-+ + + +-+ + +-+-+-+-+-+-+-+ + + + + + +-+-+-+-+-+ + + +-+
| | |   | | |   | |               | | | | | |           | | |   |
+ +-+-+ +-+ + +-+ +-+-+ + +-+-+-+ +-+-+-+-+-+ +-+ +-+-+-+-+ + +-+
|     |   | |   |     | |       |           |   |         | |   |
+ +-+-+-+-+ +-+ +-+-+-+ + +-+-+ +-+-+ + +-+ +-+ +-+-+-+ + + + +-+
|         |   |       | |     |     | |   |   |       | | | |   |
+ +-+ +-+-+-+ + + + + + + +-+ +-+ +-+ + + +-+ +-+-+-+ +-+-+-+ +-+
|   |       | | | | | | |   |   |   | | |   |       |       |   |
+ +-+-+-+-+ +-+ +-+-+ +-+ + + +-+-+ + +-+-+ +-+ +-+-+ + + + + + +
|         |   |     |   | | |     | |     |   |     | | | | | | |
+ + +-+-+-+ +-+ +-+-+-+ +-+-+-+-+-+-+-+-+-+ + + + + +-+-+-+ +-+ +
| |       |   |       |                   | | | | |       |   | |
+ + + + +-+ +-+-+-+ + + + + +-+-+-+ +-+-+-+-+-+ +-+ + + +-+ +-+-+
| | | |   |       | | | | |       |           |   | | |   |     |
+ +-+-+ +-+ +-+ +-+-+-+ +-+ + +-+-+ + +-+ +-+-+-+ +-+-+ + +-+-+-+
|     |   |   |       |   | |     | |   |       |     | |       |
+ +-+-+-+-+-+-+-+ +-+-+ + +-+-+ +-+ + +-+ +-+ +-+ + +-+ +-+-+-+-+
|               |     | |     |   | |   |   |   | |   |         |
+ +-+-+ +-+-+-+-+-+-+-+ +-+ + +-+ + +-+ + +-+ +-+-+-+ +-+-+ + +-+
|     |               |   | |   | |   | |   |       |     | |   |
+ +-+-+-+-+ +-+ + + +-+ + + + + +-+-+-+ +-+-+-+-+-+-+ +-+ +-+ +-+
|         |   | | |   | | | | |       |             |   |   |   |
+ +-+-+-+-+ +-+ + + +-+ +-+-+-+ + +-+ + + +-+ + +-+ +-+ +-+-+ + +
|         |   | | |   |       | |   | | |   | |   |   |     | | |
+-+-+-+-+-+-+-+-+-+-+-+-+-+-+-+-+-+-+-+-+-+-+-+-+-+-+-+-+-+-+-+-+