+-+-+-+-+-+-+-+-+-+-+-+-+-+-+-+-+-+-+-+-+-+-+-+-+-+-+-+-+-+-+-+-+-+-+-+-+-+-+-+-+-+-+-+-+-+-+-+-+-+-+
| |     |               |             |     |             |               | |       |           |   |
+ +-+ + +-+-+-+-+ +-+-+ + +-+-+-+ +-+-+ +-+ + +-+-+ +-+-+ + +-+-+-+-+ +-+ + + +-+ + + +-+-+-+-+ + +-+
|     |           |   | |   |   | |     | |   |   |     | | |       | |   |     | |   |   |     |   |
+-+-+-+-+-+-+-+-+-+-+ + +-+ + + + + +-+-+ +-+-+ + + +-+ + + + +-+ +-+ + +-+-+ +-+ +-+-+ +-+ +-+-+ + +
|       |     |       |   |   | |           |   | | |   | |   | | |   |     | |   |     |   |     | |
+ +-+-+ + + + + +-+-+ +-+ +-+ +-+-+-+-+-+-+ + +-+ +-+ +-+ +-+-+ + + +-+-+-+ + + +-+ +-+ + +-+-+-+-+ +
|   | |   | | |   |   | | | | |       |   | | | |   | |   |   |   | |       | | | | |   |   |       |
+-+ + +-+-+ + +-+ + +-+ + + + + +-+-+ + + +-+ + +-+ + + +-+ +-+ +-+ +-+-+ +-+-+ + + + +-+-+ + +-+-+ +
| | |   |   |   | |     | | | | |   |   |   | |     | |   |     | |     |       | | |       | |     |
+ + + + + +-+-+ + + +-+-+ + + + +-+ +-+-+-+ + +-+ +-+ +-+ + +-+-+ +-+-+ + +-+-+-+ + +-+-+-+-+ + +-+-+
| |   | |     |   | |     |   |   |   |     |   |     |   |         |   | |   |   | |     |   |     |
+ +-+-+ +-+-+ +-+-+-+ +-+-+-+ +-+ + + + +-+-+ + +-+-+-+ +-+-+-+-+-+ + +-+ + + +-+ + +-+ + + + +-+-+-+
|   |   |   |   |     |     |   | | | |   |   | |     |     |       | |   | |   | | |   | | |       |
+ +-+ +-+ +-+-+ + +-+-+ +-+ + +-+ + + +-+ + +-+ + +-+-+-+-+ +-+-+-+ + + +-+ +-+ + + + +-+ +-+-+-+ + +
| |   |   |     |   |     | | |   | |     |   | | |     |         | | |   | |   | | | |         | | |
+ + +-+-+ + + +-+-+ + +-+ + +-+ +-+ +-+-+-+-+ + + + + +-+ +-+-+-+ +-+ +-+ + + +-+ + + +-+-+-+-+ +-+ +
| |       | | |     | |   |     | | |   |     | |   |       |   |     |   | | | |     |     | |   | |
+ +-+-+-+ + +-+ +-+-+-+ +-+-+-+-+ + + +-+ +-+-+ + +-+-+-+-+-+ + +-+-+-+ +-+ + + + +-+-+ +-+ + +-+ + +
|       | |     |       |         | |         | | |       |   | |     |   | | |     |     | |   |   |
+ + +-+-+ +-+-+-+-+-+ +-+ +-+-+-+ + +-+-+-+-+-+ +-+ +-+-+ + +-+ +-+ +-+ +-+ + +-+-+-+ +-+-+ + + +-+ +
| | |   | |         | |     |     | |         | |       |   |   |   |   |   |       | |     | |   | |
+ +-+ + + +-+-+-+ + + + +-+-+ +-+ + + +-+-+-+ + + +-+-+-+-+ + +-+ +-+ +-+ +-+-+-+-+ + + +-+-+ + +-+ +
|   | |   |       |   | | |   |   | | |     | |     |     | | | |     |   |   |   |   | |   | |   | |
+ + + +-+-+ +-+-+-+-+-+ + + +-+ +-+ + + +-+ + +-+ +-+ +-+ +-+ + + +-+-+ +-+-+ + + +-+-+ + + +-+-+ + +
| |   |     |         |   |   |   |   |   | |   | |   |   |   |   |     |   |   |   | |   |     | | |
+ +-+-+ + +-+ + +-+-+ +-+ +-+ +-+ +-+-+ + + +-+ +-+ +-+ +-+ +-+-+-+ +-+-+ + +-+-+ + + +-+-+-+-+ + + +
| | |   | |   |     | | | | |   | |     | | | |     |   | |       |   |   |   |   |     |   | | | | |
+ + + +-+ + +-+-+-+ + + + + +-+ +-+ +-+-+ + + +-+-+-+ +-+ + +-+-+ +-+ + +-+-+ + +-+-+-+ + + + + + + +
| |     | | |       | | | |   |     |   | |         |   |   |   |   |   |   | |     | |   |   | | | |
+ +-+-+-+ + + +-+-+-+ + + + + +-+-+-+ + + +-+-+-+-+ +-+ + +-+ + + +-+-+-+ + + +-+-+ + + +-+-+-+ + + +
|         | |   | |   | |   |   |   | |   |   |   |   | | |   | |         | | |     |   |       | | |
+-+-+-+-+-+-+-+ + + +-+ +-+-+-+ +-+ + +-+ + + + + +-+-+ + + +-+ +-+-+-+-+-+ + + +-+-+ +-+ +-+-+-+ + +
|   |           | | |       |   |   |   | | |   |       | | |   |         | |   |     | | |     |   |
+ +-+ +-+ +-+-+-+ + + +-+ + + +-+ + +-+ +-+ +-+-+-+-+-+-+ + + + +-+ +-+-+-+ +-+-+ +-+-+ + + +-+-+ +-+
|   |   | |         |   | | | |   | |   |   |     |       | | |   |       |     | |     | | |     | |
+ + +-+ + +-+ +-+-+-+ +-+ + + +-+ + + + + +-+-+ + + +-+-+-+-+ +-+ + +-+-+ +-+ + + + +-+ + + + +-+-+ +
| |   | |   |       | |   | |   | | | | | |     | |         | | | |     | |   | | |   | | |         |
+ +-+ + +-+ +-+-+-+ +-+ +-+-+-+ + + + +-+ + + +-+ +-+-+-+-+ + + + +-+-+-+ + + +-+ +-+-+ + +-+-+-+-+ +
|   |   |   |     |   |   |   | | | |     | | | |   |   | |   |   |       | | |   |     | |     |   |
+-+ +-+-+ +-+ +-+ +-+ +-+ + + + + + +-+-+-+ + + +-+ + + + +-+-+ +-+ +-+-+-+ +-+ +-+ +-+ + + +-+ + +-+
|   |   |   |   |   |   |   | |   |   |     | |   |   | |     | |   |   |   |   |   | | |   | | | | |
+ +-+ + +-+ +-+ +-+ +-+ +-+-+ +-+-+-+ +-+-+-+ + + +-+-+ + +-+-+ +-+ + + + +-+ +-+-+ + + +-+-+ + + + +
| |   |   | |   |     | |     |     |         | |   |   |           | | |           |       | | |   |
+ + +-+-+ + + +-+ +-+-+ + +-+ + +-+ +-+-+-+-+-+ +-+ + +-+ +-+-+-+-+-+ + +-+-+-+-+ +-+-+-+-+ + + +-+ +
|   |     | | |   |   |   |   | |     | |     |   |   |   |     |     |       |   |     |     |   | |
+-+-+ +-+-+ + + +-+ + +-+-+ +-+ +-+-+ + + + + +-+ +-+-+-+-+ +-+ + +-+-+-+-+-+ +-+-+ +-+ +-+-+ +-+ +-+
|   | |   | | |     |         |   | | |   | |   | |         | | | |     |   |     |   | |   |   |   |
+-+ + +-+ + +-+ +-+-+-+ +-+-+ +-+ + + +-+ + +-+ + + +-+-+-+-+ + + + +-+ + + +-+-+ + + + + + +-+ +-+ +
|   |   | |   |   |   | |   |     | |   | |   | |   | |       |   | |   | |   |   | | |   |   | |   |
+ +-+-+ + +-+ +-+-+ + +-+ + +-+-+-+ +-+ +-+-+ +-+-+-+ + +-+ + +-+-+ +-+-+ +-+ + +-+ + +-+-+-+ +-+ + +
|     | |   | |   | |     |   |     |   |   | |         |   |     |   |   | |   |   | |   | |     | |
+-+-+ + +-+ + + + + +-+-+-+-+ + +-+-+ +-+ + + + +-+-+-+-+ +-+-+-+ + + + +-+ +-+-+-+-+ + + + +-+-+-+ +
|   |       | | |     |       |   |   |   |   |   |     |       | | |   | |           | | |     |   |
+ + +-+-+-+-+ + +-+-+-+ +-+-+-+-+ + +-+ +-+-+-+-+ + +-+-+-+-+-+ +-+ +-+-+ + + +-+-+-+-+ + +-+ + + +-+
| |           |   | |   |       | | | |     |     |           |     |   |   |       |   |   | |   | |
+ +-+-+-+ +-+-+-+ + + +-+ +-+-+ + + + + +-+ + +-+-+ +-+-+ +-+ +-+-+-+-+ + +-+-+-+-+ + +-+-+ + +-+-+ +
| |       |       | |   | | |   |   |   |   | |   | |   |   |     |   |   |       |   |     | |     |
+ + +-+-+-+ +-+-+-+ +-+ + + + +-+ +-+-+-+ + + + + + +-+ +-+ +-+-+ + + +-+ +-+-+-+ +-+-+ +-+-+ + +-+ +
| |     | |         |   |   |   |         | |   | |       |     |   |   |             |   |   |   | |
+ +-+-+ + +-+ +-+-+-+ + + +-+-+ + +-+-+-+-+ +-+-+ + +-+-+-+-+ + +-+-+-+ +-+-+ +-+-+-+-+-+ + +-+-+-+ +
|   |   | |   |       | | |     | |       | |     | |       | | |     |     | |           |       | |
+-+ + +-+ + +-+ +-+-+ +-+ + +-+-+-+ +-+-+ +-+ +-+-+ + +-+-+ + + +-+ + +-+-+ +-+ +-+-+-+-+-+-+-+-+ + +
|   |     |   |     | |   | |       |   |     |     | |   | | |   | |   |       |     |   |     |   |
+ +-+-+-+ +-+ +-+-+ +-+ +-+ + +-+-+-+ + +-+-+-+ +-+-+ + + + + +-+ +-+ +-+ +-+-+-+-+-+ + + + +-+ +-+ +
|       |   |   | |     | |   |   |   |         |   | | |   |   |   |     |         |   |   |     | |
+ +-+-+ +-+ +-+ + +-+-+-+ +-+-+ + + +-+-+ +-+-+-+ + + + +-+-+-+ +-+ +-+-+ + +-+-+-+ + +-+-+-+ +-+-+ +
|     | |     |   |         | | |   |   | |       | | |       | | |     | |   |     |     | |       |
+-+-+ + +-+-+ +-+ +-+-+ +-+ + + +-+-+ + +-+ +-+-+-+ + +-+-+-+ + + +-+-+ +-+ +-+ +-+-+-+-+ + +-+-+-+-+
|     |     |   |       |   |     |   |   | |     |   | |   | | |   |   |   |   |       |   |       |
+ +-+-+-+-+ +-+ +-+-+-+-+ +-+ +-+-+ +-+-+ + + + +-+-+-+ + + + + + +-+ +-+ +-+ +-+ +-+-+-+-+ + + +-+ +
|   |   | | | |   |     |   | |     |   |   | |   |   |   | | | | |   |   | |   | |         | |   | |
+-+ + + + + + +-+ + +-+ +-+ +-+ +-+-+ +-+-+ +-+-+ + + + +-+ + + + + +-+ +-+ +-+ + + +-+-+-+-+ +-+ +-+
| |   |   | |   | | |     |   | |     |     |   |   |   |   | |   |       | |   | |     |   | | |   |
+ + +-+-+-+ + + + + +-+-+-+-+ + + + +-+ +-+-+ + +-+-+-+-+ +-+ + +-+-+-+-+ + + +-+ +-+-+ + +-+ + +-+ +
|   |       | |     |     |   | | |     |     |       |   |   | |     |     | |   |     | |   | |   |
+ +-+ +-+-+-+-+-+-+-+ +-+ + +-+ +-+ +-+-+ +-+-+-+-+-+ + + + +-+-+ +-+ +-+ +-+ + + + +-+-+ + +-+ + + +
|   |           |     | |   | |   | |     |     |   | | | | |   | | |   | |   | |   |     |   | | | |
+-+ +-+-+-+-+-+ + +-+-+ +-+-+ + + +-+ +-+-+ +-+ + +-+ + +-+ + + + + +-+ +-+ +-+ +-+-+ +-+-+-+ + + + +
| | |   |   |   |   |   |       |     |     |   |   | |       | | | |   |   | | | |     |     | | | |
+ + +-+ + + + + +-+ +-+ + +-+-+-+-+-+-+-+ +-+ +-+ + + +-+ +-+-+ + + + +-+ +-+ + + + +-+ + +-+-+ + + +
| | |   | |   |   | |   |   |       |     | | |   | |   | |   |   | |   | | |   |     |   |   | | | |
+ + + +-+ +-+-+ +-+ + +-+-+ + +-+ + +-+ +-+ + +-+-+ +-+ +-+ + +-+-+ +-+ + + + +-+-+-+ +-+-+ + + + +-+
| | |   |     | |   |       | |   |     |             |   | | |       |   | |     |         |   |   |
+ + + + +-+-+ + + +-+ +-+-+-+-+ +-+-+-+ +-+-+-+-+-+-+ +-+ + + +-+-+ + +-+-+ +-+-+ +-+-+-+ +-+-+ +-+ +
|   | |     | | |   |   |       | |     |   |         |   | | |     |           | |     | |   | |   |
+ +-+ +-+ +-+ +-+-+ +-+ + + +-+-+ + +-+-+ + +-+-+ +-+-+ + + + + +-+-+-+-+ +-+-+ + + +-+ +-+ + + + + +
| |     |   |     |   | | | |       |   | |     | |   | | | | |     |     |   | |   | |     | | | | |
+ +-+-+ +-+ +-+-+ +-+ + +-+ +-+-+-+-+ + + +-+-+ +-+ + + +-+ + + +-+ +-+-+-+ + +-+-+-+ +-+-+-+ +-+ + +
|     |   |     |     |   | |       | |   |   |     | |     | |   |         |           | |   |   | |
+-+-+ +-+-+-+-+ +-+-+-+-+ + + +-+-+ + +-+-+ + +-+-+-+ + +-+-+ +-+-+ +-+-+-+-+-+-+-+ +-+ + + +-+ +-+ +
|   |         |             | |   | | |     | |     | |     |     |   | |       | | |     |   |   | |
+ +-+-+-+-+-+ +-+-+ +-+-+-+-+ + +-+ + +-+-+ +-+ + +-+ +-+-+-+-+ + +-+ + + +-+ + + + +-+-+ +-+ + + + +
|     |     | |   | | |       |     |     | |   |   |         | | | | | |   | |   |     |   | | | | |
+ + + + +-+-+ + + + + + +-+-+-+ +-+-+-+-+ + + +-+-+ +-+-+-+-+ + + + + + + +-+ +-+ +-+-+ +-+ + +-+ + +
| | |   |     | | |   | |       |         | |   |   |   |     | | |   |   |   | | |     |   |   | | |
+ + +-+-+ +-+-+ + +-+-+ + +-+-+-+-+ +-+-+-+ +-+ + + + + + +-+-+-+ + +-+ +-+ +-+ + + +-+-+-+-+-+ + + +
| | |   |   |   |   |   | |         |           | | | |   |   |   | |   |   |   | |           | | | |
+ + + + +-+ + +-+-+ + +-+ + +-+-+-+-+ +-+-+-+-+-+ +-+ +-+-+ + + +-+ +-+-+ +-+ + + +-+-+-+-+-+ + + + +
| |   |       |       |     |                   |           |   |         |   |             |     | |
+-+-+-+-+-+-+-+-+-+-+-+-+-+-+-+-+-+-+-+-+-+-+-+-+-+-+-+-+-+-+-+-+-+-+-+-+-+-+-+-+-+-+-+-+-+-+-+-+-+-+