+-+-+-+-+-+-+-+
|             |
+ + +-+-+-+ + +
| | |     | | |
+ +-+ +-+ + +-+
|   |   | |   |
+-+ + +-+ +-+ +
|     |     | |
+-+-+-+ + +-+-+
|       | |   |
+ + +-+ +-+ +-+
| |   |       |
+ + +-+-+ +-+ +
| |   |   |   |
+-+-+-+-+-+-+-+