+-+-+-+-+-+-+-+
|             |
+ +-+ + + + +-+
|   | | | |   |
+ +-+-+ +-+-+-+
|     | | | | |
+-+-+-+-+-+-+-+
| | | | | | | |
+-+-+-+-+-+-+-+
| | | | | | | |
+-+-+-+-+-+-+-+
| | | | | | | |
+-+-+-+-+-+-+-+
| | | | | | | |
+-+-+-+-+-+-+-+