+-+-+-+-+-+-+-+-+-+-+-+-+-+-+-+-+-+-+-+-+-+-+-+-+-+
|                                                 |
+ + + + + + + + + + + + + + + + + +-+-+-+-+ + +-+ +
| | | | | | | | | | | | | | | | |       |   | |   |
+ + +-+ +-+ + + +-+ + + +-+-+ + + + + + + + +-+ + +
| | |   |   | |   | | |     | | | | | | | | |   | |
+-+ + + + +-+-+ +-+-+-+ + +-+-+ + + +-+ + + + +-+ +
|   | | |   |         | |   |   | |   | | | |   | |
+ + +-+ + + + + + + +-+ +-+ +-+-+ + + + +-+-+-+ + +
| |   | | | | | | |   |   |   |   | | | |       | |
+ + + + +-+-+ + + + +-+-+ +-+-+ + + +-+ + + +-+ +-+
| | | | |     | | | |       |   | | |   | |   |   |
+ + + + + +-+-+ +-+ + + +-+ + + + + + +-+ + + + + +
| | | | |   |     | | | |   | | | | | |   | | | | |
+-+ + + + +-+-+-+ +-+ +-+ +-+-+ +-+ + + + + +-+-+ +
|   | | |   |       | |       | |   | | | | |     |
+ + + + +-+-+-+ + + + +-+ + +-+ + + +-+ + +-+ +-+-+
| | | | |       | | |   | |   | | | |   | |       |
+ +-+-+ + + + + +-+ +-+-+-+ + + + + + + +-+ + + + +
| |     | | | |   |       | | | | | | | |   | | | |
+-+ + + + +-+ + + +-+ + + + + + +-+-+ +-+ + + + +-+
|   | | | |   | | |   | | | | | |     |   | | |   |
+ + +-+ +-+ + + +-+ + + + + + + +-+ + + + + + +-+ +
| |   | |   | | |   | | | | | |   | | | | | | |   |
+-+ + + +-+-+-+ + + +-+ +-+ + + +-+ + + +-+ + + + +
|   | |   |     | | |   |   | |   | | | |   | | | |
+-+ + +-+-+-+ +-+-+-+-+ + + + +-+-+-+ + + +-+-+-+ +
|   |     |   |         | | | |       | |   |     |
+-+ +-+ + +-+-+ +-+ + +-+-+-+ +-+ + + + + + + + + +
|   |   |     |   | | |         | | | | | | | | | |
+ + +-+-+ + + + + + + + + + + +-+ +-+ + +-+-+ + + +
| | |     | | | | | | | | | | |   |   | |     | | |
+ +-+ + + + + + +-+ + + + + +-+ + + +-+-+ + + + + +
| |   | | | | |   | | | | |   | | |   |   | | | | |
+-+ + + + + + + + +-+-+ + +-+ + +-+ +-+-+ + + +-+ +
|   | | | | | | |     | | |   | |     |   | | |   |
+-+ +-+ +-+-+ + + + + + + +-+ +-+ + + + +-+ + + + +
|     |   |   | | | | | |   | |   | | |   | | | | |
+ + + + + +-+ +-+-+ + + + +-+ +-+-+ +-+-+ +-+ + + +
| | | | | |       | | | |   | |     |       | | | |
+ + + +-+ +-+-+ + +-+-+ + + +-+ + + +-+ +-+ +-+ + +
| | |   |     | | |     | |   | | | |     |   | | |
+ + +-+ + + + +-+ + + + + + +-+-+-+ +-+ + +-+ + + +
| | |   | | | |   | | | | |       | |   | |   | | |
+ +-+-+ +-+ +-+ + + + + + + +-+ +-+ +-+ + +-+-+-+ +
| |       |   | | | | | | | |     | |   |   |     |
+-+ + + + + +-+-+ + +-+ + +-+ + + + +-+ +-+-+ + + +
|   | | | |     | |   | |   | | | | |       | | | |
+-+ +-+ + + + + + + + + +-+ +-+ +-+ +-+ + + +-+ +-+
|     | | | | | | | | | |   |     |   | | | |     |
+-+-+-+-+-+-+-+-+-+-+-+-+-+-+-+-+-+-+-+-+-+-+-+-+-+