+-+-+-+-+-+-+-+-+-+-+-+-+-+
|   |   |   |       |     |
+-+ + + + + + + +-+ + + + +
|   | |   |   | |   | | | |
+ +-+ +-+-+-+-+ +-+ +-+ + +
| |   |   |   |   |     | |
+ + +-+ + + + +-+ +-+-+-+-+
| |     | | |   |         |
+ +-+-+-+ +-+-+ +-+-+-+-+ +
| |     |   |   |     |   |
+ +-+-+ +-+ + + + + +-+ + +
| |       |   | | |   | | |
+ + +-+-+-+-+-+ +-+-+ + +-+
| |   |         |   | |   |
+ +-+ + +-+-+-+ + + + +-+ +
|   |     |   |   |     | |
+-+ + +-+-+ + +-+-+-+-+-+ +
| | |   |   |           | |
+ + +-+-+ +-+-+-+-+-+-+ + +
|   |   |             | | |
+ +-+ + + +-+-+-+-+-+ + + +
|   | | |     |     | | | |
+-+ + + +-+-+-+ +-+ + + + +
| |   |       |   |   |   |
+ +-+-+-+-+-+ +-+ +-+-+-+ +
|                 |       |
+-+-+-+-+-+-+-+-+-+-+-+-+-+