+-+-+-+-+-+-+-+-+-+-+-+-+-+-+-+-+-+-+-+-+-+-+-+-+-+-+-+-+-+-+-+-+-+-+-+-+-+-+-+-+-+-+-+-+-+-+-+-+-+-+
|                                                                                                   |
+ +-+-+ +-+ +-+ +-+ +-+ + + +-+-+-+-+ +-+ + +-+ +-+ +-+ +-+-+-+-+-+-+ + + +-+ +-+-+ +-+ +-+ + +-+-+-+
|     |   |   |   |   | | |         |   | |   |   |   |             | | |   |     |   |   | |       |
+ +-+ +-+-+ + +-+ +-+ +-+ + + + +-+ + + +-+ + +-+-+ + + + +-+ + +-+-+-+-+ +-+ +-+ + +-+-+ + + +-+-+ +
|   |     | |   |   |   | | | |   | | |   | |     | | | |   | |         |   |   | |     | | |     | |
+ + + + + +-+-+-+-+ +-+ + +-+ +-+-+ + + + + +-+ + +-+-+-+ +-+ +-+ + +-+-+-+-+-+-+-+-+ +-+-+ + +-+ +-+
| | | | |         |   | |   |     | | | | |   | |       |   |   | |                 |     | |   |   |
+ + +-+ + + + + +-+ +-+ +-+-+-+-+-+-+-+-+-+ +-+ +-+-+-+-+-+-+-+-+ +-+-+ + +-+-+-+-+ +-+ + +-+-+-+-+ +
| |   | | | | |   |   |                   |   |                 |     | |         |   | |         | |
+ + +-+-+ + + +-+-+ +-+-+ +-+-+-+ +-+-+ +-+-+ + + +-+-+ +-+ +-+-+-+ + +-+ + +-+-+ + + +-+-+-+-+ + +-+
| |     | | |     |     |       |     |     | | |     |   |       | |   | |     | | |         | |   |
+ + + + + + + +-+ +-+-+ + +-+ +-+-+ + + + +-+-+ + +-+-+ + +-+ + + +-+-+ +-+ +-+ +-+-+ + + +-+ + +-+-+
| | | | | | |   |     | |   |     | | | |     | |     | |   | | |     |   |   |     | | |   | |     |
+ + +-+ +-+-+ + + +-+-+ +-+ + + + + + + +-+ +-+ +-+-+-+-+-+ + +-+-+-+-+-+-+ + +-+-+-+-+ +-+-+-+ +-+ +
| |   |     | | |     |   | | | | | | |   |   |           | |             | |         |       |   | |
+ + + +-+-+ +-+-+ + +-+-+-+-+-+-+-+-+ + +-+ +-+-+-+ +-+-+ +-+ +-+-+-+ + +-+-+ + + + + +-+ + +-+ + +-+
| | |     |     | |                 | |   |       |     |   |       | |     | | | | |   | |   | |   |
+ + +-+-+ + + + + + +-+-+ +-+ +-+-+ + +-+-+ +-+-+ + + + + +-+-+-+-+-+-+ +-+-+-+ +-+-+-+ + + + + +-+ +
| |     | | | | | |     |   |     | |     |     | | | | |             |       |       | | | | |   | |
+ +-+-+-+-+ +-+ + + +-+-+-+ +-+ + +-+ + + + + + + + +-+ +-+ +-+-+ +-+ +-+-+-+-+-+ + +-+-+-+ +-+-+-+ +
|         |   | | |       |   | |   | | | | | | | |   |   |     |   |           | |       |       | |
+ + +-+ +-+ + + + +-+-+-+-+-+-+ +-+-+-+-+-+ + + +-+ +-+ + +-+-+ +-+-+ +-+ +-+-+-+-+ +-+ + +-+-+ + +-+
| |   |   | | | |             |           | | |   |   | |     |     |   |         |   | |     | |   |
+ + +-+ +-+-+-+-+ +-+ +-+ +-+-+-+-+-+-+ +-+-+ +-+ +-+-+ + +-+ +-+-+ + + + +-+ +-+-+ + +-+-+ + + +-+ +
| |   |         |   |   |             |     |   |     | |   |     | | | |   |     | |     | | |   | |
+ +-+-+ + + + +-+ + +-+-+-+ + +-+-+-+ + +-+-+-+-+ +-+ + +-+ + +-+ +-+-+-+-+-+-+-+ + + + + +-+-+ +-+ +
|     | | | |   | |       | |       | |         |   | |   | |   |               | | | | |     |   | |
+ +-+ + +-+-+-+ + +-+-+ + +-+ +-+ + + + +-+ +-+ +-+-+-+-+ +-+ +-+ +-+-+-+ + +-+-+-+-+-+-+ + + +-+ + +
|   | |       | |     | |   |   | | | |   |   |         |   |   |       | |             | | |   | | |
+ +-+-+-+ + +-+ + +-+ +-+-+-+-+-+ +-+ +-+ +-+ + +-+ +-+-+-+ + + + + + + + +-+ +-+ + + +-+ +-+-+ +-+ +
|       | |   | |   |           |   |   |   | |   |       | | | | | | | |   |   | | |   |     |   | |
+ + + +-+-+ + +-+ +-+ + + + +-+-+-+ + + + + + + + +-+-+-+ +-+ + +-+ + + +-+ + + + +-+ +-+ +-+-+ +-+ +
| | |     | |   |   | | | |       | | | | | | | |       |   | |   | | |   | | | |   |   |     |   | |
+ +-+ + + +-+ + + + + + +-+-+-+-+-+-+ + +-+-+-+ +-+ +-+ +-+ +-+ + + + + +-+-+-+-+ +-+ + +-+ + +-+ + +
|   | | |   | | | | | |             | |       |   |   |   |   | | | | |         |   | |   | |   | | |
+ +-+-+-+ + +-+ + +-+-+-+-+ + + + + +-+ + + + +-+-+ + +-+-+ +-+ + + +-+ + + + +-+ +-+ +-+-+ +-+ + +-+
|       | |   | |         | | | | |   | | | |     | |     |   | | |   | | | |   |   |     |   | |   |
+ + +-+-+ +-+ + + + + + +-+ + +-+-+-+ +-+-+-+ + +-+-+-+-+ +-+ +-+ + + + + + +-+ + +-+-+-+-+ +-+ + + +
| |     |   | | | | | |   | |       |       | |         |   |   | | | | | |   | |         |   | | | |
+ + + + + + +-+-+-+-+ + + + +-+-+ +-+-+-+ + + + + +-+-+-+ + +-+-+ + +-+-+-+ + + +-+-+ + +-+-+-+-+-+ +
| | | | | |         | | | |     |       | | | | |       | |     | |       | | |     | |           | |
+ + + + + +-+-+ + + + + +-+-+ +-+-+ + +-+-+-+-+ +-+-+-+ + +-+ + +-+ + +-+-+ + +-+ + + + +-+-+ +-+-+ +
| | | | |     | | | | |     |     | |         |       | |   | |   | |     | |   | | | |     |     | |
+ +-+-+-+ + + +-+ + +-+-+-+ +-+ + + +-+ +-+-+-+-+ + + +-+-+-+-+ + + +-+-+-+ + + +-+-+-+-+ +-+-+-+-+-+
|       | | |   | |       |   | | |   |         | | |         | | |       | | |         |           |
+ + + +-+-+-+-+-+ +-+ + + + + + +-+ + +-+ + +-+-+ + +-+-+ + + +-+ +-+ +-+ + + + + +-+-+ + +-+ +-+-+ +
| | |           |   | | | | | |   | |   | |     | |     | | |   |   |   | | | | |     | |   |     | |
+ + + + +-+ +-+ +-+ +-+ +-+-+-+ +-+-+-+ +-+-+-+-+-+-+-+ + + +-+ +-+-+ + + + + + + +-+ + +-+ + + +-+ +
| | | |   |   |   |   |       |       |               | | |   |     | | | | | | |   | |   | | |   | |
+ + + + + +-+-+ +-+ + + + +-+-+ + +-+ + +-+ + +-+-+-+ + + +-+ + + +-+-+ +-+-+ + +-+-+ +-+-+-+-+-+-+-+
| | | | |     |   | | | |     | |   | |   | |       | | |   | | |     |     | |     |               |
+ + +-+-+ + +-+-+ +-+ + + + +-+ + + + +-+-+-+ +-+-+-+ +-+-+ + + + + + +-+-+ + +-+-+ +-+ +-+ +-+-+ + +
| |     | |     |   | | | |   | | | |       |       |     | | | | | |     | |     |   |   |     | | |
+ + +-+ + +-+ +-+ +-+ +-+ +-+-+ + +-+-+-+ + + +-+-+-+-+ +-+ + + + + + +-+ + +-+ + +-+ + +-+ + +-+ + +
| |   | |   |   |   |   |     | |       | | |         |   | | | | | |   | |   | |   | |   | |   | | |
+ + + + + +-+-+-+-+ + + +-+ + + +-+ +-+-+ + + + + +-+-+ +-+-+ + +-+-+ + + + + +-+ +-+ + + + +-+ + +-+
| | | | |         | | |   | | |   |     | | | | |     |     | |     | | | | |   |   | | | |   | |   |
+ +-+-+ +-+-+ +-+ + + +-+-+-+-+ +-+-+-+ + +-+-+ + + +-+ + + + + +-+ + + +-+-+-+ +-+-+-+-+-+-+-+-+-+-+
|     |     |   | | |         |       | |     | | |   | | | | |   | | |       |                     |
+ + +-+-+ +-+ + + +-+-+-+-+-+ +-+-+-+ + +-+-+-+-+-+-+-+-+ + + + +-+ +-+-+-+-+ + + +-+-+ + + +-+-+-+-+
| |     |   | | |           |       | |                 | | | |   |         | | |     | | |         |
+ + +-+ +-+ +-+-+ + +-+-+ + + + +-+-+ + +-+ + +-+-+ + +-+-+-+-+-+-+-+-+-+ + + + + +-+ +-+-+-+-+ +-+ +
| |   |   |     | |     | | | |     | |   | |     | |                   | | | | |   |         |   | |
+ +-+ +-+ + +-+ + + +-+ + +-+-+-+ +-+-+-+ +-+-+-+-+-+-+ + + + + + + +-+ + +-+-+ +-+ + +-+ + + + + +-+
|   |   | |   | | |   | |       |       |             | | | | | | |   | |     |   | |   | | | | |   |
+ +-+ + +-+-+ +-+-+-+ +-+-+ + + +-+ +-+-+ + + + + +-+ + +-+ +-+ +-+ + +-+-+-+-+ +-+-+ + +-+ +-+ +-+ +
|   | |     |       |     | | |   |     | | | | |   | |   |   |   | |         |     | |   |   |   | |
+ + + +-+ +-+-+ + +-+ + +-+-+-+-+-+ +-+ +-+-+-+-+-+ + +-+ + + +-+ +-+ + +-+-+-+-+-+ + + + + + +-+ + +
| | |   |     | |   | |           |   |           | |   | | |   |   | |           | | | | | |   | | |
+ +-+-+ +-+-+-+ +-+-+ +-+ +-+-+-+-+ + +-+ + + +-+-+-+ + + + +-+-+ + + +-+ +-+ + +-+-+-+-+-+ +-+-+ +-+
|     |       |     |   |         | |   | | |       | | | |     | | |   |   | |           |     |   |
+ + + +-+ +-+ + + + + +-+-+-+ + + +-+ +-+ + +-+-+ + + +-+-+ + + + +-+-+-+ +-+ +-+ +-+-+ +-+ +-+ +-+-+
| | |   |   | | | | |       | | |   |   | |     | | |     | | | |       |   |   |     |   |   |     |
+ + + +-+ +-+ + + + + + +-+ +-+-+ +-+ +-+-+-+-+ +-+-+-+ + +-+-+ +-+-+ +-+ + +-+-+-+ + +-+ + + +-+-+ +
| | |   |   | | | | | |   |     |   |         |       | |     |     |   | |       | |   | | |     | |
+ +-+-+ + + + +-+ + + + +-+ +-+-+ +-+ + + +-+ +-+-+ + +-+-+-+ +-+ +-+ + +-+-+ + + +-+-+-+ + +-+ + +-+
|     | | | |   | | | |   |     |   | | |   |     | |       |   |   | |     | | |       | |   | |   |
+ + +-+-+ +-+ +-+ + +-+-+ + +-+-+-+ +-+ +-+-+-+-+ + + + +-+ +-+ +-+-+ +-+ + +-+-+-+-+ + +-+-+ +-+ + +
| |     |   |   | |     | |       |   |         | | | |   |   |     |   | |         | |     |   | | |
+ +-+-+-+ + + + +-+ + + + +-+-+ + + +-+-+ +-+-+ +-+ + +-+-+ + +-+-+ + + +-+ +-+ +-+ + + +-+-+-+ + +-+
|       | | | |   | | | |     | | |     |     |   | |     | |     | | |   |   |   | | |       | |   |
+ + + +-+ +-+-+ + + + + +-+ +-+-+ + + +-+ +-+ +-+ +-+-+ +-+ +-+ +-+ + + + +-+-+-+ + + + + + +-+-+-+ +
| | |   |     | | | | |   |     | | |   |   |   |     |   |   |   | | | |       | | | | | |       | |
+ + +-+ + + + +-+ +-+-+ +-+ + + + + + + +-+ +-+-+ + + +-+-+ +-+-+ + + + +-+-+ +-+-+-+-+-+-+-+-+-+-+-+
| |   | | | |   |     |   | | | | | | |   |     | | |     |     | | | |     |                       |
+ +-+-+ + + + +-+-+-+ + + + + +-+ +-+ + + + +-+-+-+ +-+-+ + +-+-+ +-+-+-+-+ + + +-+-+ +-+-+-+-+-+ +-+
|     | | | |       | | | | |   |   | | | |       |     | |     |         | | |     |           |   |
+ + +-+ +-+ +-+-+ +-+ +-+-+-+-+ + +-+-+ +-+-+-+-+-+ +-+ + +-+ +-+ +-+ +-+ + + + + +-+-+ +-+ +-+ +-+ +
| |   |   |     |   |         | |     |           |   | |   |   |   |   | | | | |     |   |   |   | |
+ + + +-+ +-+ +-+ + + + + +-+ + +-+ +-+ +-+-+-+-+ + +-+ +-+-+ +-+ + +-+-+ + +-+ + +-+ +-+-+-+ +-+ + +
| | |   |   |   | | | | |   | |   |   |         | |   |     |   | |     | |   | |   |       |   | | |
+ +-+ +-+ + + +-+ + +-+ +-+-+-+ +-+-+ +-+-+ + +-+ +-+ +-+-+-+-+ + +-+-+-+ + +-+ + + +-+-+-+ + +-+-+ +
|   |   | | |   | |   |       |     |     | |   |   |         | |       | |   | | |       | |     | |
+ +-+-+-+ +-+-+ +-+ + + + + + +-+ + + + +-+ + + + +-+ + +-+ +-+-+-+ + + + + + +-+-+-+ +-+ + + + + +-+
|       |     |   | | | | | |   | | | |   | | | |   | |   |       | | | | | |       |   | | | | |   |
+ +-+ + + + + +-+ + +-+ + + +-+ +-+-+ + +-+-+ + + +-+-+ +-+-+-+-+-+ +-+ +-+ + +-+-+-+-+-+-+-+-+ +-+-+
|   | | | | |   | |   | | |   |     | |     | | |     |           |   |   | |                 |     |
+ +-+ +-+-+-+ +-+-+-+-+ + +-+ +-+ +-+ + +-+-+ +-+ + + +-+ + +-+-+ +-+-+-+ + + +-+ +-+ +-+ +-+-+-+-+ +
|   |       |         | |   |   |   | |     |   | | |   | |     |       | | |   |   |   |         | |
+-+-+-+-+-+-+-+-+-+-+-+-+-+-+-+-+-+-+-+-+-+-+-+-+-+-+-+-+-+-+-+-+-+-+-+-+-+-+-+-+-+-+-+-+-+-+-+-+-+-+