+-+-+-+-+-+-+-+
| |   | |   | |
+ +-+ + + + + +
|   |   | | | |
+-+ + + + +-+ +
|     | | | | |
+-+-+ + + + + +
|     | |     |
+-+-+-+ +-+-+ +
|           | |
+ +-+ +-+ +-+ +
| |     | |   |
+-+ +-+-+ + +-+
|   |         |
+-+-+-+-+-+-+-+