+-+-+-+-+-+
|         |
+ + +-+ +-+
| |   |   |
+ +-+ + + +
|   | | | |
+ +-+-+ +-+
|     |   |
+ +-+-+ +-+
|     |   |
+-+-+-+-+-+