+-+-+-+-+-+
|       | |
+-+-+ + + +
|     |   |
+-+-+ +-+ +
| |   |   |
+ + + +-+-+
|   |   | |
+ + +-+ + +
| |   |   |
+-+-+-+-+-+