+-+-+-+-+-+-+-+-+-+-+-+-+-+-+-+-+-+-+-+-+-+-+-+-+-+-+-+-+-+-+-+-+-+-+-+-+-+-+-+-+-+-+-+-+-+-+-+-+-+-+
| |     |     |     |     |           |   |   | |   |     |         | |                 | |     |   |
+ +-+ +-+ +-+ + +-+-+-+ +-+ + +-+ + +-+ +-+ +-+ + +-+-+ +-+ + +-+ +-+ +-+ +-+ +-+-+ +-+-+ + +-+-+ +-+
|         | | |     |       | |   |               |       | | | | | |   |   |   | | |     | | |   | |
+ +-+ +-+ + +-+-+-+ +-+-+ +-+-+-+-+-+ +-+ +-+-+-+ +-+-+ +-+ +-+ + + + +-+ +-+-+ + + +-+ + + + +-+ + +
| | | |     |   |   | | |   | |       |     |   | |   |       |     |     |     | | |   | |   |     |
+-+ +-+ +-+-+ +-+-+ + + +-+-+ +-+-+-+-+-+ +-+-+ +-+-+ +-+-+ +-+-+ +-+-+-+ +-+-+-+ + +-+ +-+ +-+ +-+-+
| | |     |     | |           |           | |       |     |   | |     | | |       |     | |         |
+ + + +-+ +-+ +-+ +-+-+ +-+-+-+ +-+-+-+-+ + + +-+ + + +-+ +-+-+ + + +-+ +-+-+ +-+-+ +-+-+ + +-+ +-+ +
| |     | | |   |   |       |   |     | |   | |   |     |     |   | | |     |       | | |   |   | | |
+ + +-+-+-+ + +-+ +-+-+ +-+ +-+-+-+ +-+ +-+ + +-+ +-+ +-+ +-+ +-+-+ + + +-+ + +-+-+ + + +-+-+ +-+ +-+
|   |   |     |   |     |         |   | | |     |   | | | | |   | | | | | |     |             |     |
+-+ +-+ + + + + + + + + +-+ +-+-+ + +-+ + + +-+-+ + + + +-+ + + + + + +-+ +-+ +-+-+ +-+-+-+-+ + +-+-+
|       | | | | | | | | |     |   |   |   |     | | | |       | | | | |     |     |     | |     |   |
+-+ + +-+-+ +-+ +-+ +-+ +-+-+-+ +-+-+ + + + +-+-+ +-+-+ + +-+ +-+ + + +-+-+ + +-+ +-+-+ + +-+ + + +-+
| | |   |     |     | | |   |     | |   |   | |     |   | |     |   |     |   | | | |     |   |     |
+ +-+ + + + +-+-+ +-+ +-+ +-+ +-+ + +-+-+-+ + + +-+-+-+ + + +-+ +-+ + +-+-+-+-+ +-+ + +-+ +-+-+-+ +-+
|   | |   | |             | |   | | | |       | |     | | | |     |         |     |     |     |     |
+-+ + + + + +-+-+ +-+ + +-+ +-+-+-+ + +-+-+ + +-+-+ + +-+-+-+ + +-+-+ +-+-+ +-+ + +-+-+-+-+ +-+ +-+ +
| |   | | | |   | |   |     |   |   |       | |   | | | |     |     | |   |     |             |   | |
+ + + +-+ + + +-+ +-+-+-+-+ +-+ +-+ +-+ +-+ + + +-+ + + +-+ +-+ +-+-+-+-+ + +-+-+-+-+ +-+ +-+ +-+-+-+
|   | |   | |   |   | | |   |   |     | |   | |     |   | | |     |     | |       | | |     | | | | |
+ + + +-+ + + +-+ + + + + + + + + +-+-+ +-+-+ +-+-+ +-+ + +-+ + +-+ + + + +-+-+ +-+ +-+-+ + + + + + +
| | |   | |   |   |     | |   |     |       | |     | | |     |     | |   |         | |   | |       |
+-+ + +-+ +-+ + + +-+-+-+-+-+ +-+ +-+-+ +-+-+ + +-+-+ +-+-+ +-+-+ +-+-+ + + +-+ +-+-+ + + +-+-+-+ +-+
| | | | | |     | |   |       | |     |     | |     | |     |     |   | | | | |   | |   |       | | |
+ + +-+ +-+-+-+ +-+ +-+-+-+ +-+ +-+-+-+ +-+-+-+-+-+ + + +-+-+ + + + +-+-+-+-+ + +-+ + +-+-+ +-+ +-+ +
|           | | |     |   |         |       | |       |     | | |     |     |     | | |   | |   |   |
+-+ +-+-+-+ + +-+ +-+-+ + + + +-+-+ +-+-+ + + +-+-+ +-+-+-+-+-+ +-+-+-+ + +-+ +-+ + +-+-+ +-+-+-+ + +
| |   | |     |         | | |   |     |   |     |     |         |     | | | | |       |         | | |
+ + + + + +-+ + + +-+-+-+ +-+-+-+-+ +-+ + + +-+-+-+ +-+-+-+-+-+-+-+ +-+-+ + +-+-+-+-+ + +-+-+-+-+-+ +
| | | | | | | | |   |     |   | | | |   | |       |     |   |   |   |       |     |   |   |         |
+ +-+ + +-+ + +-+-+ + +-+-+ +-+ + + +-+-+-+ +-+-+ + +-+ +-+ +-+ +-+ + +-+-+-+-+-+ +-+ + +-+-+ + + +-+
|         |   |     | | |       |     | |   | |     |         |   | |   | | |       |     | | | |   |
+-+ +-+ +-+ +-+-+-+ + + +-+-+-+ +-+-+ + +-+ + +-+-+-+ + + + + + + + +-+ + + + +-+-+-+ + + + +-+ +-+-+
|   |   |   |     | | |   |           | | |       |   | | | | | |   |               | | | |       | |
+ + +-+-+ + + + + +-+ + +-+-+-+ +-+ + + + + + + +-+ +-+-+-+ +-+-+-+ +-+ + +-+ +-+ + + +-+-+-+ +-+ + +
| | |   | |   | |           |     | | |     | |   | |   | |     |       |   | |   | |     | | |     |
+ + +-+ +-+-+ + + +-+-+-+-+ + + +-+-+-+ +-+-+-+-+-+-+ + + +-+-+-+-+-+-+-+-+ +-+-+-+ + + + + +-+ +-+ +
| | | |       | |   |   |   | |   | |   | |         | |     |   |     | | |     | | | | |         | |
+ +-+ +-+ + + +-+-+ + +-+ +-+-+-+ + + + + +-+-+ +-+-+-+-+ +-+ + + +-+-+ + + + +-+ + +-+ +-+ +-+-+ + +
|   |     | |   |     |     |   | |   | | |     |         | | |   |         |   |     |   | |     | |
+ +-+ + +-+ +-+-+-+-+-+-+-+-+-+ +-+ + + + + +-+-+-+ +-+-+-+ + + +-+ +-+ + +-+-+ + + +-+-+ + + +-+ +-+
| | | |   | | |             |       | | | |   |   |     | |   |   | | | |   | | | |   | | | |   |   |
+-+ + + + +-+ + +-+-+-+-+-+ + +-+-+-+-+ + + + +-+ +-+ + + + + +-+-+ + + + + + +-+-+-+ + +-+-+ + + +-+
|   | | | |     |   | | | |           |   | | |     | |   | |     | |   | |   |               | |   |
+ +-+-+ +-+ + +-+ +-+ + + +-+-+ +-+ +-+-+ +-+ + + +-+-+ +-+ +-+ +-+-+-+-+-+ +-+-+ +-+ + +-+ +-+-+ +-+
|       |   |   | |   | | | |     | |       |   | |   |   |   | |     | |   | |     | |   |     | | |
+ + +-+-+-+-+ +-+ + +-+ + + +-+ +-+ +-+ +-+-+ +-+-+-+ + + +-+-+ +-+ +-+ + + + +-+-+-+ +-+-+-+ +-+-+ +
| |     | |               | |   |     | | |     |   | | |           | |   |   |         |     |     |
+ + +-+ + +-+ +-+-+-+-+-+ + +-+-+-+-+-+-+ + + +-+-+ + +-+-+-+ + +-+ + + +-+-+ + +-+ + +-+ + + + +-+ +
| | |     | | |             |       |     | | |             | |   |     | |   |   | | | | | |   |   |
+-+ + + +-+ + + + +-+-+ + +-+ +-+-+ +-+ + +-+ +-+ +-+-+ +-+-+-+ +-+ + +-+ +-+-+ + +-+ + +-+-+-+ + +-+
|   | |   | | | |   | | | | |     | |   | | |   |     |   |   |   | |         | | | |     |   | | | |
+-+-+ +-+ + +-+ +-+ + + + + +-+ +-+-+-+ + + + +-+-+ + +-+ + +-+ +-+-+ + +-+-+ +-+ + + + + + + + +-+ +
| |   | |   |   |   |   |   |       |   | |       | | |   |   | | |   |   |     | |   | | | |   |   |
+ +-+-+ +-+ + + + +-+-+ + + +-+-+ + + +-+-+-+ +-+-+ +-+-+ +-+ + + + +-+-+-+-+-+-+-+-+-+-+-+ +-+-+ +-+
| | |   |   | | | | |   | |   | | | |       |       |     |     |   | | | |     | |   | | |         |
+ + + +-+-+ + +-+-+ + +-+-+-+-+ + +-+ +-+-+ +-+-+-+-+-+ +-+ +-+-+ +-+ + + + +-+-+ + + + + + +-+-+ + +
|     |   |   |   | |   | | |   |     |     |   |     |   | | |   | |               | |   | |     | |
+-+-+ +-+ + +-+ + + +-+ + + +-+ + + + +-+ +-+ +-+-+ +-+ +-+-+ +-+-+ + + +-+ +-+-+-+ +-+ +-+ +-+-+-+-+
|     |       | | | |     |       | |   |   | | |     |               | |   |     |     |     | |   |
+-+-+ +-+-+-+ + +-+ +-+-+ +-+-+ +-+-+ +-+-+-+ + +-+-+ + + + +-+-+ +-+-+-+-+ + + +-+-+-+ +-+-+ + + + +
|     |   |   |   |         | |   |   |     | |     |   | | | |   | |     |   |   | | | | |       | |
+ +-+ +-+ + +-+ +-+-+-+-+ + + + +-+ +-+ + + + + + + + +-+-+ + +-+-+ + +-+ +-+-+-+-+ + + + + +-+ +-+-+
| |         |     |       |       |   | | |     | | |     |   |     | |     |       |       |   |   |
+ + +-+ +-+-+-+ +-+-+ + + +-+-+-+-+-+ +-+ +-+ +-+ +-+-+-+-+-+ + +-+-+-+ + +-+ +-+-+-+ + + +-+-+ +-+ +
| |   |     |     |   | | |   | |         | |   | |     | |   | |   |   |     | |     | |     |   | |
+-+ +-+ + +-+-+ + +-+ + + +-+ + +-+-+ +-+ + +-+-+-+-+-+ + +-+ + + + +-+ + +-+-+ +-+ + +-+-+ +-+-+-+ +
|   |   |       | |   | | | |   |     |   |   |         | |     | | | | |     |   | |     |   | | | |
+ + +-+-+ +-+ +-+-+-+ + +-+ + +-+-+ +-+-+-+-+ +-+-+ +-+ + + +-+-+ + + +-+-+ + +-+ + +-+-+ +-+-+ + + +
| | | |     | | |   | | |   | | | |     |   |       |   |     |   | |   |   |   | |     |   | | |   |
+-+ + + +-+-+ + + + + + +-+ + + + +-+-+ +-+ + +-+ + +-+ +-+ +-+-+ + + + + +-+-+ + +-+-+-+ +-+ + + +-+
|   |       | |   |   |   | | | | | | | | | |   | | | | |         | | |   | |     |   | | |         |
+ + +-+-+-+-+ +-+-+-+ +-+ + + + + + + + + + + + + +-+ +-+-+-+ +-+ + +-+ +-+ +-+-+-+ + + + + +-+-+ +-+
| |     |     |       | |           | |   | | | | | | |     | | | | |     |   | |   | |     |     | |
+ +-+ +-+-+ +-+-+-+-+-+ + + +-+ +-+-+ +-+-+ + +-+ + + +-+ +-+ + +-+-+-+-+ + + + +-+-+ +-+-+ +-+ +-+ +
| |     | |       |       | | |             | |       |   |   |   |       | | | | | | |   | |   |   |
+-+-+-+-+ + +-+ +-+-+ + +-+ + +-+-+ +-+ +-+ + + + + + + +-+ + +-+ + +-+ + +-+ + + + + +-+ +-+-+ + + +
| |     | | |   |   | | |   |   |   |     |   | | | | |   | | |   |   | |   |         | | |   |   | |
+ +-+ +-+ +-+ +-+ +-+-+ +-+ + + + + + + +-+-+-+-+ +-+ +-+ + +-+ +-+ +-+-+-+-+ +-+ + + + + + +-+-+-+ +
|         | | | |     | | | | |   | | |   |   |   | | |           |       |     | | | |       | | | |
+ +-+-+ + + + + +-+ +-+-+ +-+ +-+ +-+ +-+ +-+ +-+ + +-+-+-+ +-+ + + + + +-+ +-+-+-+-+-+-+-+-+ + + + +
| |     |         |       |     |   | | | |             |   |   |   | |   |         | | | |   |     |
+-+ +-+-+ +-+ +-+-+-+ +-+-+-+ +-+ + +-+ +-+-+-+-+ +-+ +-+-+ +-+ +-+ +-+-+-+-+-+ + +-+ + + + + +-+-+ +
| | |     |           |   |     | | |   |       | |     |   |   | |     |   | | |     | | | | |     |
+ + + +-+ +-+-+-+-+-+-+ +-+ +-+-+ +-+-+ + +-+-+ + + +-+-+ +-+-+ + + +-+ + +-+ +-+ +-+-+ + +-+ +-+ +-+
|   |   | | | |   |   |   |     | |       |   |   |       | |     | | |       | |   |   |     | |   |
+ +-+-+-+ + + +-+ + +-+ +-+-+ + + +-+-+-+-+ +-+-+ +-+-+ + + + +-+-+-+ + +-+ +-+ + +-+ +-+ +-+-+ + + +
| |     | |   | |   | |     | | | | |         |   |     |   | |     |   |       |   |         | | | |
+ +-+ +-+ + + + + + + + + +-+ +-+ + + +-+-+-+ +-+ + +-+ + +-+-+ +-+-+ +-+ + + +-+ +-+ +-+-+-+ + + + +
|   |     | | |   |     | | | |   |       |       |   | | |         | | | | |       | |         | | |
+-+-+ +-+ + + +-+-+-+ + +-+ + + + +-+ + + +-+ +-+-+-+ + +-+-+ + + +-+ + + +-+-+ + + + +-+-+-+-+ +-+ +
| | | | | | | | |   | |     | | | | | | |   |       | | | |   | | |   |   |   | | | |     |   | |   |
+ + +-+ + +-+ + +-+ + +-+-+-+-+ +-+ + +-+-+-+ +-+ +-+-+ + +-+-+ + +-+ +-+-+-+ + +-+ + + +-+ +-+ +-+ +
|   |     |       |             | | |     | | | |   | | |       |     |   |       |   | | |     | | |
+-+ + +-+ + + + +-+-+-+ +-+-+-+ + + +-+ + + +-+ + +-+ +-+ + +-+-+ + +-+-+ +-+-+-+-+-+-+-+ +-+ +-+ +-+
|       |   | | | |       |   |   | | | |   |       |   | |   | | |             | | |   |           |
+-+-+ +-+ + +-+-+ + +-+ +-+-+ +-+ + + + + + + +-+-+-+ +-+-+ +-+ + +-+-+-+ +-+ + + + + + +-+-+ + + + +
|       | |       |   |   |           | | | |     |             |       |   | |   |   |       | | | |
+-+-+-+-+-+-+-+-+-+-+-+-+-+-+-+-+-+-+-+-+-+-+-+-+-+-+-+-+-+-+-+-+-+-+-+-+-+-+-+-+-+-+-+-+-+-+-+-+-+-+