+-+-+-+-+-+-+-+-+-+-+-+-+
|         |         |   |
+-+-+-+-+ +-+-+ +-+ +-+ +
| |     |       | | |   |
+ + +-+ +-+-+-+-+ + + +-+
| | | |         |   |   |
+ + + +-+-+-+ + + +-+ + +
| | | |       | | |   | |
+ + + + +-+ +-+-+ +-+ + +
| | | | |   |   |   | | |
+ + + + + +-+ + +-+ +-+ +
|     | | |   |     |   |
+-+-+-+ +-+ +-+-+-+-+ +-+
|       |   |       |   |
+ +-+-+-+ +-+-+ +-+ +-+ +
| |   |   |     | |     |
+ + + + +-+ +-+-+ +-+-+ +
|   |   |   |     |   | |
+ +-+-+-+ +-+ +-+ + + + +
|     |   |   |   | |   |
+-+-+ + +-+ +-+-+-+ +-+-+
| |   | |   |       |   |
+ + +-+ + +-+ +-+-+-+ + +
|       |             | |
+-+-+-+-+-+-+-+-+-+-+-+-+