+-+-+-+-+-+-+-+-+-+-+-+-+-+-+-+-+-+-+-+-+-+-+-+-+-+-+-+-+-+-+-+-+-+-+-+-+
|                                                                       |
+ +-+-+-+-+ + + + +-+ + + + +-+ +-+ + + +-+ +-+ + + + + + + +-+ + + +-+-+
|         | | | |   | | | |   |   | | |   |   | | | | | | |   | | |     |
+ +-+-+ +-+-+ +-+ +-+ + + +-+-+-+-+-+-+ + + +-+-+-+-+-+ +-+ +-+ +-+-+-+-+
|     |     |   |   | | |             | | |           |   |   |         |
+ + +-+ +-+ + + + +-+-+-+-+-+ +-+-+ +-+-+ +-+-+ +-+ + + + +-+-+ +-+-+ + +
| |   |   | | | |           |     |     |     |   | | | |     |     | | |
+ +-+ + +-+-+-+ +-+ +-+-+-+-+ +-+-+ + + +-+ +-+-+-+-+-+-+ + +-+ + +-+-+ +
|   | |       |   |         |     | | |   |             | |   | |     | |
+ +-+ +-+-+-+ + +-+-+-+ + +-+-+ +-+-+ +-+-+-+-+-+ +-+-+-+-+ +-+-+ +-+ + +
|   |       | |       | |     |     |           |         |     |   | | |
+ + +-+-+-+ + +-+ +-+ +-+-+ + +-+ +-+-+ +-+ + + + + +-+-+-+ + + +-+-+-+-+
| |       | |   |   |     | |   |     |   | | | | |       | | |         |
+ + +-+ +-+ + + + + +-+ +-+-+-+-+ + + +-+ + + +-+ +-+ + +-+-+-+-+ +-+ + +
| |   |   | | | | |   |         | | |   | | |   |   | |         |   | | |
+ + + +-+-+ + +-+-+-+ + +-+-+ +-+-+-+ +-+ + + +-+ + +-+ +-+-+-+ +-+-+ + +
| | |     | |       | |     |       |   | | |   | |   |       |     | | |
+ + + + +-+-+ +-+-+-+ +-+ +-+-+ + + + +-+-+ + + + + +-+ + + +-+-+ + +-+-+
| | | |     |       |   |     | | | |     | | | | |   | | |     | |     |
+ +-+-+ +-+-+ +-+ +-+-+-+-+ +-+ +-+ + + + + +-+-+ + + +-+-+ + +-+-+-+ + +
|     |     |   |         |   |   | | | | |     | | |     | |       | | |
+ +-+-+-+-+-+ + +-+ + +-+-+-+-+-+-+ +-+ + +-+ + + +-+ +-+ +-+ +-+-+ + + +
|           | |   | |             |   | |   | | |   |   |   |     | | | |
+ + +-+-+ +-+ + +-+-+ + +-+ + + +-+-+-+-+-+-+-+ +-+ +-+ +-+-+-+-+-+-+ + +
| |     |   | |     | |   | | |               |   |   |             | | |
+ +-+-+-+-+-+ +-+-+ + +-+-+-+ + + +-+-+-+ + + +-+ +-+ +-+-+-+ +-+ + + +-+
|           |     | |       | | |       | | |   |   |       |   | | |   |
+ + +-+-+-+ + + +-+-+ + +-+ +-+-+ +-+-+ +-+-+ +-+ + + + +-+ +-+ +-+ + + +
| |       | | |     | |   |     |     |     |   | | | |   |   |   | | | |
+ +-+-+-+ +-+-+ +-+-+-+-+-+-+-+ + + + +-+ +-+-+-+ +-+ +-+-+ +-+ +-+ + +-+
|       |     |               | | | |   |       |   |     |   |   | |   |
+ +-+ + + +-+-+ + + +-+ + +-+-+ + + +-+ + + +-+ +-+ +-+-+ + + + +-+ +-+ +
|   | | |     | | |   | |     | | |   | | |   |   |     | | | |   |   | |
+ +-+ +-+ +-+-+ + + + + +-+ + +-+ +-+-+-+ + + + + +-+-+-+-+-+ +-+-+-+ + +
|   |   |     | | | | |   | |   |       | | | | |           |       | | |
+ +-+ +-+-+ + + +-+-+-+ +-+ +-+ +-+-+-+ + +-+-+ + + + +-+-+-+ + +-+-+ +-+
|   |     | | |       |   |   |       | |     | | | |       | |     |   |
+ + + + +-+ + +-+-+ + +-+-+ +-+ +-+-+ +-+-+ +-+-+-+-+ +-+ +-+ +-+ + +-+-+
| | | |   | |     | |     |   |     |     |         |   |   |   | |     |
+ +-+ + +-+-+ + + +-+-+ +-+-+-+-+-+ +-+-+ + + + + +-+-+ +-+-+-+ + +-+ +-+
|   | |     | | |     |           |     | | | | |     |       | |   |   |
+ +-+-+-+-+-+-+-+ +-+-+ +-+-+ + +-+-+-+ +-+ + + + + +-+-+ +-+-+-+ + + +-+
|               |     |     | |       |   | | | | |     |       | | |   |
+ +-+-+ +-+ + +-+-+-+-+-+ + +-+-+-+ +-+ +-+-+-+ +-+ +-+ +-+ +-+ + +-+-+ +
|     |   | |           | |       |   |       |   |   |   |   | |     | |
+ +-+-+ + + + +-+ + +-+ + + + +-+ +-+-+-+ +-+-+ +-+ +-+-+-+ + + + + +-+ +
|     | | | |   | |   | | | |   |       |     |   |       | | | | |   | |
+ + + + +-+-+ + +-+-+-+-+ +-+ +-+ + + +-+ +-+-+-+ +-+ + +-+-+ +-+-+ +-+ +
| | | |     | |         |   |   | | |   |       |   | |     |     |   | |
+ +-+-+ +-+-+-+ +-+ + + +-+ + +-+-+ + + + +-+ + + +-+ +-+-+ +-+-+ + +-+-+
|     |       |   | | |   | |     | | | |   | | |   |     |     | |     |
+ +-+ +-+ + +-+-+ + +-+-+ + + + +-+ +-+-+ + + + +-+ +-+-+-+-+ + + + +-+-+
|   |   | |     | |     | | | |   |     | | | |   |         | | | |     |
+ +-+ + +-+-+ + + +-+-+-+ + + + + +-+ +-+-+-+-+-+-+-+-+ +-+-+-+-+-+-+-+ +
|   | |     | | |       | | | | |   |                 |               | |
+ + +-+-+ + + + + +-+-+-+-+-+-+-+-+-+ + +-+-+ + + +-+-+ +-+-+-+ +-+ + + +
| |     | | | | |                   | |     | | |     |       |   | | | |
+ + +-+-+-+ + +-+-+-+ +-+ +-+-+-+ +-+ + + + +-+ +-+ + + + +-+-+ + +-+ +-+
| |       | |       |   |       |   | | | |   |   | | | |     | |   |   |
+ + +-+-+ +-+ +-+-+ + + + +-+-+ + + +-+ +-+-+ + + +-+-+ +-+ + + +-+ + +-+
| |     |   |     | | | |     | | |   |     | | |     |   | | |   | |   |
+ + +-+-+ + + + + +-+-+ + + + +-+-+-+-+-+-+ + + +-+ +-+ +-+-+-+-+-+-+ +-+
| |     | | | | |     | | | |             | | |   |   |             |   |
+ +-+-+ +-+-+-+-+ + +-+-+-+ + + +-+-+ +-+ + +-+ +-+-+ + + + + +-+ +-+-+-+
|     |         | |       | | |     |   | |   |     | | | | |   |       |
+ +-+-+ +-+ + + +-+ +-+-+ + + +-+-+ + +-+ +-+ +-+ + + + +-+ +-+-+ + +-+ +
|     |   | | |   |     | | |     | |   |   |   | | | |   |     | |   | |
+ + +-+-+-+-+ + +-+ +-+ + + + + + + + + +-+-+-+-+-+-+ +-+ + + +-+-+ +-+-+
| |         | |   |   | | | | | | | | |             |   | | |     |     |
+ + + +-+-+ + +-+-+-+ +-+ +-+ + + +-+-+-+-+ +-+ +-+ +-+-+ +-+ + + +-+-+-+
| | |     | |       |   |   | | |         |   |   |     |   | | |       |
+-+-+-+-+-+-+-+-+-+-+-+-+-+-+-+-+-+-+-+-+-+-+-+-+-+-+-+-+-+-+-+-+-+-+-+-+