+-+-+-+-+-+
|   |     |
+ + +-+-+ +
| |   |   |
+ +-+ + +-+
|   |     |
+ +-+ +-+ +
|   |   | |
+ + +-+ + +
| |   | | |
+-+-+-+-+-+