+-+-+-+-+-+-+-+-+-+-+-+-+-+
|                         |
+ + +-+-+-+ + + +-+-+-+-+-+
| |       | | |           |
+ + +-+-+ +-+-+-+-+-+-+-+ +
| |     |               | |
+ +-+ +-+-+ + +-+ +-+ + + +
|   |     | |   |   | | | |
+ +-+-+ +-+ + + + +-+-+-+-+
|     |   | | | |         |
+ + +-+-+-+ + +-+ +-+-+ +-+
| |       | |   |     |   |
+ + +-+-+-+-+-+-+ +-+ +-+-+
| |             |   |     |
+ +-+-+-+ +-+ + +-+ +-+-+ +
|       |   | |   |     | |
+ +-+ +-+-+-+ + +-+ + +-+-+
|   |       | |   | |     |
+ +-+ +-+-+-+ +-+-+-+ + + +
|   |       |       | | | |
+ +-+-+ +-+ + +-+ +-+-+ +-+
|     |   | |   |     |   |
+ + +-+ + +-+-+-+-+ + +-+-+
| |   | |         | |     |
+ +-+ +-+-+-+ + + + + +-+-+
|   |       | | | | |     |
+-+-+-+-+-+-+-+-+-+-+-+-+-+