+-+-+-+-+-+
|         |
+ + + +-+ +
| | |   | |
+ + +-+ + +
| |   | | |
+ + +-+-+ +
| |     | |
+ + +-+ +-+
| |   |   |
+-+-+-+-+-+