+-+-+-+-+
| |     |
+ + + +-+
|   | | |
+ +-+-+ +
|   |   |
+ +-+-+ +
|       |
+-+-+-+-+