+-+-+-+-+-+
|   |   | |
+-+ + + + +
| |   |   |
+ +-+-+-+ +
|     |   |
+ +-+ + +-+
| |   |   |
+ +-+-+-+ +
|         |
+-+-+-+-+-+