+-+-+-+-+-+-+-+-+-+-+-+-+-+-+-+-+-+-+-+-+-+
|                                         |
+ +-+ +-+-+-+ +-+ +-+ +-+ +-+ +-+-+ + +-+ +
|   |       |   |   |   |   |     | |   | |
+ + + + +-+ +-+-+ + + + +-+-+-+-+ + +-+ + +
| | | |   |     | | | |         | |   | | |
+ +-+-+ +-+ +-+-+ + +-+-+ +-+ + +-+ +-+-+-+
|     |   |     | |     |   | |   |       |
+ +-+ +-+-+ +-+-+ + + + +-+-+-+ + +-+ + + +
|   |     |     | | | |       | |   | | | |
+ + +-+-+ +-+-+-+ + + + +-+ + +-+-+-+-+-+ +
| |     |       | | | |   | |           | |
+ +-+ + + +-+ + + +-+ +-+-+ +-+ + +-+ +-+-+
|   | | |   | | |   |     |   | |   |     |
+ +-+-+ + +-+ +-+-+-+ + +-+ + + + + +-+ + +
|     | |   |       | |   | | | | |   | | |
+ + + +-+ +-+-+ +-+ +-+ + + +-+-+-+ + + +-+
| | |   |     |   |   | | |       | | |   |
+ +-+-+-+-+ +-+ +-+ +-+-+-+ + + +-+ +-+ + +
|         |   |   |       | | |   |   | | |
+ + + + +-+-+-+ +-+-+ +-+ +-+ +-+ + +-+-+ +
| | | |       |     |   |   |   | |     | |
+ +-+ +-+ + + +-+-+-+ +-+-+ +-+-+-+-+ + +-+
|   |   | | |       |     |         | |   |
+ + +-+ + +-+ + + + +-+ + +-+ + +-+-+ +-+-+
| |   | |   | | | |   | |   | |     |     |
+ + +-+ +-+-+ + + + + +-+-+-+ + +-+-+ +-+-+
| |   |     | | | | |       | |     |     |
+ +-+ +-+ +-+-+ + +-+-+ + +-+-+-+ + + +-+ +
|   |   |     | |     | |       | | |   | |
+ + + +-+ + + + +-+-+-+-+ +-+ + + +-+-+ +-+
| | |   | | | |         |   | | |     |   |
+ +-+-+-+ + +-+ + +-+-+-+ +-+ + + +-+-+-+ +
|       | |   | |       |   | | |       | |
+ +-+-+ + + + + + +-+-+-+-+-+-+ + +-+ + +-+
|     | | | | | |             | |   | |   |
+ +-+-+ +-+-+-+-+-+-+-+-+ + +-+ + +-+ +-+-+
|     |                 | |   | |   |     |
+ + + + +-+-+ +-+-+ +-+-+ +-+-+ + + + + +-+
| | | |     |     |     |     | | | | |   |
+ +-+-+ + + +-+ + + + + +-+ +-+ + + + + +-+
|     | | |   | | | | |   |   | | | | |   |
+-+-+-+-+-+-+-+-+-+-+-+-+-+-+-+-+-+-+-+-+-+