+-+-+-+-+-+-+-+
|   |   |     |
+-+ + + + +-+ +
| | | |   |   |
+ + + +-+-+ +-+
| | |     |   |
+ + + +-+ +-+ +
|   |   | |   |
+ +-+-+ + +-+-+
|   |   |     |
+-+ +-+-+-+-+ +
| | |         |
+ + + +-+-+-+ +
|     |       |
+-+-+-+-+-+-+-+