+-+-+-+-+-+-+-+-+-+-+-+-+-+-+-+-+-+-+-+-+-+-+-+-+-+-+-+-+-+-+
|                                                           |
+ + +-+ + + +-+ +-+ +-+ +-+ + + +-+-+ +-+-+-+-+ +-+ +-+-+-+-+
| |   | | |   |   |   |   | | |     |         |   |         |
+ +-+-+ +-+-+ +-+-+ +-+ + + + + + + +-+ +-+-+-+-+ +-+-+-+-+-+
|     |     |     |   | | | | | | |   |         |           |
+ +-+-+-+-+-+-+ + +-+ + + + + +-+ +-+ + + +-+-+-+-+ +-+-+ + +
|             | |   | | | | |   |   | | |         |     | | |
+ +-+ +-+-+ +-+-+ +-+ + + +-+ +-+ + +-+ +-+-+-+ +-+ + +-+ +-+
|   |     |     |   | | |   |   | |   |       |   | |   |   |
+ +-+ +-+-+ +-+ + +-+ + + + +-+ + +-+-+ +-+ +-+-+-+ +-+-+ + +
|   |     |   | |   | | | |   | |     |   |       |     | | |
+ +-+-+-+ +-+-+ +-+ + + + + + + +-+ +-+ +-+-+-+ + +-+-+ + +-+
|       |     |   | | | | | | |   |   |       | |     | |   |
+ + + + +-+ +-+-+-+-+ +-+ +-+-+-+-+ + +-+ + +-+-+ +-+-+-+-+ +
| | | |   |         |   |         | |   | |     |         | |
+ + +-+-+ + + + +-+-+ +-+ + +-+-+-+-+ + +-+ +-+ + +-+-+-+ + +
| |     | | | |     |   | |         | |   |   | |       | | |
+ +-+ + +-+-+ +-+-+ +-+ + + +-+-+ + +-+-+ + + +-+ + +-+ +-+ +
|   | |     |     |   | | |     | |     | | |   | |   |   | |
+ + +-+ + +-+-+ + + +-+ +-+ +-+ +-+-+-+ + + +-+-+-+ + + +-+-+
| |   | |     | | |   |   |   |       | | |       | | |     |
+ + +-+ + +-+ + +-+-+ +-+ + +-+-+ +-+ +-+-+ + + + + + + + + +
| |   | |   | |     |   | |     |   |     | | | | | | | | | |
+ +-+-+-+ +-+ + + +-+-+-+-+-+-+-+-+ + +-+-+-+ + + +-+ +-+ + +
|       |   | | |                 | |       | | |   |   | | |
+ +-+ + +-+ +-+-+-+ +-+ + + + + +-+-+-+-+-+-+ +-+ +-+-+ +-+-+
|   | |   |       |   | | | | |             |   |     |     |
+ +-+ +-+ + + +-+-+ +-+-+-+ +-+ +-+-+-+-+-+-+-+ +-+ + + +-+-+
|   |   | | |     |       |   |               |   | | |     |
+ + +-+-+-+-+-+ + +-+ +-+ + +-+-+ +-+-+ + +-+-+-+ +-+-+-+ + +
| |           | |   |   | |     |     | |       |       | | |
+ +-+-+-+-+ + + +-+ + + + +-+ +-+-+-+-+-+-+-+-+-+ +-+ + +-+ +
|         | | |   | | | |   |                   |   | |   | |
+ + + + +-+-+ + +-+ + +-+ +-+ + +-+ + + + +-+ + +-+-+ + +-+-+
| | | |     | |   | |   |   | |   | | | |   | |     | |     |
+ + +-+-+ + + + + +-+-+ + + +-+ +-+ +-+-+ + +-+-+-+ + + + + +
| |     | | | | |     | | |   |   |     | |       | | | | | |
+ +-+ + +-+ +-+ + +-+ +-+-+-+-+-+ +-+ +-+-+-+ + +-+ + + +-+-+
|   | |   |   | |   |           |   |       | |   | | |     |
+ +-+ + + + +-+-+ + + +-+-+ + +-+ + + +-+-+ + + +-+ + + +-+-+
|   | | | |     | | |     | |   | | |     | | |   | | |     |
+ + +-+ +-+-+-+ + + +-+ + + + +-+-+-+-+-+-+ +-+-+ + + +-+ +-+
| |   |       | | |   | | | |             |     | | |   |   |
+ +-+ + +-+ + + + + + +-+ +-+-+ + + +-+ + +-+ + + +-+ + +-+-+
|   | |   | | | | | |   |     | | |   | |   | | |   | |     |
+ +-+ +-+-+ +-+ + + + + +-+ +-+-+ +-+ +-+ +-+ + + +-+ +-+ + +
|   |     |   | | | | |   |     |   |   |   | | |   |   | | |
+ + + +-+-+ + +-+ + +-+ +-+-+-+ + +-+-+-+ +-+-+-+-+ + +-+-+-+
| | |     | |   | |   |       | |       |         | |       |
+ +-+-+ +-+-+-+-+ + +-+-+-+ +-+ +-+-+-+-+ +-+-+-+-+ +-+ + + +
|     |         | |       |   |         |         |   | | | |
+ +-+-+-+ + + + + +-+ + + +-+ +-+-+ + +-+ +-+-+-+ +-+ + + + +
|       | | | | |   | | |   |     | |   |       |   | | | | |
+ + +-+-+-+ +-+-+-+ + + + + + +-+-+-+ +-+ + +-+ + +-+ + +-+ +
| |       |       | | | | | |       |   | |   | |   | |   | |
+ +-+ + + +-+ + + + +-+-+ + +-+-+ +-+ +-+ + +-+ + +-+ + + +-+
|   | | |   | | | |     | |     |   |   | |   | |   | | |   |
+ + + +-+-+-+ +-+-+-+-+-+ +-+-+-+ +-+-+ + +-+-+ +-+-+-+-+-+-+
| | |       |           |       |     | |     |             |
+-+-+-+-+-+-+-+-+-+-+-+-+-+-+-+-+-+-+-+-+-+-+-+-+-+-+-+-+-+-+