+-+-+-+-+-+-+-+
|             |
+ + + +-+-+-+-+
| | |         |
+ + +-+ + + +-+
| |   | | |   |
+ + +-+-+-+ +-+
| |       |   |
+ +-+ +-+-+-+ +
|   |       | |
+ + +-+ + +-+-+
| |   | |     |
+ + + +-+-+-+ +
| | |       | |
+-+-+-+-+-+-+-+