+-+-+-+-+-+-+-+-+-+-+-+-+-+-+
|     |   | |     | |   | | |
+ + +-+ + + + +-+ + + +-+ + +
| |     | |     |         | |
+ + + + + +-+-+ + + +-+-+-+ +
| | | | |     | | | |   |   |
+ + + +-+ +-+ +-+-+ +-+ + + +
| | |   | | | | |   | |   | |
+ +-+-+-+ + +-+ +-+ + + +-+-+
| | | |           |         |
+ + + +-+ +-+ +-+ +-+ + +-+ +
|     |   | | |       | | | |
+ +-+-+-+ + +-+-+ + +-+ + +-+
| |   |     |   | |   |   | |
+ + +-+-+-+-+-+ +-+-+ +-+ + +
| |           |   | |   |   |
+-+ + +-+-+ +-+ +-+ +-+-+ +-+
|   | |   |         | |     |
+-+-+-+ +-+-+-+-+-+ + + + +-+
| |   |   |   |   | |   | | |
+ + +-+ + + + + + + + +-+ + +
|     | |   |   | | | | |   |
+-+-+ +-+-+ +-+-+ + +-+ + +-+
| |       |     |   |       |
+ +-+ +-+-+-+ +-+-+ +-+ + +-+
|     |       |         | | |
+ +-+ + +-+ +-+-+ + +-+-+ + +
|   |     | |     |     |   |
+-+-+-+-+-+-+-+-+-+-+-+-+-+-+