+-+-+-+-+-+-+-+-+-+-+-+-+-+-+-+-+-+-+-+-+-+-+-+-+
| |     | | |   |   |   | |   |         |       |
+ + + +-+ + + + + + + + + + +-+-+-+ + +-+-+-+ + +
|   |   | | | |   | | |     | | |   |   | |   | |
+ + + +-+ + + + +-+ + +-+-+ + + +-+-+ +-+ + + +-+
| | |     |   | | | |     | |   |   |     | | | |
+-+ + +-+-+-+ +-+ +-+-+-+-+ +-+ + +-+ +-+-+ +-+ +
|   | | |     |       | |   | |   | |           |
+-+ +-+ + + + + +-+-+ + +-+ + +-+ + +-+ +-+ + +-+
|   |     | |     |         |       |   |   |   |
+ +-+-+ + +-+ +-+-+ +-+-+-+ +-+ + + + +-+-+-+ +-+
|       | | |   | | | |       | | |         | | |
+ +-+-+-+ + +-+ + +-+ +-+ + +-+-+ +-+ +-+ + +-+ +
| | |     |     |         |   |     | | | |   | |
+ + + +-+-+-+-+-+ +-+-+-+-+-+-+ +-+-+ + +-+-+-+ +
|   | | |           | |   |         |   | | |   |
+-+ +-+ +-+-+ +-+-+-+ +-+ + + + +-+-+ +-+ + +-+ +
|     | |     |         |   | | |   | |   | |   |
+-+-+ + +-+-+-+ + +-+ +-+ +-+-+ + +-+ +-+ + +-+ +
|   |           |   |   | |   |     | |   |   | |
+ +-+ +-+-+ + +-+-+-+-+ +-+ +-+-+-+ +-+ + + +-+ +
|   | | | | |   | | |     | | | |     | |       |
+ +-+-+ + + + +-+ + +-+-+-+ + + + +-+ +-+ + +-+ +
|     |     |   |   |           |   |   | | |   |
+-+-+ +-+-+-+ + +-+ +-+ +-+-+-+ +-+ + +-+-+-+ + +
| | | | |     |       |   |       | |         | |
+ + + + + +-+-+-+-+ + +-+-+-+ +-+-+-+-+-+-+ +-+-+
|           |     | | |     |   |   |   | |     |
+-+-+ +-+-+-+-+-+ +-+-+-+ +-+ +-+-+ +-+ + +-+-+ +
|     |   |     |       | | | | |   |     | | | |
+ +-+-+ +-+ +-+-+-+ + + + + + + +-+ + + +-+ + + +
| | |           |   | |       | | |   |         |
+ + +-+ + +-+-+-+ + +-+-+ +-+ + + +-+-+ +-+ +-+ +
| | | | |         |     | |   |   | | |   | |   |
+ + + + + +-+ + +-+-+ +-+-+ +-+ +-+ + + +-+-+ +-+
|     | | |   | |       |   |   |   | | | |     |
+ + +-+ +-+-+-+-+-+-+-+ +-+ +-+ +-+ + + + + + +-+
| |       | |         | |         | |   | | |   |
+-+ + +-+-+ +-+ +-+ +-+ + + +-+ + + +-+ + +-+-+ +
|   |   |   | | |   |   | |   | |     | | |     |
+-+ + + + + + +-+-+ + + + +-+ + + +-+-+-+ +-+ + +
|   | | | | |       | | |   | | |     | | | | | |
+ + +-+ + +-+ + +-+-+ + +-+-+ +-+ +-+ + + + +-+ +
| |   |     | |     | |     | |     | | |   |   |
+-+ +-+-+-+-+-+ +-+-+-+ + +-+-+ +-+-+ + + +-+-+ +
| |     | |   | |     | | | | |   |   |     |   |
+ + +-+ + + +-+ +-+ + + +-+ + + +-+-+ +-+ +-+-+ +
|   |     |         |     |         |           |
+-+-+-+-+-+-+-+-+-+-+-+-+-+-+-+-+-+-+-+-+-+-+-+-+