+-+-+-+-+-+-+-+-+-+-+-+-+-+-+-+-+-+-+-+-+-+-+-+-+-+-+-+-+-+-+-+-+-+-+-+-+-+
|                                                                         |
+ + +-+-+-+-+ +-+ + +-+ + + + + + +-+-+-+-+-+ +-+ +-+-+ + + + + +-+ +-+ + +
| |         |   | |   | | | | | |           |   |     | | | | |   |   | | |
+ + + +-+-+ +-+ +-+ +-+-+-+-+ +-+-+ +-+ + +-+ +-+ + +-+-+ +-+ +-+ +-+ +-+ +
| | |     |   |   |         |     |   | |   |   | |     |   |   |   |   | |
+ + +-+ +-+-+-+ + +-+ +-+-+-+-+ + + +-+-+-+-+ +-+-+ +-+ + + + +-+ +-+ + +-+
| |   |       | |   |         | | |         |     |   | | | |   |   | |   |
+ +-+-+-+ + + + + +-+-+-+ + +-+ +-+ + +-+-+-+-+-+ + +-+-+ +-+-+-+ +-+ +-+-+
|       | | | | |       | |   |   | |           | |     |       |   |     |
+ +-+ + +-+-+-+ + + +-+ +-+ + +-+ + +-+ +-+-+-+ +-+-+-+-+-+ + + +-+ + +-+ +
|   | |       | | |   |   | |   | |   |       |           | | |   | |   | |
+ +-+-+-+ + +-+-+-+-+ + +-+ + +-+ + + +-+ +-+-+-+ +-+-+-+-+ +-+-+ +-+-+ +-+
|       | |         | |   | |   | | |   |       |         |     |     |   |
+ +-+-+ +-+ + + +-+-+-+ +-+-+ +-+-+ +-+-+-+ + +-+ +-+ + +-+ + +-+-+ +-+-+-+
|     |   | | |       |     |     |       | |   |   | |   | |     |       |
+ + +-+-+ + + + + +-+ +-+ +-+ + + + + + +-+-+ +-+-+-+ +-+ +-+ +-+ +-+ +-+-+
| |     | | | | |   |   |   | | | | | |     |       |   |   |   |   |     |
+ + +-+-+ +-+-+-+-+ +-+ +-+ +-+ + + + +-+-+-+-+ + +-+ + +-+-+ +-+-+-+ +-+-+
| |     |         |   |   |   | | | |         | |   | |     |       |     |
+ + + +-+ +-+ +-+-+-+ + +-+-+-+ +-+-+ + + + +-+-+-+ + +-+ + +-+-+-+-+-+-+-+
| | |   |   |       | |       |     | | | |       | |   | |               |
+ + + +-+ + + + + +-+ +-+ +-+ +-+-+ + +-+ + +-+-+ + +-+ + + + + +-+ +-+-+ +
| | |   | | | | |   |   |   |     | |   | |     | |   | | | | |   |     | |
+ + + +-+-+ + +-+ +-+-+-+-+-+ + + + +-+-+ + + +-+ + + + + + + +-+-+-+ +-+ +
| | |     | |   |           | | | |     | | |   | | | | | | |       |   | |
+ + +-+ + +-+ + + +-+ + + + +-+ +-+ + +-+-+-+-+ + +-+-+-+-+ + + + +-+ +-+-+
| |   | |   | | |   | | | |   |   | |         | |         | | | |   |     |
+ +-+ +-+-+-+ +-+-+-+-+-+-+-+-+ +-+-+ + + + + +-+ + +-+-+-+-+-+ +-+-+-+-+ +
|   |       |                 |     | | | | |   | |           |         | |
+ +-+ +-+-+ + + + + +-+ + +-+ + +-+-+-+-+ +-+ +-+ + +-+-+-+ +-+-+-+-+ +-+ +
|   |     | | | | |   | |   | |         |   |   | |       |         |   | |
+ +-+ +-+ +-+-+-+ +-+ +-+ + +-+-+-+-+-+ +-+-+ +-+-+-+ +-+-+-+ +-+-+ + +-+-+
|   |   |       |   |   | |           |     |       |       |     | |     |
+ +-+ + +-+-+-+-+ + + +-+-+ +-+ +-+ + +-+-+-+-+ + +-+ + + + +-+ + +-+ +-+ +
|   | |         | | |     |   |   | |         | |   | | | |   | |   |   | |
+ + + + + + +-+ + + + +-+ + +-+ + +-+-+-+-+-+ +-+ + + +-+ + +-+-+ +-+ +-+-+
| | | | | |   | | | |   | |   | |           |   | | |   | |     |   |     |
+ +-+-+ + + + +-+-+-+ +-+-+ + +-+-+ + +-+ + +-+ +-+-+-+-+ +-+-+-+ +-+ + +-+
|     | | | |       |     | |     | |   | |   |         |       |   | |   |
+ + + +-+ + + + + + +-+-+ +-+-+ +-+-+ + + + +-+ + +-+ + +-+-+ + + +-+ +-+-+
| | |   | | | | | |     |     |     | | | |   | |   | |     | | |   |     |
+ + +-+-+ + +-+ +-+ +-+ + +-+-+-+ + +-+-+ +-+ + +-+ + + +-+-+ +-+ + +-+ +-+
| |     | |   |   |   | |       | |     |   | |   | | |     |   | |   |   |
+ +-+-+ + +-+ + +-+-+ + + +-+-+-+ +-+-+ + + +-+ + +-+ + + +-+-+ + + +-+-+-+
|     | |   | |     | | |       |     | | |   | |   | | |     | | |       |
+ +-+ +-+ + +-+ +-+ + + + +-+ +-+ + +-+-+ +-+ + +-+ +-+ +-+-+ +-+ + +-+-+-+
|   |   | |   |   | | | |   |   | |     |   | |   |   |     |   | |       |
+ + + +-+ + + +-+-+-+ +-+-+ +-+ +-+ + + + + + +-+-+ +-+-+-+ + +-+ + + +-+ +
| | |   | | |       |     |   |   | | | | | |     |       | |   | | |   | |
+ + +-+ + +-+ + + +-+ + + + +-+ +-+-+ +-+ + + +-+-+ +-+ +-+ +-+ +-+-+ +-+ +
| |   | |   | | |   | | | |   |     |   | | |     |   |   |   |     |   | |
+ + + +-+ + + + + + +-+-+-+ + +-+-+ +-+-+-+-+-+ + +-+-+-+-+-+ + + +-+-+-+ +
| | |   | | | | | |       | |     |           | |           | | |       | |
+ +-+-+-+-+-+-+ + +-+ + +-+ + + + +-+ +-+-+-+-+ +-+ + +-+ +-+-+ + +-+ +-+ +
|             | |   | |   | | | |   |         |   | |   |     | |   |   | |
+ + + + + +-+-+ +-+ +-+-+ +-+ + + +-+ +-+-+ + + + + + +-+-+ + + +-+ +-+-+ +
| | | | |     |   |     |   | | |   |     | | | | | |     | | |   |     | |
+ + + + + + + +-+-+ + + + + +-+ +-+-+-+-+ + +-+-+ + + +-+-+-+ + + + +-+ + +
| | | | | | |     | | | | |   |         | |     | | |       | | | |   | | |
+ +-+-+-+-+ +-+ + +-+ +-+ +-+ +-+-+ +-+ +-+ +-+-+-+ + +-+-+ +-+-+-+-+ +-+-+
|         |   | |   |   |   |     |   |   |       | |     |         |     |
+ + + +-+-+-+ +-+ + + + + + +-+-+ + +-+ + +-+-+-+ +-+-+ +-+ +-+-+-+-+ +-+-+
| | |       |   | | | | | |     | |   | |       |     |   |         |     |
+ +-+ +-+-+ + + + + + +-+ + + + + +-+-+ +-+-+ +-+ + + + +-+ +-+-+ +-+ +-+ +
|   |     | | | | | |   | | | | |     |     |   | | | |   |     |   |   | |
+ + + + + +-+ +-+ + + + +-+-+ +-+ + +-+-+ + +-+ +-+ +-+ +-+ +-+-+-+-+-+ +-+
| | | | |   |   | | | |     |   | |     | |   |   |   |   |           |   |
+ + + + +-+-+ + +-+ +-+-+-+ +-+ + + +-+-+ + +-+ + +-+-+ +-+-+-+-+-+-+ + +-+
| | | |     | |   |       |   | | |     | |   | |     |             | |   |
+ + + + + +-+ +-+ +-+-+-+ +-+ +-+-+ +-+ +-+ +-+-+ +-+-+-+-+-+-+-+ + + + + +
| | | | |   |   |       |   |     |   |   |     |               | | | | | |
+ + + + + +-+-+-+-+ +-+-+ + + +-+-+ +-+-+ +-+ + +-+ + + + + + +-+-+-+ + + +
| | | | |         |     | | |     |     |   | |   | | | | | |       | | | |
+-+-+-+-+-+-+-+-+-+-+-+-+-+-+-+-+-+-+-+-+-+-+-+-+-+-+-+-+-+-+-+-+-+-+-+-+-+