+-+-+-+-+-+-+-+-+-+-+-+-+-+-+-+-+-+-+-+-+-+-+-+-+-+-+-+-+-+-+-+-+-+-+-+-+-+-+-+-+-+-+-+-+-+-+-+
| |       |   |   | |           |         | | | |           | |   | | | | | |       | | |     |
+ +-+-+-+ + + + +-+ +-+ +-+ +-+-+ +-+-+-+ + + + +-+-+-+-+-+ + +-+ + + + + + +-+ + +-+ + + + + +
|       |   |       |     |     |   |     |             |       |   | | | | |   | |   |   | | |
+-+ + +-+ +-+ +-+ +-+-+ +-+-+-+ +-+-+ +-+-+ +-+ +-+ +-+ + +-+-+-+-+ + + + + + +-+ +-+ + +-+-+-+
|   |   | | | |         |   |   |   | |       | |   |     |   | |       | |   |     |     | | |
+ + +-+ +-+ + + + +-+-+-+ + + +-+-+ + + + +-+ + +-+-+-+-+ + + + + +-+-+-+ + + +-+-+ +-+ +-+ + +
| | |     |   | |   |   | |         |   | |   |     |   | | |   | |   |     |     | |         |
+-+-+-+-+ +-+ + +-+-+-+ +-+-+ + + +-+-+-+-+ + +-+ + +-+ + + +-+-+ + + + +-+ + +-+-+-+ +-+-+-+ +
| |     |     | | |       | | | |   |   |   |   | | |     |         |   | | | |         |   | |
+ +-+ + +-+-+-+ + + +-+-+ + + +-+-+-+ +-+-+-+-+ +-+-+-+ + + +-+ + +-+-+-+ + + +-+ + + +-+ + + +
|     |   |   |   | | | |   | | |   | | | | | |   |   | | |   | |     | |   |   | | | | | | | |
+-+-+ +-+-+ + +-+ +-+ + +-+ +-+ + +-+ + + + + +-+ + + +-+-+ +-+ +-+-+ + + + + + +-+-+ + + + +-+
|         | | |       |         |             | | | |   |   | |   | | |   | | |   |   |   | | |
+-+ +-+-+ + + +-+-+ + +-+ +-+-+-+-+ + +-+ + +-+ + + + +-+-+ + + +-+ +-+ + + +-+ +-+-+ + + + + +
|     |     |       |           | | |   | | |       | |     | | |       | | | |     |   | | | |
+-+-+-+-+-+ + +-+ +-+-+ +-+-+-+-+ +-+ + + +-+ +-+-+ +-+-+-+ + +-+-+-+-+-+-+-+ + +-+-+ + +-+-+ +
|           |   | |     |   |   |     | | |       |   |   | |       | | |   |         |   |   |
+ + +-+-+ +-+-+-+-+-+-+ + +-+ + +-+-+ +-+-+-+-+ + +-+ + +-+-+ +-+ + + + + +-+-+-+ + + + +-+-+ +
| | | |     | | | |     |     | |       |       | | |       | |   | | |     |     | | | |     |
+-+-+ + + +-+ + + +-+ + + +-+ +-+ +-+-+ +-+ +-+-+ + + +-+ + +-+ +-+-+ +-+ + +-+ + + +-+ +-+ + +
|     | |         |   |   |     | |         |     |   | | |     | |     | |   | | |   | |   | |
+-+-+ +-+ +-+ + +-+-+-+ +-+-+ + + +-+ +-+-+-+-+ + +-+-+ +-+-+-+-+ + + +-+ +-+-+-+-+-+-+ + +-+ +
|   |   |   | |   |   | |     | | |     | |     | | |   | |   |   | |     | |         |   |   |
+ + + + + +-+-+-+-+-+ + +-+ +-+ +-+ +-+ + +-+-+ +-+ + +-+ +-+ + +-+ + +-+-+ + +-+-+-+-+-+-+-+ +
| |   | | |   |       | |   |     | | |   |   | |   |     | |     | |   |             |       |
+ +-+-+ +-+-+ +-+-+ +-+ +-+ + + +-+-+ + +-+-+ +-+ +-+-+ + + + + +-+-+-+ +-+-+ +-+-+-+ + + +-+ +
| |   | |               |   | | |     |   | | | |   |   |     |               |       | |   | |
+ + + +-+ + + +-+ +-+-+ + +-+-+ + +-+ + +-+ + + +-+ + +-+-+ +-+-+ + +-+-+ +-+ +-+-+ +-+-+-+ +-+
|   |   | | | |     |   | | |     | |                   |     | | |     | |       |       |   |
+-+ +-+ +-+-+ + +-+-+-+-+-+ +-+ +-+ +-+-+ +-+-+-+-+-+-+-+ +-+-+ +-+-+ +-+ + +-+ +-+-+ +-+ +-+ +
|     |   |   |     |   | |         | | | |   |   |     |     | |   |   | | |       |   | |   |
+ + + +-+ +-+-+ + +-+ +-+ +-+ + +-+ + + +-+ +-+ +-+ +-+-+-+-+-+ +-+ +-+ +-+ + + +-+ +-+-+ +-+ +
| | | | | |     | |     |     | | |     |           | |     | |     |   |   | | | | | |       |
+ +-+ + +-+-+ + + +-+ + + +-+ +-+ +-+-+-+-+ + + + +-+ +-+-+ + +-+ + +-+ +-+-+-+ + + + +-+-+ +-+
| |       |   | | |   |   |     |   | | |   | | | | |     |   | | | |     |   | |       |     |
+-+-+-+ +-+-+ +-+-+-+ +-+-+-+-+-+ +-+ + + +-+ +-+ + +-+ + +-+ + + +-+-+-+ + + + +-+-+ + +-+ +-+
| | |   |   | |     | |       | |           |   |   |   |   |       |       | | | | | |   |   |
+ + + +-+-+ +-+-+ + +-+-+ +-+-+ + + +-+-+-+-+-+-+-+ +-+-+-+ + +-+-+-+ +-+-+ + + + + +-+-+-+-+-+
|         |   | | | |     | |   | |   |     | |   | |   | |     |     | |   | | |     |   |   |
+-+-+ +-+ + +-+ +-+ + +-+ + + +-+ +-+ + +-+ + + + +-+ + + + + +-+ +-+ + +-+-+ +-+-+-+ +-+ + +-+
|     |         |     |       |   | |   | |   | |   | |   | |   | | |       |   | |   |   |   |
+-+-+-+-+-+-+-+ +-+-+ +-+ + +-+ +-+ + + + + +-+ + + +-+ + +-+ +-+ + + +-+-+-+-+ + +-+ +-+ + +-+
|   |   |       | |     | | |   |     |   |   | | |     | |         | |       | |             |
+-+ + + +-+ + + + +-+-+ + +-+-+ + +-+ + +-+-+-+ + +-+-+ + + +-+-+ + +-+-+ + +-+-+-+ +-+-+-+ +-+
|     |     | | |     | |     | | | | | |     | |     | | | |     |       |     | |       |   |
+ + + +-+-+-+ + + +-+-+-+-+-+ +-+ + +-+ +-+-+ +-+ +-+-+ +-+-+ +-+ +-+ + +-+-+ + + + +-+ + + +-+
| | |   | |   | |         |         |     |       |       |     | |   |   |   | |   |   | | | |
+ + +-+ + +-+ +-+-+-+-+-+ + +-+ + + +-+-+ +-+-+-+-+-+-+ +-+-+-+-+-+ +-+ + +-+ +-+-+-+ + +-+-+ +
| | | |   |         | |     |   | | |   | |     |   |     |   |     | | |   | |       |       |
+-+ + + + +-+ +-+-+ + + +-+ + +-+-+ +-+ +-+ + +-+ +-+-+ +-+-+ +-+ + + +-+-+-+-+-+ +-+-+-+ + +-+
|   |   | |     | |     |   | | |           |     | |         |   |   |         |   |     |   |
+-+-+-+-+-+ + + + + +-+-+ + +-+ + +-+ +-+ + +-+ +-+ + +-+ +-+-+-+-+ +-+ +-+ +-+-+ +-+ +-+ + +-+
|   |     | | |   |   |   |     | |   |   | | |       |   |     |   |   |   |   |   |   | |   |
+-+ + +-+-+ +-+-+-+-+-+-+-+ + + +-+ +-+ +-+ + + +-+-+-+-+ +-+-+ + + + +-+-+ +-+ +-+-+ +-+-+ +-+
|   |       |       |       | |   | |   |   | |       | |   | | | | |   |     | |       |   | |
+ + +-+ + +-+ + +-+-+-+-+-+-+ +-+-+-+-+ +-+-+ + +-+-+ + +-+-+ + + + + + +-+-+ + + + +-+-+-+ + +
| | | | | |   | |   | |   |     |         |     |   | |   | |   | | | | | |   | | | |   |   | |
+ + + + +-+-+ + + +-+ + +-+ + +-+-+-+ + +-+-+-+ +-+ + + +-+ +-+ +-+ + +-+ + + + + + +-+ + + + +
| |       |   |       |   | |   |     |   | |     |     |       |         | | | | | |     |   |
+-+ +-+ +-+ + + +-+ +-+ +-+ + +-+-+-+-+-+-+ + + +-+-+-+-+ +-+ +-+-+-+ + +-+-+ + +-+-+-+ + + +-+
| | | |     | |   |     |   |     | |   | | | | |   | | |   |     |   |     | |       | | |   |
+ +-+ + +-+ +-+ + + + + + + +-+-+-+ + +-+ + +-+ + +-+ + +-+ +-+ + + +-+-+ + + + +-+ + + +-+ + +
|   |     | | | | | | | | |   | | | |   |   |     |   |     |   | |   |   | |   |   | |   | | |
+-+ +-+ + +-+ +-+-+ +-+-+-+ +-+ + + + +-+ +-+ +-+-+ +-+-+-+ +-+ +-+ + +-+ + +-+-+ + +-+ + +-+ +
|       | |       | |   |           |   |       |       |     | |   |   | |     | | | | | |   |
+ + +-+ +-+ + +-+-+ + + +-+-+ +-+-+ + +-+-+-+ + +-+ +-+ + +-+ + + +-+ +-+-+ + +-+-+ + +-+-+ +-+
| | |   |   | | | | | |       | |   | |   | | | |     | |   | |   |       | |     |   |     | |
+ +-+-+ +-+-+ + + + +-+ +-+ + + +-+ + + + + +-+-+ +-+ + + +-+ + +-+ + +-+-+-+ +-+-+-+ +-+-+ + +
| |         |         | | | | |         |   | |   |   | | | | | |   | | |     |     | | |     |
+-+ +-+ +-+-+-+-+ + +-+-+ + + +-+ +-+-+ +-+ + +-+ +-+-+-+-+ +-+ + +-+ + + + +-+-+ + +-+ + +-+ +
|   |     |     | |       | | |   | |   |     |     |       |   | |     | | |   | |       | | |
+-+ +-+ +-+-+ + +-+ +-+-+-+-+-+ +-+ + + + +-+-+-+ + +-+-+-+ +-+-+-+ +-+ +-+-+-+ + +-+-+-+-+ + +
|     |   | | |   |         | | |     | |     |   |     |     |   | | | |           | |     | |
+ +-+-+-+ + + + +-+ +-+-+ +-+ +-+ + +-+ + +-+-+-+-+ +-+-+ +-+-+ +-+ + + +-+-+-+ + + + + +-+-+-+
| |   | | | | | |       |   |   | | |   |     |       |   |   | |   |   | | | | | |         | |
+-+ +-+ + + +-+ + +-+-+-+-+-+ + +-+ + + +-+-+ +-+-+-+ + + + + + + + +-+-+ + + + + +-+-+-+ +-+ +
|     |     |       |   |     |     | | | | | | | |     | | |     |   |   | |   |     |       |
+ + +-+ +-+-+-+ + +-+-+ + + + +-+ + +-+-+ + +-+ + + +-+ + +-+ +-+ +-+-+-+ + +-+ + +-+-+-+-+-+ +
| |   |   | | | | |   |   | | |   | |   |   | |     |   | |   | |           |   |       |     |
+-+ +-+-+-+ + + +-+ +-+ + +-+-+ +-+ + + +-+ + +-+-+ +-+ + +-+ + + + + + +-+ + + +-+ +-+-+ + + +
|         |   |     |   |   |     |   |     |   |     | | |     | | | | |     |   | |     | | |
+-+-+-+-+ + + +-+-+ +-+ + +-+ +-+-+-+-+ +-+ + +-+ + +-+ +-+ + +-+-+ +-+-+-+-+ +-+-+-+-+ +-+ +-+
| |   | | | |     | | | |   | | |   | | |         | |     | | |         | | | |         |   | |
+ + +-+ + +-+-+-+ +-+ +-+-+-+ + + + + + +-+-+-+-+ +-+-+ +-+-+ +-+-+-+ + + + + + +-+-+ +-+ +-+ +
|     |     | | |     |           | |   |     | |     |   |   | |     |   | | | | |   | |   | |
+ +-+ +-+ +-+ + + + +-+ +-+ +-+-+-+ + +-+ +-+-+ +-+ +-+-+ + +-+ +-+ +-+ +-+ + + + +-+ + + + + +
|   |   | | |   | |       |       | | |     |     |   |     |   | |   |   | | |   |   |   |   |
+-+-+ +-+ + + + +-+ + + + + +-+ +-+ + +-+ +-+ + +-+-+-+-+-+-+ +-+ + +-+-+ + + + + +-+-+-+ + +-+
|             | | | | | | |   | |   |     |   |       |   | |     |   |     | | | |       | | |
+ + + +-+ +-+-+ + + + +-+-+ + +-+-+-+ + +-+ +-+-+-+ + +-+ + +-+-+ +-+ +-+-+-+-+-+-+-+ +-+ +-+ +
| | | |       |   | | | |   |   |     | |     |   | |   |                   |       |   | |   |
+-+ +-+-+-+-+-+ +-+ +-+ + +-+ + + +-+ + + + +-+ +-+ + +-+-+ +-+ +-+-+-+ +-+ + + + +-+-+ +-+ + +
|   |               |       | | |   | |   |     |   |   |   |         | |     | |     |     | |
+-+-+-+-+-+-+-+-+-+-+-+-+-+-+-+-+-+-+-+-+-+-+-+-+-+-+-+-+-+-+-+-+-+-+-+-+-+-+-+-+-+-+-+-+-+-+-+