+-+-+-+-+-+-+-+-+-+-+-+-+-+-+-+-+-+-+-+-+-+-+-+-+-+-+-+-+-+-+-+-+-+-+-+-+-+-+
|                                                                           |
+ + +-+-+-+-+-+ + + + +-+ + + +-+ + +-+ + +-+-+-+-+ + + + + + +-+ +-+-+-+-+-+
| |           | | | |   | | |   | |   | |         | | | | | |   |           |
+ +-+-+ + + + +-+-+-+ + + + + + + +-+-+ + + + +-+ +-+-+-+-+ + + + +-+-+ +-+-+
|     | | | |       | | | | | | |     | | | |   |         | | | |     |     |
+ + + + +-+ + +-+ + + +-+ + +-+-+-+ +-+-+-+-+ +-+-+ +-+ +-+ + +-+ + + +-+-+ +
| | | |   | |   | | |   | |       |         |     |   |   | |   | | |     | |
+ + + +-+ + +-+ + + +-+-+ + +-+ + +-+-+ +-+ + + +-+ + + +-+-+ +-+-+ + +-+ +-+
| | |   | |   | | |     | |   | |     |   | | |   | | |     |     | |   |   |
+ +-+ + +-+ + + + + +-+ +-+ +-+ +-+-+-+-+-+-+-+-+-+ +-+ + + + + +-+ + +-+ + +
|   | |   | | | | |   |   |   |                   |   | | | | |   | |   | | |
+ +-+-+ +-+-+ +-+ +-+ +-+ + +-+-+-+-+-+ +-+-+-+ + + +-+ +-+-+ +-+ +-+-+ + +-+
|     |     |   |   |   | |           |       | | |   |     |   |     | |   |
+ + + + + + + + +-+-+ +-+ + + + +-+-+ +-+ + + + +-+ + +-+-+ + +-+-+-+ +-+-+ +
| | | | | | | |     |   | | | |     |   | | | |   | |     | |       |     | |
+ +-+ +-+ +-+-+-+ +-+-+ + +-+ + + +-+-+ +-+-+-+ + +-+ +-+ +-+-+ + +-+-+-+ +-+
|   |   |       |     | |   | | |     |       | |   |   |     | |       |   |
+ +-+ +-+ + + + + + + +-+ + +-+ +-+-+ +-+-+ +-+-+-+ + +-+-+-+ +-+-+ + + +-+ +
|   |   | | | | | | |   | |   |     |     |       | |       |     | | |   | |
+ +-+ + +-+-+-+-+ +-+-+-+-+ + + +-+-+-+ + +-+-+ +-+ + + + + +-+-+ + +-+-+-+ +
|   | |         |         | | |       | |     |   | | | | |     | |       | |
+ + +-+ +-+-+ + + +-+-+ + + + +-+ +-+ +-+ +-+-+-+ +-+-+ +-+ + +-+ + +-+-+-+-+
| |   |     | | |     | | | |   |   |   |       |     |   | |   | |         |
+ +-+-+-+-+-+ +-+ + + + + + +-+ +-+ + + +-+-+-+-+ + +-+-+-+ + +-+ + + +-+-+ +
|           |   | | | | | |   |   | | |         | |       | |   | | |     | |
+ + +-+ +-+ + +-+-+ + + +-+ +-+-+-+ +-+-+ +-+-+-+ +-+-+ +-+-+-+ +-+ +-+ + + +
| |   |   | |     | | |   |       |     |       |     |       |   |   | | | |
+ + + + +-+ + +-+-+-+-+ + +-+-+-+-+-+ + + + + +-+-+ + + +-+-+-+-+-+-+-+ + +-+
| | | |   | |         | |           | | | | |     | | |               | |   |
+ + + + + + + +-+-+ +-+ +-+-+ + + + + +-+ + +-+ + +-+-+-+ + +-+ +-+ +-+-+-+ +
| | | | | | |     |   |     | | | | |   | |   | |       | |   |   |       | |
+ + +-+ +-+-+-+ + + +-+ +-+-+-+-+ + +-+-+ + + +-+ + +-+-+-+-+ +-+-+ +-+-+-+ +
| |   |       | | |   |         | |     | | |   | |         |     |       | |
+ +-+-+ +-+-+ + + + +-+-+-+-+ +-+-+-+ +-+-+ + + +-+ + +-+ + +-+-+-+-+ +-+-+ +
|     |     | | | |         |       |     | | |   | |   | |         |     | |
+ +-+-+ +-+-+ + +-+ +-+ + +-+-+-+-+ +-+ +-+ + + + +-+-+-+ +-+-+-+-+-+-+-+-+ +
|     |     | |   |   | |         |   |   | | | |       |                 | |
+ + + + + +-+-+ +-+ +-+ +-+ +-+-+-+-+ +-+-+-+ + +-+-+-+ + +-+ + + +-+-+ + +-+
| | | | |     |   |   |   |         |       | |       | |   | | |     | |   |
+ +-+ + + +-+ + +-+-+-+ +-+ + + + + + + + + + +-+ +-+-+-+ + +-+-+-+ +-+-+ +-+
|   | | |   | |       |   | | | | | | | | | |   |       | |       |     |   |
+ +-+ +-+-+-+-+-+ +-+-+-+-+-+-+ + + + +-+ +-+-+ + + +-+ + + +-+ + + + +-+-+-+
|   |           |             | | | |   |     | | |   | | |   | | | |       |
+ +-+-+ + + +-+-+-+ +-+ +-+ + + + +-+-+-+-+-+ +-+ +-+-+-+ + + +-+ + +-+ +-+-+
|     | | |       |   |   | | | |           |   |       | | |   | |   |     |
+ +-+ +-+ +-+-+-+-+ +-+-+-+ +-+ +-+-+ + + +-+-+ + + +-+-+ + +-+ +-+-+ + +-+ +
|   |   |         |       |   |     | | |     | | |     | |   |     | |   | |
+ +-+ + +-+-+ + + + +-+ + + +-+ +-+-+-+-+-+ + + + +-+-+-+-+-+-+ + +-+-+ +-+ +
|   | |     | | | |   | | |   |           | | | |             | |     |   | |
+ + + +-+ +-+ +-+ + + + + + +-+-+ +-+-+ +-+-+-+ +-+-+-+-+-+-+ + + + + + + +-+
| | |   |   |   | | | | | |     |     |       |             | | | | | | |   |
+ + +-+-+ +-+ +-+ + + + + +-+ +-+-+ +-+-+ +-+ + +-+ +-+-+ +-+ + + +-+-+-+-+-+
| |     |   |   | | | | |   |     |     |   | |   |     |   | | |           |
+ +-+ +-+-+-+ +-+ +-+ +-+-+-+-+-+-+ +-+-+-+ +-+ + + +-+-+-+-+ +-+ +-+ + + +-+
|   |       |   |   |             |       |   | | |         |   |   | | |   |
+ + + +-+-+ +-+ +-+ +-+-+ +-+ + + +-+-+-+-+ + + +-+ +-+-+-+ + + + +-+ +-+ +-+
| | |     |   |   |     |   | | |         | | |   |       | | | |   |   |   |
+ + +-+-+ + + + +-+-+ + +-+ + + +-+ +-+-+-+ + + + + +-+-+ + + +-+ + +-+ + +-+
| |     | | | |     | |   | | |   |       | | | | |     | | |   | |   | |   |
+ + + +-+-+-+-+-+-+-+ +-+ +-+ +-+ + +-+-+-+ +-+ + +-+-+ + + + + + + +-+ + + +
| | |               |   |   |   | |       |   | |     | | | | | | |   | | | |
+ + +-+-+ + +-+ +-+ + + + + + + + + + +-+-+ + + + + + + +-+-+-+ +-+-+ +-+ +-+
| |     | |   |   | | | | | | | | | |     | | | | | | |       |     |   |   |
+ + + +-+-+ +-+-+ +-+-+ + + +-+ + +-+-+ +-+-+ + + + +-+-+-+-+ +-+ + +-+ +-+-+
| | |     |     |     | | |   | |     |     | | | |         |   | |   |     |
+ + +-+ +-+-+ + + + +-+ + + +-+ +-+ + +-+-+ +-+-+ +-+ + + +-+ +-+-+ + +-+ +-+
| |   |     | | | |   | | |   |   | |     |     |   | | |   |     | |   |   |
+ + +-+-+ + + + +-+ + + + + + +-+-+ + + + + + + +-+-+ + +-+ + + +-+ +-+ + + +
| |     | | | |   | | | | | |     | | | | | | |     | |   | | |   |   | | | |
+ +-+ + +-+-+-+ + + +-+ + + +-+-+-+-+ +-+ + +-+ + +-+-+-+ +-+-+-+-+-+ +-+ + +
|   | |       | | |   | | |         |   | |   | |       |           |   | | |
+ + +-+ +-+ + +-+-+ +-+-+ +-+ +-+ + +-+-+-+ + +-+ + +-+ +-+-+-+-+-+ + + + +-+
| |   |   | |     |     |   |   | |       | |   | |   |           | | | |   |
+ +-+ + +-+ +-+-+-+ +-+-+ + + + +-+ + + +-+-+-+-+-+ +-+ + +-+ + + +-+ +-+ + +
|   | |   |       |     | | | |   | | |           |   | |   | | |   |   | | |
+-+-+-+-+-+-+-+-+-+-+-+-+-+-+-+-+-+-+-+-+-+-+-+-+-+-+-+-+-+-+-+-+-+-+-+-+-+-+