+-+-+-+-+-+-+
|   |     | |
+-+ + +-+ + +
| |   | | | |
+ +-+-+ + + +
|       | | |
+ +-+-+ + + +
|   |   | | |
+-+ + +-+ + +
|   |   | | |
+ +-+-+-+ + +
|           |
+-+-+-+-+-+-+