+-+-+-+-+-+-+-+-+-+-+-+-+-+-+-+-+-+-+-+-+-+-+-+-+-+-+-+-+-+
|                                                         |
+-+ + + +-+ + + + + + + + + + + + + + + + +-+ + + +-+ + + +
|   | | |   | | | | | | | | | | | | | | |   | | |   | | | |
+ + + + +-+-+ +-+-+-+-+ +-+-+ + + + + + + + + + + + +-+ + +
| | | | |       |         |   | | | | | | | | | | |   | | |
+ + + + + + + + +-+ + + + +-+ +-+-+ + +-+ +-+-+ +-+ + +-+ +
| | | | | | | | |   | | | |     |   |   |     | |   | |   |
+-+ + + +-+ + +-+ + + +-+-+ + + +-+ +-+ + + + + + + +-+ + +
|   | | |   | |   | |     | | | |   |   | | | | | |   | | |
+ +-+-+-+-+-+ + + + + + + + + +-+ + +-+ + + + + + + + + + +
|       |     | | | | | | | | |   |   | | | | | | | | | | |
+ + + + + +-+ + +-+ +-+-+ +-+ + +-+ + + +-+ + + + + + +-+ +
| | | | |   | |   | |     |   |   | | | |   | | | | | |   |
+ + +-+ + + +-+ + +-+ + +-+ + + + + + +-+ +-+ +-+-+ +-+ + +
| | |   | | |   | |   | |   | | | | | |     | |       | | |
+ + + + +-+-+ + + + +-+ +-+ + + + + + +-+ +-+ + +-+-+-+ + +
| | | | |     | | | |   |   | | | | | |   |   |     |   | |
+ + +-+ + +-+ + + + + + + +-+-+ +-+-+-+ + +-+ +-+ +-+-+-+ +
| | |   | |   | | | | | | |           | |   |   |   |     |
+ +-+ +-+ + +-+ + + +-+ +-+ + + + + + + + + + + + +-+ + + +
| |   |   | |   | |   | |   | | | | | | | | | | |   | | | |
+-+ + + + +-+ + + + + + +-+-+-+ + +-+-+ + + + + + +-+ +-+ +
|   | | |   | | | | | |     |   | |     | | | | |   | |   |
+ + + + + +-+ + + + + + +-+ +-+-+ +-+-+-+ + + + + + +-+ + +
| | | | | |   | | | | | |     |         | | | | | | |   | |
+ + +-+ +-+ + + + + + + + +-+-+ +-+ +-+ + + + + +-+ + + + +
| | |     | | | | | | | |   |   |     | | | | |   | | | | |
+ +-+ + + +-+ + + + +-+-+ +-+ + +-+ +-+-+ + +-+ + +-+-+-+ +
|   | | |   | | | |   |     | | |       | |   | | |       |
+ + + + +-+-+-+-+ +-+ + + + + +-+ +-+ + + +-+ +-+ + + + + +
| | | | |           | | | | |   |   | | | |     | | | | | |
+ +-+ +-+ + +-+ + +-+-+-+-+ + +-+ +-+ + + +-+ + + +-+ + + +
| |   |   | |   |   |       |   | |   | |   | | | |   | | |
+ + +-+-+ + + +-+-+ + + +-+ + + +-+ + +-+ + + + +-+-+ + + +
| |     | | |   |   | | |   | |   | |   | | | |   |   | | |
+-+-+-+ +-+ + + +-+-+ +-+ +-+-+ + + +-+ +-+-+ + +-+-+ + + +
|       |   | |   |   |       | | | |     |   |   |   | | |
+ + + + + + +-+ + + +-+ +-+ + +-+-+ + + +-+ +-+-+-+ +-+-+ +
| | | | | | |   | | |     | | |     | |   |       | |     |
+ +-+ + + + + + + + +-+ + + + + +-+ + + +-+-+ + +-+ + +-+ +
|   | | | | | | | | |   | | | |   | | | |     | |   | |   |
+ + + +-+ + +-+ +-+ + + +-+-+ + + + +-+-+ + +-+ +-+-+ + +-+
| | | |   | |   |   | | |     | | |   |   | |       | |   |
+ +-+ + +-+ + + + +-+ + +-+-+-+ +-+ +-+ +-+-+ +-+ + + + + +
|   | | |   | | | |   |   |     |   |   |       | | | | | |
+ + +-+ + + + + + + +-+ + +-+-+-+ + + +-+-+-+-+ + + +-+ + +
| | |   | | | | | | |   |       | | | |         | |   | | |
+ +-+ + + + + + + +-+-+-+ + + + + +-+ +-+ + +-+-+ + + +-+ +
|   | | | | | | | |       | | | | |   |   |   |   | | |   |
+ +-+-+ + + + +-+ + + + +-+ + + + + + +-+ + +-+ +-+ +-+-+ +
|     | | | | |   | | | |   | | | | |   | |   |   | |     |
+ +-+ +-+ +-+ + + +-+ + + + +-+-+ +-+-+-+-+ +-+ +-+-+ + + +
| |   |     | | |   | | | | |         |     |       | | | |
+ +-+ +-+-+ + +-+ +-+ + +-+-+ + +-+ +-+ +-+-+ +-+-+-+-+ + +
| |       | | |     | |   |   |   |   |     |       |   | |
+-+ + +-+-+-+ + + + + +-+ +-+ +-+ + + + + + + + + + + +-+ +
|   |       | | | | |   | |     | | | | | | | | | | | |   |
+-+-+-+-+-+-+-+-+-+-+-+-+-+-+-+-+-+-+-+-+-+-+-+-+-+-+-+-+-+