+-+-+-+-+-+-+-+-+-+-+-+-+-+-+-+-+-+
|                                 |
+ + +-+ + +-+-+ + +-+ +-+-+ +-+ + +
| | |   |   |   | |       | |   | |
+ + + +-+-+-+ + + +-+ + + + +-+-+ +
| | |   |     | | |   | | |     | |
+ + + + + + +-+-+-+ + +-+-+ +-+ + +
| | | | | | |       | |     |   | |
+ + + +-+ + + + + + +-+ +-+ +-+ +-+
| | | |   | | | | |   | |     |   |
+ +-+ + +-+ +-+-+ +-+-+-+ + + + +-+
|   | |   | |         |   | | |   |
+ +-+ + + + +-+ + + + +-+ +-+ + + +
|   | | | |   | | | | |   |   | | |
+ + +-+ + + +-+ + +-+ + + + + + + +
| | |   | |   | |   | | | | | | | |
+ +-+-+ + +-+-+ + + +-+ + +-+ + + +
|     | |     | | | |   |   | | | |
+ + + + +-+ + + + + +-+-+-+-+-+ +-+
| | | |   | | | | | |             |
+ +-+-+ +-+ + + + +-+-+ + + +-+-+ +
|   |     | | | | |     | |     | |
+ + +-+-+ +-+ +-+ + + + + +-+ +-+ +
| | |     |   |   | | | |   |   | |
+ + +-+ +-+ +-+-+-+ +-+ + +-+ + +-+
| |   | |     |       | |   | |   |
+ + +-+ + + +-+ + + + +-+ + + + + +
| |   | | |   | | | |   | | | | | |
+ + + + +-+ + + + + + + + +-+ + +-+
| | | |   | | | | | | | | |   |   |
+ + + +-+-+ +-+-+ +-+ +-+ +-+ + + +
| | |   |   |     |   |     | | | |
+ +-+ + + + + + + +-+ +-+ +-+ + + +
| |   | | | | | |   |   | |   | | |
+-+-+-+-+-+-+-+-+-+-+-+-+-+-+-+-+-+