+-+-+-+-+-+-+-+-+-+-+-+-+-+-+-+-+-+-+-+-+-+-+
|     |         | |   |     |       |     | |
+ + +-+-+ + + +-+ +-+ +-+-+ + +-+ + + +-+-+ +
| | |   | | |   | |       |   | | |         |
+-+ + + + +-+-+ + + +-+ + +-+-+ +-+-+ +-+-+ +
| |   | | |     |     | |   |   |     | | | |
+ +-+ +-+ + +-+-+-+ +-+ +-+-+-+ +-+ +-+ + +-+
| |       | |     |   | |     | | |   |     |
+ +-+-+-+ + +-+ + + + +-+-+ + + + +-+ +-+ +-+
| |     | |   | |   |   |   | |           | |
+ +-+-+ + + +-+ +-+ +-+-+ +-+ +-+ +-+ +-+ + +
|       | |     |       |   |   |   | |   | |
+ + +-+-+-+-+-+ +-+ +-+ + + +-+ + +-+-+-+-+ +
| | |     | |   |   |     | |         |     |
+ + + +-+-+ +-+ +-+-+ +-+-+ +-+ +-+ +-+ +-+-+
| |   |         |   | | | | |     |   |   | |
+-+-+ + +-+-+-+ + +-+-+ + + +-+ +-+-+ + + + +
| |   |     | |       |   |   |     |   | | |
+ + +-+ +-+ + +-+-+-+ + +-+-+ +-+-+-+ +-+-+ +
|     | | |   | |   | | |     |     | |     |
+-+ + + + +-+ + + +-+-+ + +-+-+ +-+-+ +-+ +-+
| | |   |   | | | |     | | | | |   |     | |
+ + +-+ + +-+ + + + +-+ +-+ + + + + +-+-+ + +
|     |   |   | |   | | |   |     |       | |
+ + +-+-+-+-+ + + + + +-+-+ + + + +-+-+ + + +
| |   | |       | |       |   | | |     | | |
+-+ + + +-+ +-+-+ +-+ +-+ + + +-+-+ + +-+ + +
| | | | |       | |     | | | | | | | | |   |
+ +-+-+ +-+ + +-+-+ +-+-+ + +-+ + +-+-+ + +-+
| | |   |   |     |   |   |   |   | |     | |
+ + + + +-+ +-+-+-+ +-+-+-+-+ + +-+ + + +-+ +
| | | | |   | |                 | |   | | | |
+ + +-+ + +-+ + + +-+ + +-+ +-+ + +-+-+-+ + +
|   |   |     | | | | |   | | |       |   | |
+-+ +-+ + + +-+ +-+ +-+-+-+ + +-+-+ +-+ +-+ +
| | |   | | | |       |         | |   |   | |
+ + + + + + + + +-+ +-+ +-+-+ +-+ + + +-+ + +
|     |   | |   |     |   |   |   | |     | |
+-+ +-+-+ +-+-+-+ +-+-+ +-+-+-+-+ + +-+ + + +
| |   |       |     | |   | |       |   |   |
+ + + +-+ +-+-+ +-+ + + +-+ +-+-+ + +-+ + +-+
|   | |     | | | | |       |   | | |   |   |
+-+ +-+ +-+-+ +-+ + +-+ + + +-+ +-+ +-+ +-+ +
|   |   |           |   | |   |       |   | |
+-+-+-+-+-+-+-+-+-+-+-+-+-+-+-+-+-+-+-+-+-+-+