+-+-+-+-+-+
|         |
+ +-+-+-+ +
|       | |
+ +-+-+ +-+
|     |   |
+ + + +-+ +
| | |   | |
+ + + + +-+
| | | |   |
+-+-+-+-+-+