+-+-+-+-+-+-+-+-+-+-+-+-+-+-+-+-+-+-+-+-+-+-+-+-+-+-+-+-+-+-+-+-+-+-+
|         | |             |                       |             |   |
+-+-+-+-+ + + +-+-+-+-+-+ + +-+-+-+ + +-+-+-+-+-+ + +-+ + +-+-+-+ + +
|   | |   |   |   |   |   |       | | |         | | |   | |       | |
+ + + + +-+ +-+ + + + + + +-+-+-+ + +-+ +-+-+-+ + +-+ +-+ + +-+-+-+ +
| |   | |   |   |   |   |   |     |           | |     |   | |     | |
+ +-+-+ + +-+ + +-+-+-+-+-+ + +-+-+-+-+-+-+-+-+ +-+-+-+ +-+ + +-+ + +
|     | | | | | |     |     | |   |       |   |   |   | |   | | | | |
+ +-+ + + + + +-+ +-+ +-+-+-+ + + + +-+-+ + + +-+ + + +-+ +-+ + + + +
| |   | |   |       |       | | |   |   | | |   |   | |   |   |     |
+ + + + +-+-+-+-+-+-+ +-+-+ + + +-+-+ + + + +-+ +-+ + + +-+ +-+ +-+-+
| | | |             |     |   |   |   | | | | |   | |   |   |   |   |
+ + +-+-+-+-+-+-+-+ +-+ +-+-+ +-+ + +-+ + + + +-+ +-+ +-+ +-+-+-+ + +
| | |   |       |   |   |   | |   | |   |   |   |   | |   |     | | |
+ + + + + + +-+-+ +-+ +-+ + +-+ +-+ + +-+-+-+ +-+-+ + + +-+ +-+ + + +
| | | |   |       |   |   |   |   | |               | |       |   | |
+-+ + +-+-+-+-+-+-+ +-+ +-+-+ +-+ + +-+-+-+-+-+-+ +-+ +-+-+ +-+-+-+ +
|   |       |       |   |   |   | |       |     | | | |   | |     | |
+ +-+-+-+-+ +-+-+-+-+ + + + +-+ + +-+ +-+-+ +-+ + + + + + +-+ +-+ + +
|     |   |   |     | | | | |   | |   |       | | |   | |     | |   |
+-+ +-+ + +-+ + +-+ + +-+ + +-+ + +-+-+ +-+-+-+ + +-+-+ +-+-+-+ +-+ +
|   |   |   |   |   |     |   | |           |   |       |         | |
+ +-+ +-+ +-+-+-+ +-+ +-+-+-+ + +-+-+-+-+-+-+ +-+-+-+-+-+-+-+ + +-+ +
|   | | |     |   |   | |     | |   |   |     |             | |   | |
+ + + + +-+-+ + +-+ +-+ + +-+-+ + + + + + +-+-+ +-+-+-+-+-+ +-+-+ + +
| |         | | |       |     |   |   | | | |         |           | |
+ +-+-+-+-+-+ + + +-+-+-+-+-+ +-+-+-+-+ + + + +-+-+-+ +-+-+ +-+-+-+ +
|     |   |   | |   |         |       |   |   |   |   |   | |       |
+-+-+-+ + + + + + +-+ +-+-+-+-+ +-+-+ +-+-+ +-+-+ + +-+ + +-+ +-+-+-+
|       |   | | | |   |     |   |   |     |       |     |   |   |   |
+ +-+-+-+-+-+ + +-+ +-+ +-+ + +-+ + +-+ + +-+-+-+ +-+-+-+-+ +-+ + + +
|   |   |   | | |   |   |   |   | |     | |     | |       |   | | | |
+ + + + + + + + + +-+ +-+ +-+-+ + +-+-+-+ + +-+ + + +-+-+ +-+ + + + +
| |   | | |   |   |   | |       | |     | |   |   | |       | |   | |
+-+-+ + +-+ +-+-+-+ +-+ +-+-+-+-+ + +-+ + +-+ +-+-+-+ +-+-+ + +-+-+ +
|   | |   |     |   |       |     |   |     |       |     | |   |   |
+ + +-+-+ +-+-+-+ +-+-+ + +-+ +-+-+-+-+-+-+-+-+-+-+ + +-+ +-+-+ + +-+
| |       |     |       | |   |             |     | |   |     |   | |
+ +-+-+ +-+ +-+ +-+-+-+-+ + +-+ +-+-+-+-+-+ + + +-+ +-+ +-+-+ +-+-+ +
| |     |   |       |     | |   |         |   |     |   | |   |     |
+ +-+-+-+ +-+ +-+ +-+ +-+-+ + +-+ +-+-+ +-+-+-+-+-+-+ +-+ + + + + + +
| |       |   |   |   |     |   |     | |     |       |   | | | | | |
+ + +-+-+-+ +-+-+ + +-+ +-+-+-+ +-+-+ + + +-+ + +-+-+-+ + + +-+ + +-+
| | |   |   |   | | |   |     | |     |   |   |   |     | |     |   |
+ + + + + + + + +-+ + +-+ +-+ + +-+-+ +-+-+ +-+-+ + +-+-+ +-+-+-+-+ +
| | | | | | | |   | |   |   | |     |     | |     | |   |   |   |   |
+ + +-+ + + + +-+ + +-+ +-+ + +-+-+ +-+-+ + + +-+-+ + + +-+ + + + + +
| | |   | | |   |     |     |     | |     | |       | |   |   | | | |
+ + + + + +-+-+ +-+-+-+-+-+-+-+ +-+ + +-+-+ +-+-+-+-+ +-+-+-+-+ + + +
| |   | |       |   |     |     |   |   |       |     |       | | | |
+ +-+-+ +-+-+-+-+ + + +-+ + +-+ + +-+-+ + +-+-+-+ + +-+ +-+-+ + + + +
|     | |     |   | |   |   |   | |     |   |     |   | |   | | | | |
+ + + + + +-+ +-+-+ +-+ +-+-+-+ + +-+-+-+-+ + +-+-+-+ + + + + + + + +
| | | | | |   |     | |       | | |         |   |   | | | | |   | | |
+ + + + + +-+ + +-+ + +-+-+-+ +-+ + +-+-+-+ +-+ + +-+ + + +-+-+-+ + +
| | | | |   |   |   |     |   |   | |   |   |   |   |   |       | | |
+ + +-+ + + +-+-+-+ +-+ + + + + +-+ + + +-+-+ +-+-+ +-+-+-+-+ + + +-+
| |     | | |     | |   | | | |   | | |       |               | |   |
+ +-+-+-+ + + +-+ + + + +-+ + +-+ + + +-+-+-+-+-+ +-+-+ +-+-+-+-+ + +
|   |   | | | |   |   | |   |   | |       |       |     |       | | |
+-+ + + + + + + +-+-+-+ + +-+-+ + +-+-+-+ +-+ +-+-+ +-+-+ +-+-+ + + +
| | | |   |   |   |     |     | |     | |   |   |   |   |   |   | | |
+ + +-+-+-+-+-+-+ + +-+-+-+-+ +-+-+-+ + +-+ +-+ + +-+ + +-+ + +-+-+ +
| |   |     |     | |   |   |       | |     |   |   | |   | | |     |
+ +-+ + +-+ + +-+-+ + + + + +-+-+ +-+ + +-+-+ +-+-+ + +-+ + + +-+ +-+
|     | |   |     |   | | |   | | |   |       |   | | |   | |   |   |
+ +-+-+ + +-+-+-+ +-+-+ +-+ + + + + +-+-+-+-+-+ + +-+ + +-+ +-+ +-+ +
|       |         |         |   |               |     |     |       |
+-+-+-+-+-+-+-+-+-+-+-+-+-+-+-+-+-+-+-+-+-+-+-+-+-+-+-+-+-+-+-+-+-+-+