+-+-+-+-+-+
|         |
+ + +-+ + +
| | |   | |
+-+ + +-+ +
|   | |   |
+ + + + + +
| | | | | |
+ + + +-+ +
| | |   | |
+-+-+-+-+-+