+-+-+-+-+-+-+-+-+-+-+-+-+-+-+-+-+-+-+-+-+-+-+-+-+-+-+-+-+-+-+-+-+-+-+-+-+-+-+-+-+
|                                                                               |
+ +-+ + + +-+ + + + + +-+-+-+ +-+ + + + + +-+ +-+ + + + +-+ + + + + + + +-+-+-+ +
| |   | | |   | | | | |         | | | | | |     | | | | |   | | | | | |       | |
+ + +-+-+-+-+ + +-+ + +-+ + +-+ + + + + + + + + +-+ + +-+ + +-+ +-+ + + +-+-+-+ +
| |   |       | |   | |   | |   | | | | | | | | |   | |   | |   |   | | |       |
+ + +-+ + + + + +-+-+-+ + +-+ +-+ + +-+-+ + + + + +-+ +-+ + +-+-+ +-+ + +-+-+ + +
| | |   | | | |     |   | |     | | |     | | | |   |   | |     |   | |   |   | |
+ + +-+ + + +-+ + +-+-+ + + + +-+-+ +-+-+-+-+-+ +-+-+ + +-+ + + + +-+-+ + +-+-+ +
| | |   | |   | |     | | | | |               | |     |   | | | |     | |     | |
+ + + + +-+ + + + + + + + +-+ +-+ + + + + + + +-+ + + +-+ +-+ + + + + + + +-+-+ +
| | | |   | | | | | | | |   | |   | | | | | | |   | |   | |   | | | | | |   |   |
+-+ + +-+-+-+-+ +-+-+ + + + + +-+ + + + + +-+ + + +-+-+ + + + + + + +-+ +-+ +-+ +
|   | |             | | | | | |   | | | |   | | | |     | | | | | | |     |   | |
+ + +-+-+-+ + + + + +-+-+ +-+ + + +-+ + +-+-+ +-+-+-+ + + + + + +-+ + + +-+-+-+ +
| |     |   | | | |   |   |   | | |   |     |     |   | | | | |   | | |       | |
+ +-+ +-+ +-+ + + + + +-+-+ + + + + + + + +-+-+ +-+ +-+ +-+-+ + + + + + + +-+-+ +
|   | |     | | | | |   |   | | | | | | | |       |   |     | | | | | | |   |   |
+ + + + +-+-+ +-+-+ +-+ + + + + + + +-+ + + +-+ + +-+ + + + +-+ + + + +-+ + + + +
| | | | |       |     | | | | | | | |   | |   | |   | | | |   | | | | |   | | | |
+ + + + +-+ + + + + + +-+-+-+-+-+ + +-+ + + +-+-+ +-+ +-+-+-+ + + + + +-+ + +-+ +
| | | |   | | | | | |     |       | |   | |     |   |   |     | | | | |   | |   |
+-+ + + + + +-+ + + + +-+ +-+-+ +-+ + +-+-+ + +-+ + + + +-+ +-+ + +-+-+ + + + + +
|   | | | | |   | | | |   |     |   |   |   | |   | | |   | |   | |     | | | | |
+ + + + + + +-+ + +-+ + + + + + +-+ +-+ + + +-+ +-+ + + +-+-+ + + +-+-+ + + + +-+
| | | | | |   | | |   | | | | | |     | | | |   |   | |   |   | |     | | | |   |
+ + + + + + + + + +-+ + +-+-+ + + + + + +-+ + + +-+-+-+-+-+-+-+ + + + + + + +-+ +
| | | | | | | | |   | | |     | | | | |   | | |     |           | | | | | | |   |
+ + +-+ + +-+ + +-+ + + + +-+-+-+ +-+-+-+ +-+ + +-+ +-+ + + + + + +-+-+-+ + + + +
| | |   | |   | |   | | |   |           |   | | |     | | | | | | |       | | | |
+ + +-+ + +-+-+ + +-+ + + + + + +-+ + +-+ + + + + + + + + +-+-+ + + + + + + +-+ +
| | |   |     | |   | | | | | | |   | |   | | | | | | | | |     | | | | | |   | |
+-+-+ +-+ + + + + + + +-+-+ +-+ + +-+ + + + + +-+-+ +-+ +-+-+ + + + + + + + +-+ +
|     |   | | | | | |     |   | |   | | | | | |       | |     | | | | | | |   | |
+ +-+ + + + +-+ + + + + + +-+ + +-+ +-+ + +-+ +-+-+ +-+-+ + +-+ +-+-+ +-+-+ + + +
|   | | | |   | | | | | |   | |   |   | | |   |         | | |       | |     | | |
+ + +-+-+ + + + + +-+ +-+ + + + + + + +-+-+ +-+ +-+ + + + + + + + + +-+ + + +-+ +
| | |     | | | | |     | | | | | | | |     |   |   | | | | | | | |   | | |   | |
+ + + + + + + + + +-+ + + + + + + + + +-+-+ +-+-+ + +-+-+-+-+ + + +-+ + + + +-+-+
| | | | | | | | |   | | | | | | | | |     |     | | |         | |   | | | |     |
+ +-+ +-+-+ + +-+ +-+ + + + + +-+-+ + + + +-+ + + + + + + + + + +-+-+-+-+-+ +-+ +
| |     |   | |   |   | | | |     | | | | |   | | | | | | | | |   |           | |
+-+ +-+ + +-+ +-+ + + + + + +-+ + +-+ +-+ + + + +-+-+-+ + +-+ + + +-+ +-+ + + + +
|   |   |   | |   | | | | |   | | |   |   | | |       | |   | | |   |   | | | | |
+ +-+-+-+ +-+ +-+ + + + + + + +-+ + + +-+-+-+ + + + + +-+ +-+-+ + + + + + +-+ + +
| |         | |   | | | | | | |   | |       | | | | |   | |     | | | | | |   | |
+ + +-+-+ + + + + + +-+ + +-+ + + +-+ +-+ + +-+ +-+ + + + + + + + + +-+ + + + + +
| | |     | | | | |   | | |   | | |     | |   | |   | | | | | | | |   | | | | | |
+-+ + + +-+-+ + + + + + + + + + +-+-+ + + + + +-+ + +-+-+ + + +-+ +-+-+-+-+ + + +
|   | | |     | | | | | | | | | |     | | | | |   |     | | | |         |   | | |
+ + +-+ +-+ +-+ + +-+ + + +-+ +-+ + +-+-+ + + + + + + +-+-+ + + +-+ +-+ + + +-+ +
| |   | |     | | |   | | |   |   | |     | | | | | |   |   | | |     | | |   | |
+ +-+ + + +-+ +-+ + +-+-+ +-+-+ +-+-+ + + + + + + +-+ + + + +-+-+ +-+ + +-+ + + +
|   | | |   | |   | |         |     | | | | | | |   | | | |   |     | |   | | | |
+-+-+-+ +-+ + + + + + +-+ + + + + + + +-+ + + + + + + +-+ +-+ + + + + + + +-+-+ +
|         | | | | | |   | | | | | | | |   | | | | | | |     | | | | | | |     | |
+-+-+-+-+ +-+ +-+ + +-+-+-+ + + +-+ + +-+-+ + +-+-+-+ + + +-+ + + +-+ + +-+ +-+ +
|         |     | |       | | | |   |   |   |       | | | |   | |   | |   |   | |
+ +-+ +-+-+ + + +-+ +-+-+ + + +-+ + +-+ + + + + +-+-+ + + + +-+-+ + + +-+ +-+ +-+
|   |   |   | |   |     | | |   | |   | | | | | |     | | |     | | | |   |     |
+ +-+ + + + + + + + + +-+ + + + + + + + +-+-+ + +-+ +-+ + + + + +-+ + +-+ +-+ + +
|   | | | | | | | | | |   | | | | | | | |     | |   |   | | | | |   | |     | | |
+-+-+ + + + + + + +-+ +-+ + +-+-+ +-+ + + + + + + + +-+ +-+-+-+ + +-+ + + + +-+ +
|     | | | | | | |     | |   |   |   | | | | | | | |     |     | |   | | |   | |
+ + + +-+ +-+-+ + +-+ +-+ +-+-+-+ + +-+-+-+-+ +-+ +-+ + + + + + +-+ + + +-+ + + +
| | | |       | | |   |   |       | |           |   | | | | | |   | | |   | | | |
+ +-+-+-+ + + + + + + + + +-+ + + + +-+-+ + +-+ +-+-+ + +-+ + + + +-+ + +-+ +-+ +
|       | | | | | | | | | |   | | | |     |   |     | |   | | | |   | |   |   | |
+-+ +-+-+ + + +-+-+ +-+ + + +-+ +-+ +-+-+ +-+ + + +-+ + +-+ +-+ +-+ +-+ + +-+ + +
|   |     | |   |     | | |   |   |     | |   | |   | | |   |     |   | |   | | |
+ +-+ + + + + + +-+ + + + + +-+ +-+ + + +-+-+ +-+-+ +-+ + + +-+-+ +-+ + + +-+ + +
| |   | | | | | |   | | | |   | |   | |     |     | |   | |     | |   | |   | | |
+ + + +-+-+ +-+-+ + + +-+ + +-+ + +-+ + + + + + + + + + + +-+-+ +-+ +-+ +-+ + + +
| | | |       |   | |   | | |   | |   | | | | | | | | | | |       | |     | | | |
+ + + + + + + +-+ +-+ + +-+-+-+ + + + +-+-+-+ + + + +-+ +-+ + +-+ + + + + + + + +
| | | | | | | |   |   | |       | | |       | | | |   |   | | |   | | | | | | | |
+ +-+ + +-+-+-+ + +-+-+ +-+ + + + +-+ + +-+ + + + + +-+ + + + + +-+ +-+ + +-+ + +
|   | | |       | |     |   | | |   | | |   | | | |   | | | | |   |   | | |   | |
+ +-+ + +-+ + +-+-+-+ + + +-+ + + + + + + + +-+ + +-+ +-+ + +-+ +-+ + + +-+ + + +
| |   | |   | |       | | |   | | | | | | | |   | |   |   | |     | | |   | | | |
+-+-+-+-+-+-+-+-+-+-+-+-+-+-+-+-+-+-+-+-+-+-+-+-+-+-+-+-+-+-+-+-+-+-+-+-+-+-+-+-+