+-+-+-+-+-+-+-+-+-+-+-+-+-+-+-+-+-+-+-+-+-+-+-+-+-+-+-+-+-+-+-+-+-+-+-+-+-+-+-+-+-+-+-+
| |       |         |     |   |   |       |             |             |               |
+ + +-+-+ +-+ + +-+ +-+-+ + + + + + +-+ + +-+-+-+-+-+ + +-+-+-+-+-+ + +-+-+-+-+ +-+-+ +
|   |   |   | | | |     |   | | |     | | |     |     |           | |   |       |   | |
+-+-+ + +-+ +-+ + +-+-+ +-+-+ + +-+-+-+ + + +-+ + +-+-+-+-+-+-+-+ + +-+ + + +-+-+ +-+ +
| |   |     |   |     |     |   |       |   | |   |     |   |   |   |   | | |   |     |
+ + +-+-+-+-+ +-+ +-+-+-+-+ + +-+ +-+-+-+-+-+ +-+-+-+ + + + +-+ +-+-+ +-+ +-+ + +-+-+ +
|   |     |   |           | |   |     |             | |   |   |     | | |   | |     | |
+ +-+-+ + + + + +-+-+-+-+ + +-+ +-+-+ + +-+-+-+-+ + + +-+-+-+ + +-+ + + + + + +-+-+ + +
|     | |   | | |       | | | |     | | |       | |   |         |   | |   |       | | |
+-+-+ +-+ +-+ + +-+-+ + + + + +-+ +-+ + + +-+-+ + +-+-+-+-+-+ +-+-+ + +-+-+-+-+-+ + +-+
|   |   |   | |       | |   |     |   | |   | | |     |     | |   | |   |     | | |   |
+ + +-+ +-+-+ +-+-+-+-+ +-+-+ +-+-+ +-+ +-+ + + +-+-+ + +-+ + + + +-+-+ + +-+ + + +-+ +
| |     |     |   |   | |       |   |       |   |     | | | | | |     |   |   | |   | |
+ +-+-+-+ +-+-+-+ + + + + +-+-+-+ +-+-+-+-+-+ +-+ +-+ + + + + + +-+ +-+-+-+ +-+ +-+ + +
|     |   |       | |   | |     | |     |   | | |   | | | | | | | |     |   | |   | | |
+-+-+ +-+ + +-+-+ + +-+-+-+ +-+ + + +-+ + +-+ + +-+ +-+ + + +-+ + +-+-+ + +-+ + + + + +
|   |     |   |   | |       |   |   |   |       | |     | |     |     | | |   | |   | |
+ + +-+-+-+ + + +-+ +-+-+ +-+ +-+-+-+ + +-+-+-+ + +-+-+-+ +-+-+-+ +-+-+ + + + + +-+-+ +
| |       | | |   |     | | |         | |   | |   |           |   |     | | |     |   |
+ +-+-+ +-+ + +-+-+-+-+ + + +-+-+-+ +-+-+ + + +-+ +-+ +-+-+-+ +-+ + +-+-+ + +-+-+-+ + +
| |   | |   |     |     | |         |   | | | |   |   |     |   | |     | |   | |   | |
+ +-+ + + +-+-+-+ + +-+-+ +-+ +-+-+-+ + + + + + +-+ +-+ + + +-+ + +-+-+ + +-+ + + +-+ +
|     |   |   |   |   |     |     |   |   | |       | | | | |   |     |   |     | |   |
+-+-+-+-+-+ + + + +-+ +-+ + +-+-+ + +-+-+-+ +-+-+-+-+ + + + + +-+-+ + +-+-+-+-+ + +-+ +
|     |     |   | | |   | |     | | |     |     | |   | | | |     | |   |     | |   | |
+ +-+ + +-+-+-+-+ + +-+ + +-+-+ +-+ + +-+ +-+-+ + + + + + +-+-+-+ + +-+ + +-+ + +-+ + +
| |     |   |       |   | |   | |   | |     |   |   |   |   |     |   |   |   | | | | |
+ +-+-+-+ + +-+-+-+-+ +-+ + + + + +-+ +-+-+ + +-+ +-+-+-+-+ + +-+-+ + +-+-+ +-+ + + + +
|       | |     |     | | | |   | | |   | | |   |     |   |   |     |     |   | | | | |
+ +-+-+ + +-+-+ + +-+-+ + + +-+-+ + +-+ + + +-+ +-+-+ +-+ +-+-+-+-+-+ +-+ +-+ + + + +-+
| |   |   |   |   |       |     |   | | | | |   |   | |       |     |   | |   |   |   |
+ +-+ +-+-+ + +-+-+ +-+-+-+-+-+ +-+ + + + + + +-+ +-+ + +-+-+ + +-+ +-+-+ + +-+-+-+-+ +
|       |   |       | |         | |   | |     |   |   |   | | |   |   |   |           |
+-+-+-+ +-+-+ +-+-+-+ + +-+-+-+ + +-+ + +-+-+-+ +-+ +-+-+ + + +-+ +-+ + +-+-+-+-+-+-+ +
|     |     |         | |     | |   | |     |     | |   | | |     |   | | |       |   |
+ +-+ +-+-+ +-+-+-+-+ + +-+ + + +-+ + +-+-+ + +-+ + + + + + +-+-+-+ +-+ + + +-+-+ + +-+
|   |     | |     |   |   | |       | |   | |   |     |   | |       |   |   |     | | |
+-+ +-+-+ + + + +-+ +-+-+ + +-+-+-+ + + + + +-+-+-+-+-+-+-+ + +-+-+-+ +-+-+ + +-+ + + +
| |   | |   | | |   |     | |     | |   | |     |     |     | |           | | |   |   |
+ +-+ + +-+-+-+ + +-+ +-+-+ + +-+ +-+-+-+ +-+-+ + +-+ + +-+ + +-+-+-+-+-+ +-+ + +-+-+ +
| |   |       | |   | |   | |   |       | | |   | |   | | | |         |   |   | |   | |
+ + +-+ + +-+ + +-+ + + + + +-+ +-+ +-+ + + + +-+ + +-+ + + +-+-+-+-+ + +-+ +-+ + + + +
|   |   |   |     | |   | |   |   |   | | | |     |   |   |       | |   |   |   | |   |
+ +-+-+ +-+ +-+-+-+ +-+-+ +-+ +-+ +-+ +-+ + +-+-+-+-+ +-+-+-+-+ + + +-+-+ + +-+-+ +-+-+
|     | | | |   |   |   |   | |   | |     |         | |         |   |     |     |   | |
+-+-+ + + + + + + +-+ + +-+ +-+ +-+ +-+-+-+ +-+ +-+-+ + +-+ +-+-+-+-+ +-+-+-+-+ +-+ + +
|   | |   |   |       | | |   |       |     | |   |   | |   |   |     | |     |   |   |
+ +-+ +-+-+-+-+-+-+-+-+ + +-+ +-+-+-+ +-+-+ + +-+ + +-+ +-+-+ + + +-+-+ + +-+ + +-+-+ +
|   |     |   |   |         | |     |     |     | | |   |     |   |     | |     |     |
+ + +-+-+ + + + + + +-+-+-+ + + +-+ +-+-+ +-+-+-+ + +-+ + +-+-+-+-+ + + + +-+-+-+ +-+-+
| |       | |   | | |     | |     |   |           | |   | |     |   | | |         |   |
+ +-+-+-+-+ +-+-+ +-+ +-+ + +-+-+ +-+ + +-+-+-+ +-+ + +-+ + + +-+ +-+ + +-+-+-+-+-+-+ +
| |       | |   |     | | | |   |   |   |     | |   | |   | |       | |               |
+ +-+-+ + + +-+ +-+-+-+ + +-+ + +-+-+-+-+ +-+ +-+ +-+ + +-+ +-+-+-+-+ +-+-+-+ +-+-+-+ +
|       | |   |     |   | |   |           | |     |   | |   |       |   |     |     | |
+-+-+-+-+ +-+ + +-+ + + + + +-+-+-+-+-+-+-+ +-+-+-+ + + +-+-+ +-+-+ +-+ +-+ +-+ +-+ + +
|       |     | | |   | |   |     |       |   |     | | |   |   | |   |   | |     | | |
+ +-+-+ +-+-+-+ + +-+-+ +-+-+ + + + +-+-+ + +-+ +-+-+ + + + +-+ + +-+ +-+ +-+ +-+-+ + +
| |   |     |   | |     |   | | |   |   |   |       | | | |   | |   |   |   | |     | |
+ + + +-+-+ + + + + +-+-+ + + + +-+-+ + +-+ + +-+-+-+ + + +-+ + + +-+-+ + + + + +-+-+-+
| | |       | | |         | | | |   | | |   | |       |   | |   | |   | | | | | |     |
+-+ +-+ +-+-+ + +-+-+-+-+-+ + + + + + + +-+-+ + +-+ +-+-+-+ +-+-+ + + + +-+ + + + +-+ +
|   |   |     |   |         | |   |   |       |   | |   |         | | |   | | |     | |
+ +-+-+-+ +-+-+-+ +-+ +-+-+-+ +-+-+-+-+-+-+-+-+-+ +-+ + + +-+-+ + + + +-+ + + +-+-+-+ +
| |       |     |   | |       |   |             |     |   |   | | | |   | | |   | |   |
+ + +-+-+-+-+ + +-+ +-+ +-+-+-+-+ + +-+-+-+-+-+ +-+-+-+-+-+ +-+ +-+ + +-+ + +-+ + + + +
| | |         |   |     |   |     |   |     | |         |     | |   | |   |   |   | | |
+ + +-+ + +-+-+-+ +-+-+-+ + + + +-+-+ + +-+ + +-+-+-+-+ + +-+ + + +-+ + +-+ +-+-+ + + +
| |   | |     |   |       |   | |   |   |   |       |   | |   |   | |   |     |   | | |
+ +-+ + +-+-+ +-+-+ + +-+-+-+-+ + + +-+-+ +-+-+ +-+-+ + + + +-+-+-+ +-+-+-+-+ + +-+ + +
|   | | |   |       | |   |     | |     | |   | |   | | | |     |     |     |   |   | |
+ +-+ + + +-+-+-+-+-+ +-+ + +-+-+ +-+-+ + + + + + + + +-+ +-+ + + +-+ + +-+ +-+-+ +-+ +
|   | | |         | |   |   |   | |   |     |   | | | |   | | | | |   |   |       |   |
+ + + + +-+-+-+ + + +-+ +-+-+ + + + + +-+-+-+-+-+ + + + +-+ + + + + +-+-+ +-+-+-+-+ +-+
| |   | |     | |   | |       |   | |     |       | |   |   | | | | |     |     |   | |
+ +-+-+ + +-+ + +-+ + +-+-+-+-+-+-+ +-+-+ + +-+-+-+ + +-+ + + + + + +-+ +-+ + +-+ +-+ +
| |   |   | |   |             |   |   | |   | |   | |     | | |   | |   | | |     |   |
+ + +-+-+-+ +-+ +-+-+-+ +-+-+-+ + +-+ + +-+-+ + + + + +-+-+-+ +-+-+ + +-+ + +-+-+-+-+ +
| |             |   | | |       |     |     |   | | | |   |   | |   | |   |   |       |
+ + +-+-+-+-+-+-+ + + + + +-+-+-+-+-+-+ +-+ + +-+ + + + + + +-+ + +-+ + +-+-+ +-+ +-+ +
| |   |         | | | | |           | | |   | |   | | | |   |   | |   |   |   |   | | |
+ +-+-+ +-+-+-+ + + + + +-+-+-+-+-+ + + + +-+ + +-+ +-+ +-+-+-+ + + +-+-+ + +-+ +-+ + +
|     | | |   |   | |       |   |   | | |   | |   |   |       | | |     |   |   |   | |
+-+-+ + + + + +-+-+ +-+-+-+-+ + + +-+ + +-+ + +-+ +-+ +-+-+-+ + + +-+-+ + +-+ +-+ + + +
|       |   |                 |   |       |     |             |         |     |   |   |
+-+-+-+-+-+-+-+-+-+-+-+-+-+-+-+-+-+-+-+-+-+-+-+-+-+-+-+-+-+-+-+-+-+-+-+-+-+-+-+-+-+-+-+