+-+-+-+-+-+-+-+-+-+-+-+-+-+-+-+-+-+-+-+-+-+-+-+-+-+-+-+-+-+-+-+-+-+-+-+-+-+-+-+-+-+-+-+-+-+-+-+-+-+-+
|                                                                                                   |
+ +-+-+-+-+ + + +-+-+-+-+ + +-+ + + + +-+ + +-+ + +-+ + +-+-+-+ +-+ +-+-+ +-+-+ +-+-+ + +-+-+ + + + +
|         | | |         | |   | | | |   | |   | |   | |       |   |     |     |     | |     | | | | |
+ +-+ +-+ + + + +-+-+-+-+ +-+-+-+ +-+ +-+ +-+ + +-+-+ + +-+ +-+-+ +-+ + + + +-+-+ + + +-+-+-+-+-+ + +
|   |   | | | |         |       |   |   |   | |     | |   |     |   | | | |     | | |           | | |
+ + + +-+-+ +-+ + + + + +-+ + + +-+ +-+-+-+-+-+-+-+ +-+ + + + +-+-+ + + +-+-+-+ + + +-+ +-+-+-+ + +-+
| | |     |   | | | | |   | | |   |               |   | | | |     | | |       | | |   |       | |   |
+ + + +-+-+-+ + + +-+ + + + +-+-+-+ +-+-+-+ +-+-+-+-+-+-+-+ +-+ + +-+-+ + +-+ +-+ + + +-+-+ + +-+-+-+
| | |       | | |   | | | |       |       |               |   | |     | |   |   | | |     | |       |
+ +-+ +-+ +-+ +-+-+ +-+ +-+ + + +-+ + +-+-+-+-+-+ + + +-+-+ + +-+ + +-+ + +-+ + +-+ + + +-+-+ +-+ +-+
|   |   |   |     |   |   | | |   | |           | | |     | |   | |   | |   | |   | | |     |   |   |
+ + + +-+ + + + +-+-+ + +-+ + +-+-+ + + +-+ +-+-+-+ + +-+-+ +-+-+ +-+-+ + +-+-+ + +-+-+ + +-+ + +-+ +
| | |   | | | |     | |   | |     | | |   |       | |     |     |     | |     | |     | |   | |   | |
+ + +-+-+ +-+ +-+ + + +-+ + +-+ + +-+-+ + + +-+-+ +-+ + +-+-+-+-+ +-+-+-+ + +-+ + +-+ +-+ +-+-+ + +-+
| |     |   |   | | |   | |   | |     | | |     |   | |         |       | |   | |   |   |     | |   |
+ + + +-+ +-+-+-+-+-+ + +-+ + +-+-+-+ + + + +-+-+-+-+-+ + +-+-+ + +-+ + +-+-+-+-+-+-+ +-+ + + + +-+-+
| | |   |           | |   | |       | | | |           | |     | |   | |             |   | | | |     |
+ +-+ +-+ + + + + + +-+ +-+-+-+-+ + + +-+ + +-+-+ + +-+ +-+ + + +-+ +-+ + +-+ +-+ + + + + + +-+-+ + +
|   |   | | | | | |   |         | | |   | |     | |   |   | | |   |   | |   |   | | | | | |     | | |
+ + +-+-+ + +-+ + + + + + +-+ + +-+ +-+-+ + + + +-+-+-+ +-+-+-+-+ + + +-+-+-+ +-+ +-+ + + +-+-+ +-+-+
| |     | |   | | | | | |   | |   |     | | | |       |         | | |       |   |   | | |     |     |
+ + + +-+ + +-+ +-+ +-+ + + + + +-+ +-+ +-+ + + +-+ + +-+-+-+ +-+ + +-+ +-+ + + +-+-+ + +-+ + +-+ + +
| | |   | |   |   |   | | | | |   |   |   | | |   | |       |   | |   |   | | |     | |   | |   | | |
+ +-+ +-+ + + + + +-+ +-+ +-+-+ + + +-+ +-+ + + +-+-+ + +-+ + +-+-+ + +-+ +-+-+-+-+-+ +-+-+ + +-+ + +
|   |   | | | | |   |   |     | | |   |   | | |     | |   | |     | |   |           |     | |   | | |
+ +-+ +-+-+-+-+ + +-+ + +-+-+ +-+-+ + + + +-+-+-+-+ + +-+ + +-+ +-+ + + +-+ +-+ +-+ + + + +-+ +-+ +-+
|   |         | |   | |     |     | | | |         | |   | |   |   | | |   |   |   | | | |   |   |   |
+ +-+ + + + +-+-+ + + +-+ +-+ + +-+ +-+-+-+-+-+-+ + +-+-+ + + +-+-+ +-+-+ + + + +-+ +-+ + + + +-+-+ +
|   | | | |     | | |   |   | |   |             | |     | | |     |     | | | |   |   | | | |     | |
+ + + +-+ + + +-+ +-+-+ + +-+-+ +-+ + +-+ +-+ + + +-+-+ +-+ + + + +-+ + +-+-+-+ + +-+-+ +-+ +-+ +-+-+
| | |   | | |   |     | |     |   | |   |   | | |     |   | | | |   | |       | |     |   |   |     |
+ + +-+ + +-+ + +-+ + +-+ +-+ + +-+ +-+-+ + +-+-+-+ +-+ + +-+-+ + + + +-+ +-+-+-+-+ + + + +-+ +-+ + +
| |   | |   | |   | |   |   | |   |     | |       |   | |     | | | |   |         | | | |   |   | | |
+ +-+ +-+-+ +-+ +-+-+-+ + + +-+-+-+-+ +-+ +-+ + + +-+-+ + + + +-+ +-+ +-+-+-+-+-+-+-+-+-+ + + + +-+-+
|   |     |   |       | | |         |   |   | | |     | | | |   |   |                   | | | |     |
+ + +-+ +-+ +-+ + +-+-+ +-+ + + +-+-+-+ +-+-+-+-+ + +-+ +-+-+ +-+ + + +-+ + +-+-+-+-+ +-+-+ +-+-+-+ +
| |   |   |   | |     |   | | |       |         | |   |     |   | | |   | |         |     |       | |
+ +-+ +-+ +-+ +-+-+-+-+ +-+ +-+-+-+ + +-+-+-+ + +-+ + +-+ + +-+ + + +-+ +-+ + +-+ +-+-+ +-+ + +-+-+-+
|   |   |   |         |   |       | |       | |   | |   | |   | | |   |   | |   |     |   | |       |
+ + +-+ + +-+-+ + +-+ + + +-+-+-+-+ + +-+ +-+-+-+ + +-+ + +-+-+-+ + +-+-+-+-+ + + +-+ +-+ +-+-+-+ + +
| |   | |     | |   | | |         | |   |       | |   | |       | |         | | |   |   |       | | |
+ + + + + +-+ +-+-+-+-+-+-+ + + + +-+ + + + +-+-+-+ + +-+ +-+-+-+-+ +-+-+-+ +-+-+-+-+ +-+-+ + +-+ + +
| | | | |   |             | | | |   | | | |       | |   |         |       |         |     | |   | | |
+ + +-+ + + +-+-+-+-+-+-+ + + + +-+ +-+ +-+-+-+-+-+-+ + +-+-+-+ +-+ +-+-+ +-+-+-+ + + +-+ + + + + +-+
| |   | | |             | | | |   |   |             | |       |   |     |       | | |   | | | | |   |
+ +-+ +-+-+ +-+ +-+-+-+ + +-+-+-+ +-+-+-+-+-+-+ + + +-+-+-+-+ + +-+-+ + +-+ +-+ +-+ +-+ +-+-+ + +-+ +
|   |     |   |       | |       |             | | |         | |     | |   |   |   |   |     | |   | |
+ + +-+ + + +-+ +-+ + + + +-+-+-+-+ +-+-+ +-+-+-+-+-+-+-+-+ +-+-+-+ +-+-+ +-+ + +-+-+-+-+ + + + +-+ +
| |   | | |   |   | | | |         |     |                 |       |     |   | |         | | | |   | |
+ +-+ +-+ + + + + +-+-+-+ +-+ + + + + + + +-+-+-+ +-+-+ + +-+ +-+-+ +-+-+ +-+-+ +-+-+ + +-+-+-+ + +-+
|   |   | | | | |       |   | | | | | | |       |     | |   |     |     |     |     | |       | |   |
+ +-+ + + + +-+-+-+ + + + +-+-+ +-+-+ +-+ + + + +-+ + + +-+ +-+ +-+ +-+ + +-+-+-+ + + +-+ +-+ +-+-+-+
|   | | | |       | | | |     |     |   | | | |   | | |   |   |   |   | |       | | |   |   |       |
+ +-+ + + + +-+-+ + +-+ + + +-+ + +-+ + +-+ +-+-+ + + +-+ +-+-+-+ + +-+ + + + + + + + + + + +-+ + +-+
|   | | | |     | |   | | |   | |   | |   |     | | |   |       | |   | | | | | | | | | | |   | |   |
+ + +-+ +-+ +-+-+-+ +-+-+-+ + + + +-+ + +-+-+ +-+ + + + +-+ + + +-+-+-+ +-+ +-+ +-+-+ + +-+-+ + +-+ +
| |   |   |       |       | | | |   | |     |   | | | |   | | |       |   |   |     | |     | |   | |
+ + +-+-+-+-+-+ +-+ + + +-+ + +-+ + +-+ +-+-+ + +-+ + +-+ +-+-+ +-+ +-+-+ +-+ +-+ + + + +-+ + + +-+ +
| |           |   | | |   | |   | |   |     | |   | |   |     |   |     |   |   | | | |   | | |   | |
+ +-+-+-+-+ +-+-+ + + + +-+-+ +-+ +-+ +-+ + +-+-+-+-+ +-+-+-+-+-+ +-+-+ +-+ +-+-+ + + + + +-+-+-+-+-+
|         |     | | | |     |   |   |   | |         |           |     |   |     | | | | |           |
+ +-+-+-+ +-+ + +-+ + +-+-+ +-+ + + +-+ + +-+-+-+-+-+-+-+ + + + +-+-+-+ +-+ +-+ +-+ + +-+-+ +-+ +-+ +
|       |   | |   | |     |   | | |   | |               | | | |       |   |   |   | |     |   |   | |
+ + + +-+-+-+-+-+-+ +-+ + +-+ + +-+-+-+-+-+ + + + + + + + + +-+-+ + +-+ + +-+-+ + + + +-+-+-+ +-+-+ +
| | |             |   | |   | |           | | | | | | | | |     | |   | |     | | | |       |     | |
+ + +-+ + + + +-+ +-+-+ + +-+-+ + + + + + + +-+-+-+-+-+ + +-+-+ +-+ + + + + +-+ + + +-+ +-+-+ +-+-+ +
| |   | | | |   |     | |     | | | | | | |           | |     |   | | | | |   | | |   |     |     | |
+ +-+ +-+ +-+-+-+-+-+-+-+ +-+-+-+-+-+-+ +-+-+ +-+-+ + +-+ +-+-+-+-+-+ + +-+ + + + + + + + + +-+ +-+-+
|   |   |               |             |     |     | |   |           | |   | | | | | | | | |   |     |
+ +-+ + +-+-+ +-+ + +-+-+-+ +-+-+-+ + + + +-+ +-+-+ +-+ +-+ + +-+-+-+-+-+-+ +-+ +-+-+ + + + +-+ +-+ +
|   | |     |   | |       |       | | | |   |     |   |   | |             |   |     | | | |   |   | |
+ + + + + + + + + + +-+ +-+-+-+-+-+ +-+ +-+-+ +-+ +-+ + + +-+ + +-+-+-+-+-+-+ +-+ +-+ +-+ + +-+ +-+-+
| | | | | | | | | |   |           |   |     |   |   | | |   | |             |   |   |   | |   |     |
+ +-+ +-+-+-+-+ +-+-+-+ +-+ +-+ +-+-+-+-+ +-+-+ +-+ + + +-+-+-+-+-+-+-+-+-+-+-+-+-+ +-+-+-+ + + +-+ +
|   |         |       |   |   |         |     |   | | |                           |       | | |   | |
+ +-+ +-+ +-+ + +-+ + +-+ +-+-+-+-+-+ + +-+ +-+ +-+-+-+ + +-+ + +-+ +-+ + + + + + +-+ +-+ + + +-+-+-+
|   |   |   | |   | |   |           | |   |   |       | |   | |   |   | | | | | |   |   | | |       |
+ +-+ +-+-+ +-+ +-+ +-+-+ +-+ +-+-+-+ + +-+ + +-+ + + + + + +-+ + +-+ + + + +-+-+ +-+ +-+ + + +-+ + +
|   |     |   |   |     |   |       | |   | |   | | | | | |   | |   | | | |     |   |   | | |   | | |
+ + + +-+ + +-+-+-+ +-+-+-+-+-+-+ + +-+-+ + + +-+ +-+ +-+-+-+-+-+ +-+-+-+-+-+-+-+-+ +-+-+-+-+-+-+-+-+
| | |   | |       |             | |     | | |   |   |           |                 |                 |
+ + +-+-+ +-+-+-+-+-+ +-+-+-+ + + +-+ +-+ +-+ + + + + + + + +-+-+ +-+-+-+ + + + +-+-+-+ +-+ + + + +-+
| |     |           |       | | |   |   |   | | | | | | | |     |       | | | |       |   | | | |   |
+ +-+-+ +-+ + + + + +-+-+-+-+ + + + +-+ +-+-+ + +-+ + + +-+ + +-+-+ +-+-+ + +-+ + +-+ + + + +-+ + + +
|     |   | | | | |         | | | |   |     | |   | | |   | |     |     | |   | |   | | | |   | | | |
+ + +-+-+ +-+ +-+ +-+-+-+-+-+ + + + +-+-+-+ +-+-+-+-+ +-+-+ +-+ +-+-+ + +-+ + + + + +-+-+ + + + +-+ +
| |     |   |   |           | | | |       |         |     |   |     | |   | | | | |     | | | |   | |
+ +-+-+ +-+ + +-+-+ + +-+-+ + + +-+ + +-+-+ +-+ +-+ +-+ + + +-+-+ + +-+ + +-+ + + + + + +-+ +-+ +-+-+
|     |   | |     | |     | | |   | |     |   |   |   | | |     | |   | |   | | | | | |   |   |     |
+ + + +-+-+-+ +-+-+ +-+ +-+ +-+ + + + +-+-+-+-+-+-+-+ + +-+-+-+ + +-+-+ + +-+ +-+-+-+-+-+-+-+ +-+ + +
| | |       |     |   |   |   | | | |               | |       | |     | |   |               |   | | |
+ + +-+-+-+-+-+ +-+-+-+ + +-+-+ + +-+-+-+ + +-+ +-+ +-+-+ + +-+-+-+-+-+-+-+ +-+ +-+-+-+-+-+-+ +-+-+ +
| |           |       | |     | |       | |   |   |     | |               |   |             |     | |
+ +-+-+ + + +-+ +-+-+ + +-+ +-+ +-+-+ + +-+-+-+-+ + +-+ +-+ + + +-+-+-+ +-+-+ +-+ +-+ + + + + +-+ +-+
|     | | |   |     | |   |   |     | |         | |   |   | | |       |     |   |   | | | | |   |   |
+ +-+-+ +-+ + +-+ +-+ + + +-+-+ + +-+ +-+-+ + + + + +-+ +-+ + +-+ + +-+ + +-+-+ + + + + + + +-+-+ + +
|     |   | |   |   | | |     | |   |     | | | | |   |   | |   | |   | |     | | | | | | |     | | |
+ +-+ +-+-+-+ + +-+-+-+ + +-+ +-+ + +-+ +-+-+-+ +-+-+ +-+-+ + +-+ + +-+ + +-+ + +-+-+ + +-+ +-+ +-+-+
|   |       | |       | |   |   | |   |       |     |     | |   | |   | |   | |     | |   |   |     |
+-+-+-+-+-+-+-+-+-+-+-+-+-+-+-+-+-+-+-+-+-+-+-+-+-+-+-+-+-+-+-+-+-+-+-+-+-+-+-+-+-+-+-+-+-+-+-+-+-+-+