+-+-+-+-+-+-+-+-+-+-+-+-+-+-+-+-+-+-+-+-+-+-+-+-+-+-+-+-+-+-+-+-+-+-+-+-+-+-+-+
|                                                                             |
+ +-+-+ + + + +-+ + +-+ + + +-+ + + +-+ +-+-+ + +-+ +-+ + + +-+-+-+-+-+ + + + +
|     | | | |   | |   | | |   | | |   |     | |   |   | | |           | | | | |
+ + +-+-+-+-+-+ + +-+ +-+ + +-+-+-+ + +-+ +-+-+ +-+ + +-+-+-+-+-+ +-+-+-+ + +-+
| |           | |   |   | |       | |   |     |   | |           |       | |   |
+ +-+-+-+ +-+ +-+ +-+ + +-+ + +-+ +-+-+-+ +-+-+-+-+ +-+-+-+ +-+-+-+-+-+-+ + +-+
|       |   |   |   | |   | |   |       |         |       |             | |   |
+ +-+ + +-+ +-+ + + + +-+ +-+-+ +-+ +-+-+ +-+-+ + + +-+ + + + + +-+-+ + + + + +
|   | |   |   | | | |   |     |   |     |     | | |   | | | | |     | | | | | |
+ + + +-+ + + + + + +-+-+ +-+ + + + + +-+ +-+ +-+ +-+ +-+-+ + +-+-+ + + +-+-+-+
| | |   | | | | | |     |   | | | | |   |   |   |   |     | |     | | |       |
+ + + + +-+ + +-+-+-+ + +-+-+-+ +-+ + +-+ + +-+-+-+ + +-+ +-+ +-+ +-+ +-+ +-+ +
| | | |   | |       | |       |   | |   | |       | |   |   |   |   |   |   | |
+ + + +-+ +-+-+ +-+ + +-+-+-+-+-+-+ + + +-+ + +-+-+ +-+-+ +-+-+ + + +-+ +-+-+ +
| | |   |     |   | |             | | |   | |     |     |     | | |   |     | |
+ + + + + + +-+ + + +-+ +-+ +-+-+ +-+-+ +-+-+-+ + + +-+-+-+ + +-+-+-+-+-+-+-+ +
| | | | | |   | | |   |   |     |     |       | | |       | |               | |
+ + + +-+ + + + +-+-+ + + +-+ + + +-+-+-+-+-+-+ +-+ + +-+ +-+-+ + + +-+ +-+ + +
| | |   | | | |     | | |   | | |             |   | |   |     | | |   |   | | |
+ + + + +-+ +-+-+ + +-+ + +-+ + +-+ + + +-+-+ + +-+-+-+ +-+ + +-+-+ +-+-+-+-+-+
| | | |   |     | |   | |   | |   | | |     | |       |   | |     |           |
+ + +-+ +-+ +-+-+-+ +-+-+-+ + +-+-+-+ +-+ +-+ + +-+ + + + +-+-+-+ + + + + + +-+
| |   |   |       |       | |       |   |   | |   | | | |       | | | | | |   |
+ + +-+ +-+ + + +-+-+ +-+-+-+ + +-+-+-+-+ + + + +-+ +-+ +-+-+-+-+-+-+-+ +-+-+ +
| |   |   | | |     |       | |         | | | |   |   |               |     | |
+ +-+-+-+ +-+-+ +-+-+ + +-+-+-+ + + + + +-+ +-+ + +-+-+-+ + +-+-+-+ + +-+-+ + +
|       |     |     | |       | | | | |   |   | |       | |       | |     | | |
+ +-+ + + +-+-+-+-+-+-+-+ + +-+-+-+-+ + +-+-+ +-+-+-+-+-+ + +-+-+ + +-+ + + + +
|   | | |               | |         | |     |           | |     | |   | | | | |
+ + +-+ +-+ + +-+-+ +-+-+-+ + +-+ + +-+-+-+ +-+-+ +-+-+ +-+-+ + + + +-+-+ + +-+
| |   |   | |     |       | |   | |       |     |     |     | | | |     | |   |
+ +-+ +-+ +-+ +-+-+-+-+-+-+ +-+-+-+-+-+-+-+-+ +-+ +-+ + +-+ +-+ +-+ +-+-+ + +-+
|   |   |   |             |                 |   |   | |   |   |   |     | |   |
+ + + + +-+-+ +-+ + + + +-+-+-+ +-+ +-+-+ +-+ +-+-+-+ +-+ + +-+-+-+ + +-+ +-+-+
| | | |     |   | | | |       |   |     |   |       |   | |       | |   |     |
+ + +-+ +-+-+-+ + +-+ +-+ +-+-+-+-+ +-+-+ + +-+-+-+-+-+-+ + +-+-+-+-+-+ +-+ + +
| |   |       | |   |   |         |     | |             | |           |   | | |
+ +-+-+ + +-+-+ + + + + + + +-+-+-+ + + +-+ + +-+-+-+ +-+-+ +-+-+-+-+ + +-+ +-+
|     | |     | | | | | | |       | | |   | |       |     |         | |   |   |
+ +-+-+ +-+ + +-+-+ +-+-+-+-+-+ +-+-+ + + + + +-+ + +-+ +-+ +-+-+-+-+ +-+-+ +-+
|     |   | |     |           |     | | | | |   | |   |   |         |     |   |
+ + +-+-+ + +-+ +-+-+-+-+ +-+-+-+ + + + +-+ + +-+-+-+-+-+ + + + + +-+ +-+-+-+ +
| |     | |   |         |       | | | |   | |           | | | | |   |       | |
+ + +-+ +-+ + + + + +-+ + +-+-+-+ + +-+ + +-+-+ +-+ + +-+-+ +-+ + + + + + +-+ +
| |   |   | | | | |   | |       | |   | |     |   | |     |   | | | | | |   | |
+ + +-+ +-+ + +-+ + +-+-+ + +-+ +-+-+ +-+-+ +-+-+-+-+-+ +-+-+-+-+-+-+-+ + + + +
| |   |   | |   | |     | |   |     |     |           |               | | | | |
+ + +-+-+-+-+ +-+-+-+-+ +-+-+ + + +-+-+ +-+ + +-+ + +-+ + + + +-+ + +-+-+ + + +
| |         |         |     | | |     |   | |   | |   | | | |   | |     | | | |
+ +-+ + +-+ +-+-+ +-+-+ +-+ + + + +-+-+ +-+-+ +-+ +-+-+ + +-+-+ +-+ + +-+-+ + +
|   | |   |     |     |   | | | |     |     |   |     | |     |   | |     | | |
+ + +-+ + +-+ + +-+ +-+-+-+ + +-+-+ + + +-+-+ +-+-+ + + +-+ + +-+ + +-+ + +-+-+
| |   | |   | |   |       | |     | | |     |     | | |   | |   | |   | |     |
+ +-+-+-+ +-+ + +-+-+-+ + +-+-+-+-+ + +-+-+-+ + + +-+ +-+ + +-+ +-+ +-+ + +-+ +
|       |   | |       | |         | |       | | |   |   | |   |   |   | |   | |
+ +-+ +-+ + + +-+-+-+ + + + + +-+ + + + + + + + + +-+ + + + +-+ +-+-+-+ + + +-+
|   |   | | |       | | | | |   | | | | | | | | |   | | | |   |       | | |   |
+ + +-+ +-+ +-+-+-+-+-+-+-+ +-+-+-+ + +-+ +-+-+ + + + +-+-+ +-+ +-+-+-+-+ +-+-+
| |   |   |               |       | |   |     | | | |     |   |         |     |
+ + +-+-+ + +-+ + +-+ +-+ +-+ +-+ +-+ + + + + + +-+-+ +-+ + +-+-+-+-+ + +-+-+ +
| |     | |   | |   |   |   |   |   | | | | | |     |   | |         | |     | |
+ +-+-+-+ +-+-+-+-+ + + + + +-+ + + +-+-+-+-+-+ + +-+-+-+-+-+-+-+-+-+ + +-+-+ +
|       |         | | | | |   | | |           | |                   | |     | |
+ +-+-+ + + +-+-+ +-+-+-+ + + +-+-+ +-+ +-+-+-+ + + +-+ +-+-+-+ +-+ + +-+ + + +
|     | | |     |       | | |     |   |       | | |   |       |   | |   | | | |
+ +-+ +-+-+ +-+-+ + + + + +-+ +-+ + +-+-+ + + + + +-+ +-+-+ +-+ + + + +-+ + + +
|   |     |     | | | | |   |   | |     | | | | |   |     |   | | | |   | | | |
+ +-+-+-+-+-+-+-+-+ + + +-+ +-+ + + +-+ + + + + +-+-+ +-+-+-+-+ + + + +-+ + + +
|                 | | |   |   | | |   | | | | |     |         | | | |   | | | |
+ + +-+ +-+ +-+ +-+ + + +-+ + + + +-+-+ +-+ + + + + + + + +-+-+-+-+ + + + + +-+
| |   |   |   |   | | |   | | | |     |   | | | | | | | |         | | | | |   |
+ + +-+-+ + +-+-+-+ + +-+ + + +-+-+-+-+ +-+-+-+ + + +-+ + + +-+-+-+-+ +-+ +-+-+
| |     | |       | |   | | |         |       | | |   | | |         |   |     |
+ +-+-+-+ +-+ +-+ +-+-+ +-+ + +-+-+ +-+ + + + + +-+-+-+ + +-+ +-+ +-+-+ +-+-+-+
|       |   |   |     |   | |     |   | | | | |       | |   |   |     |       |
+ + + +-+ +-+-+ + + + +-+ +-+-+ +-+-+-+-+-+-+ +-+-+-+ + + + + + + +-+-+-+-+-+-+
| | |   |     | | | |   |     |             |       | | | | | | |             |
+-+-+-+-+-+-+-+-+-+-+-+-+-+-+-+-+-+-+-+-+-+-+-+-+-+-+-+-+-+-+-+-+-+-+-+-+-+-+-+