+-+-+-+-+-+-+-+-+-+-+-+-+-+-+-+-+-+-+-+-+-+-+-+-+-+-+-+-+-+-+-+-+-+-+-+-+-+-+-+-+-+-+-+-+-+-+-+-+-+-+
|                                                                                                   |
+ + +-+ +-+ +-+ +-+ +-+-+-+-+ + + + +-+ + +-+ +-+ + + + +-+ + +-+ + + + + + + + + + +-+ + + + +-+ + +
| | |     | |   |   |         | | |   | | |     | | | |   | |   | | | | | | | | | |   | | | |   | | |
+ +-+-+ +-+ + + + + + + + +-+ + +-+ + + + + +-+ + + + +-+-+ +-+ + + + + + + + + + +-+ + + +-+ +-+-+ +
| |     |   | | | | | | | |   | |   | | | |   | | | | |     |   | | | | | | | | |   | | | |   |     |
+ + + + +-+ + + +-+ +-+ + + + + + + +-+ + + +-+ +-+-+ +-+ + + + + +-+-+ + + + + + +-+ +-+-+-+ +-+-+ +
| | | |   | | | |   |   | | | | | | |   | |   |     |   | | | | | |     | | | | | |   |           | |
+ + + + +-+ + + + + + + + + + + + + +-+-+ +-+-+-+ + + + +-+ + + + + + +-+ + + + + + +-+ + +-+ + + + +
| | | |   | | | | | | | | | | | | | |         |   | | |   | | | | | | |   | | | | | |   | |   | | | |
+ + + +-+ +-+ + + + + + +-+-+ + +-+ +-+ +-+ + + + +-+ + +-+ +-+ + + +-+ + +-+ +-+ +-+ +-+-+ +-+ + + +
| | |   | |   | | | | |   |   |   |   |   | | | | |   | |     | | | |   |   | |   |   |     |   | | |
+ + +-+ + + + + +-+ + + +-+ +-+ +-+ + + +-+-+ + + + +-+ +-+ +-+ + +-+-+ +-+ + + + + +-+ + + + + + +-+
| | |   | | | |   | | | |     |   | | | |     | | |   |   | |   |   |     | | | | |   | | | | | |   |
+-+-+-+ +-+ +-+ +-+-+ + + +-+ + + +-+ + + + +-+-+ +-+ + + +-+ +-+ + + + + +-+ +-+-+-+-+ + +-+ + + + +
|         | |   |     | |   | | |   | | | | |       | | | |     | | | | | |     |       | |   | | | |
+-+ + +-+ +-+-+-+ + + + +-+-+-+ + +-+ + + +-+-+-+ + + +-+ + +-+-+-+-+ +-+ +-+ +-+ + + + +-+-+ + + +-+
|   |   |       | | | |   |     |   | | | |       | |   | |       |   |   |   |   | | |     | | |   |
+ +-+ +-+ +-+ + +-+-+ +-+ + + +-+ +-+ + +-+-+-+ +-+ + + +-+ + + + +-+ + + + +-+ + + + + + + +-+ + + +
|   | |     | | |       | | | |     | |     |   |   | |   | | | | |   | | | |   | | | | | | |   | | |
+ + + + + +-+ + +-+-+ + + +-+-+ + + + +-+-+-+ + + + + + + + +-+ + + +-+ + + + + +-+ +-+-+-+ + + + +-+
| | | | | |   | |     | | |     | | |       | | | | | | | |   | | |   | | | | |   |   |     | | |   |
+ +-+-+ +-+ + + +-+ + + + + + + + + + + +-+ +-+ +-+ + + + + + + + +-+ +-+-+ +-+-+ + + + + + +-+ + +-+
|   |   |   | | |   | | | | | | | | | |   |   |   | | | | | | | |   | |       |   | | | | | |   |   |
+ + + +-+-+ +-+ + + + + + + + +-+ + + +-+-+ +-+-+-+-+ + + + +-+-+ + +-+-+ + + + + + + + + +-+ +-+ + +
| | | |     |   | | | | | | | |   | | |         |     | | |     | |   |   | | | | | | | |   |   | | |
+ +-+ + + + + +-+ +-+ + + + + +-+ +-+ + + + + + + + + +-+ +-+ + + + + + + + +-+ + + + + +-+-+ + + + +
| |   | | | | |     | | | | |   |   | | | | | | | | | |   |   | | | | | | | |   | | | |   |   | | | |
+ + +-+-+-+ + + + + + + + +-+ + +-+ + + + +-+-+ + + +-+ +-+-+ +-+ + + + +-+-+-+ +-+-+-+ +-+ +-+ + + +
| |       | | | | | | | |   | | |   | | |   |   | | |       |   | | | | |             | |   |   | | |
+ + + + + + + +-+-+ + +-+ + +-+ +-+ + + + + +-+ + + +-+ + + + +-+-+ + + + +-+-+-+ +-+ + + +-+ + +-+ +
| | | | | | |   |   |   | |   | |   | | | |   | | |   | | | |     | | | |       | |   | |   | |   | |
+ + + + +-+ +-+-+ + + +-+ + + + + + +-+ + + + +-+-+ + +-+ +-+ + + + + +-+ +-+ + + + + + + +-+-+ + + +
| | | | |     |   | |   | | | | | |   | | | |   |   | |   |   | | | |   | |   | | | | | |   |   | | |
+ +-+-+-+-+ + +-+ +-+ + + + +-+-+ + + + + + +-+-+-+-+-+ + +-+-+-+ +-+ + + +-+-+ + + + +-+ +-+-+-+ + +
|   |       | |     | | | | |     | | | | |     |       |       | |   | |     | | | | |   |       | |
+ + +-+-+ + + + +-+ + + +-+ +-+ +-+ +-+ + + + + +-+-+ +-+ + +-+ + + +-+ + + + + +-+ +-+-+ + + + + + +
| |   |   | | |   | | |   | |   |   |   | | | | |     |   | |   | | |   | | | |   | |     | | | | | |
+ + +-+-+ + + +-+ +-+-+-+-+-+ + + + +-+-+ +-+ + +-+-+ + +-+ + + +-+ +-+-+ + +-+-+ +-+ + + + + + + + +
| | |     | | |   |           | | |     |   | |     | |   | | | |       | |   |   |   | | | | | | | |
+ +-+ + + +-+ +-+ + + +-+-+ + + +-+ +-+ + +-+ + +-+-+ + + + +-+ + + + + +-+-+-+ +-+ +-+ +-+-+-+ + + +
| |   | | |     | | |     | | | |     | |   | |   |   | | | |   | | | |       |   |   |   |     | | |
+ +-+ + + + + +-+-+ + + + +-+-+ +-+ +-+ +-+ +-+ + +-+ + + + + +-+ + + +-+ + +-+-+ +-+ + +-+ + +-+-+ +
|   | | | | | |     | | | |       | |     |   | | |   | | | |   | | | |   |     |   | |   | |     | |
+ +-+ + + + +-+ + + + +-+ + +-+ + + + + + + +-+-+ + + +-+ + +-+ +-+-+ + + + + + + + +-+ +-+-+-+ +-+ +
|   | | | | |   | | |   | |   | | | | | | |   |   | |   | |   |   |   | | | | | | |   |     |   |   |
+ +-+-+-+-+-+ + +-+ +-+ +-+ + + + + +-+ +-+-+ + + +-+ + + + +-+ + +-+ +-+ +-+-+-+ +-+ + + + + +-+ +-+
| |           |   |   |   | | | | | |   |     | |   | | | |   | | |     | |       |   | | | | |     |
+ +-+-+-+ + +-+ +-+ +-+-+ +-+ + +-+ + + + +-+ +-+ + + + + +-+-+ + + + + + +-+-+ + +-+-+ + + + + +-+ +
| |       |   | |     |     | | |   | | |   | |   | | | | |     | | | | |     | | |     | | | |   | |
+ + + +-+ + + + + + + +-+ + + +-+-+ +-+ + + + +-+ + +-+-+ + +-+-+ +-+ + + +-+ +-+ + +-+ +-+ +-+-+ +-+
| | | |   | | | | | | |   | | |     |   | | |   | | |     |     | |   | |   |   | | |   |   |       |
+ + + + + +-+ +-+ + +-+ + +-+ +-+ + +-+ + +-+-+-+-+ + + +-+-+ + + +-+-+ + + + + +-+ + + + + + +-+ + +
| | | | | |     | |   | | |   |   | |   |         | | | |     | |     | | | | | |   | | | | | |   | |
+ + + + + +-+ +-+ +-+ +-+-+ +-+ + +-+ + + +-+ +-+ + +-+ + +-+ + + +-+ + +-+ + + + + + +-+ + + + +-+ +
| | | | | |     | |   |       | | |   | |   | |   | |   | |   | |   | | |   | | | | | |   | | | |   |
+ + + + + + +-+ + + + + +-+-+ + + + + +-+ +-+-+ + + + + + + + +-+ + + + + + + +-+-+ +-+-+-+ +-+ +-+ +
| | | | | |   | | | | |     | | | | | |   |     | | | | | | |   | | | | | | |   |         |   |   | |
+ + +-+ +-+ + +-+ + + +-+ + + + + + + + + + + + + +-+ + + +-+-+-+ +-+-+ + +-+ + + + + + + + + + +-+ +
| |   | |   |   | | |   | | | | | | | | | | | | | |   | |   |         | |   | | | | | | | | | | |   |
+ +-+ +-+ +-+ + + + +-+ + + + + +-+ + +-+-+-+ + +-+-+ +-+ +-+-+ +-+-+ + +-+ +-+ + +-+-+-+-+ + +-+ + +
|   | |     | | | |   | | | | |   | |     |   |   |   |   |         | |   |   | |   |       |   | | |
+ +-+-+ + + + +-+ +-+-+ + + + + + +-+-+-+ + + +-+ +-+-+ + + + + +-+ +-+ + + + +-+-+ + + + + + +-+-+ +
|     | | | | |     |   | | | | |       | | | |   |     | | | |   | |   | | |     | | | | | |     | |
+ +-+ +-+-+-+-+ +-+ + + + + + + +-+-+-+ +-+ + + +-+-+ + + +-+ + + + + +-+-+ +-+ + + + +-+ +-+ +-+-+ +
| |   |           | | | | | | | |         | | |   |   | |   | | | | | |       | | | | |     | |     |
+ + + + +-+-+ +-+ +-+ + + + + + + + + + + + + +-+ +-+-+ +-+-+ +-+-+ + + +-+ + + +-+ + + + +-+ +-+-+ +
| | | | |       |   | | | | | | | | | | | | | |       |   |     |   | |   | | |   | | | | |       | |
+-+-+ + +-+ + + + + +-+-+ + +-+ + + +-+ +-+ + + + +-+ +-+-+ + + +-+ + + + + + + + + + + + + + +-+-+ +
|     |   | | | | |     | | |   | | |   |   | | | |       | | | |   | | | | | | | | | | | | | |     |
+ + +-+-+ +-+ + + + +-+-+ + +-+-+ + +-+ + +-+ +-+ + + + + + + + + + +-+ + + + +-+ + + + + + + + + + +
| |   |   |   | | |     | |   |   |   | |   |   | | | | | | | | | | |   | | | |   | | | | | | | | | |
+ +-+ +-+-+ +-+ +-+ + + +-+ +-+ + +-+ + +-+ +-+ +-+ +-+-+ + +-+ +-+-+ + + +-+ + +-+-+-+-+ + +-+ +-+-+
| |       | |     | | | |     | | |   | |     | |       | |   | |     | |   | | |         |   |     |
+ + + + + + + + + +-+ + + + +-+ + + + + + +-+ +-+ + + + + + + + + + +-+ + + +-+-+ +-+ +-+-+ + + + + +
| | | | | | | | |   | | | |   | | | | | | |   |   | | | | | | | | | |   | | |       |   |   | | | | |
+-+ + + +-+ + + + + +-+ + + + + + + + + + + + +-+ + + +-+ +-+ + + +-+ + +-+ +-+-+ + +-+ + +-+ +-+-+ +
|   | | |   | | | | |   | | | | | | | | | | |   | | | |     | | | |   |   |     | |   | |   |     | |
+ + + + +-+ + +-+ + + + + + + +-+-+ + + + +-+ + + + + + + + + +-+ + + + + +-+ + +-+ + + + + + + + +-+
| | | | |   | |   | | | | | |     | | | | |   | | | | | | | | |   | | | |   | | |   | | | | | | |   |
+ +-+-+ + + + + +-+ + + + + + + + + + +-+-+ + + + + + + +-+-+-+ + +-+ + + + +-+ +-+-+-+-+-+-+ +-+ + +
| |     | | | |   | | | | | | | | | |   |   | | | | | |       | |   | | | | |     |             | | |
+ + + + +-+ + + + + + +-+-+ + + + + + + + + + + + + +-+-+ + +-+-+ +-+ +-+-+ + +-+ + +-+ + +-+-+ + + +
| | | | |   | | | | |     | | | | | | | | | | | | | |     | |     |   |     |   | |   | |     | | | |
+ +-+ + + +-+ + +-+ + + + +-+-+ +-+ +-+ +-+ + + + + + + + + +-+-+ + +-+ + + + +-+ + +-+ +-+ +-+ +-+ +
| |   | |   | |   | | | | |       | |     | | | | | | | | |     | |   | | | |   | |   |   |   | |   |
+ + + +-+ +-+ + + + +-+ + + + + +-+ + + + + +-+ + +-+ + + + +-+-+ +-+ + + +-+ +-+ + + +-+-+ + +-+ + +
| | |   | |   | | |   | | | | | |   | | | | |   | |   | | |   |     | | |   |   | | | |     | |   | |
+-+-+ + + + +-+-+ + + +-+-+ + + + +-+ + +-+ + + + +-+ + + + + + +-+-+ +-+ +-+ +-+ + + + + +-+ + +-+ +
|     | | | |     | | |     | | |   | |   | | | |   | | | | | |     | |   |     | | | | |   | | |   |
+ +-+ + +-+ + + + + + +-+ + + + + + +-+ +-+-+-+-+-+ + +-+-+ +-+ + + +-+-+ + + + + + + + + + + + + + +
|   | | |   | | | | | |   | | | | |   |     |       |   |     | | |     | | | | | | | | | | | | | | |
+ + +-+ + +-+ +-+-+ + +-+-+-+ + + + + + + + + + +-+-+ + + +-+ +-+-+ + +-+-+ + + + + + + + + +-+ + +-+
| |   | | |     |   |       | | | | | | | | | |     | | | |   |     | |     | | | | | | | |   | |   |
+ + + + + + + + +-+ + +-+ + + +-+ + + +-+ +-+ + + + +-+ + +-+ + + + + + +-+ +-+ + + + +-+-+ + +-+-+-+
| | | | | | | | |   | |   | |   | | |   | |   | | | |   | |   | | | | |   | |   | | |     | |       |
+ + + + + + + + + +-+ + +-+ +-+ +-+ +-+ + + + +-+ + + +-+ + + + + +-+-+ + + +-+ + + + + + + + +-+ +-+
| | | | | | | | |   | | |   |   |     | | | |   | | | |   | | | | |     | |   | | | | | | | | |     |
+ + +-+-+-+-+-+ +-+ + +-+-+-+ +-+-+ + + +-+ +-+ + + + + + +-+ +-+ + + + +-+ + + +-+ + +-+-+ + + + +-+
| |         |   |   | |           | | | |     | | | | | | |   |   | | |   | | |   | |   |   | | |   |
+-+-+-+-+-+-+-+-+-+-+-+-+-+-+-+-+-+-+-+-+-+-+-+-+-+-+-+-+-+-+-+-+-+-+-+-+-+-+-+-+-+-+-+-+-+-+-+-+-+-+