+-+-+-+-+-+-+-+-+-+-+-+-+-+-+-+-+-+-+-+-+-+-+-+-+-+-+-+-+-+-+-+-+-+-+-+-+-+-+-+-+-+-+-+-+
| |     | |   |     | | |     |   |   | | |   |   | |     |   | | |   |   |   |         |
+ + +-+ + +-+ + +-+ + + + + +-+ + + +-+ + + +-+ + + +-+ +-+-+ + + +-+ + +-+-+ + + +-+-+-+
| |   |       | |   |     |   | | |   |       | | |   |   |   |         |     | | | |   |
+ +-+ + +-+-+ +-+-+ + +-+ +-+ + +-+-+ +-+ +-+-+-+ + +-+-+ + +-+ +-+-+-+-+ + + +-+ + +-+ +
|     | |       | |     | | |         |     | | | |   | | |   | |   |     | |     |   | |
+-+-+-+-+-+ +-+-+ + + + +-+ +-+-+-+-+ + +-+ + + + + +-+ + + + + +-+ + +-+-+ + + + +-+ + +
|       | |         | |   | |             | |     |         | |       |   | | | | |     |
+-+ +-+-+ + +-+-+-+ + + +-+ + +-+ +-+ +-+-+-+-+ +-+ +-+ +-+-+-+ +-+ + +-+ +-+-+ +-+-+ +-+
| |     |     | |   | | | |   | | | |   |   |     | |   |   |     | |     | |       |   |
+ + +-+ + +-+ + +-+ +-+ + + + + +-+ +-+-+ + + +-+-+ +-+-+ +-+-+-+-+-+ +-+ + + + +-+ +-+ +
|   |   |   | | | | |     | |         |   |       |     |               |   | | | |     |
+ +-+-+ +-+-+ + + +-+-+-+-+-+ +-+-+-+ + +-+ +-+-+-+-+ +-+-+-+-+ +-+ +-+-+ +-+-+ + +-+ +-+
| |   |     |   |   |       |       |     |   | |   | | |       |       | |   |   |   | |
+-+ +-+-+ +-+-+-+-+ + + + +-+ +-+-+-+-+ + +-+-+ + +-+ + +-+-+ + +-+-+ + +-+-+ +-+ +-+-+ +
|       | |         | | |   |     |     | |       | | |       | |     | | |     | | |   |
+-+ +-+ + + + +-+-+ +-+ +-+-+ + + + +-+ +-+-+ +-+ + + + + +-+-+ +-+-+-+-+ + + +-+ + + +-+
|   |     | | | |   |         | | |   |   |   |       | | |   |           | | | | | |   |
+ +-+ +-+-+-+-+ + + + + + +-+ +-+-+-+ +-+-+-+-+-+ +-+ +-+-+-+ + +-+ +-+-+ +-+ + +-+ +-+ +
| | |       | |   |   | |   | | |     | |         | |       | | |       | |       | |   |
+-+ +-+-+-+ + +-+ +-+ +-+-+-+-+ + +-+ + + +-+-+-+ + +-+ +-+-+ + +-+-+-+-+ +-+ +-+ + + +-+
|   | | |       |   | |           |         |   | |   |   |       | |   | |     |       |
+ +-+ + +-+-+ +-+ +-+ +-+-+-+-+ + +-+ +-+-+-+ +-+ +-+ +-+-+ +-+ +-+ + +-+-+-+ +-+-+ +-+-+
| |                 | |   | | | | |     | | |   | |         |   |     |         |   |   |
+ +-+ +-+ + +-+ + +-+-+-+ + + + +-+ +-+ + + +-+ + + +-+-+-+-+ + +-+ + +-+-+-+-+-+-+ +-+ +
|     |   | |   |   | | |   |   |     |   | | |     | |   |   |   | | |   |     |   |   |
+-+-+-+-+ +-+-+ +-+-+ + + +-+ +-+ +-+-+-+ + + + +-+ + +-+ +-+-+ + + +-+-+ + +-+-+ +-+ + +
|       |     | |   |         | | | | |     | | |           |   |           | |     | | |
+ + +-+ + +-+-+-+ +-+ +-+-+ + + + + + +-+ +-+ +-+ +-+ +-+-+-+-+ +-+-+-+ +-+-+ + +-+-+-+ +
| | |   | | | |     |   |   |   |     |         | |           |   |   | |   | | | |   | |
+-+ +-+ + + + +-+ +-+-+-+-+-+ +-+ +-+-+ +-+ +-+-+-+-+-+ +-+ +-+-+ + + +-+-+ + + + + + + +
|     | |         |   |         |   | | |     |   |   |   |   |     | | |       | | |   |
+ +-+ + +-+ +-+-+-+ +-+-+ +-+-+-+-+-+ +-+-+-+ +-+ +-+ + +-+-+-+-+ +-+ + + + +-+-+ +-+ +-+
| |   |     |     | |   |             |   |   |         |           | |   |         |   |
+-+ +-+ + +-+ +-+-+ + +-+ +-+-+ + + + + +-+ + +-+ +-+-+-+ +-+ +-+-+-+ +-+ +-+-+-+ +-+ + +
|   |   |   |   |   |     |   | | | |     | |   | | | | | |   |       |   |   | | |   | |
+-+ +-+ +-+-+-+ + +-+ +-+ +-+ +-+-+-+ +-+-+ +-+-+-+ + + +-+ +-+ +-+ + + +-+-+ + + +-+ + +
|   |   |   |   |   | | |           |   | |     | | |       |     | | |         |     | |
+ +-+-+ +-+ +-+ +-+ + + +-+-+ +-+-+-+ + + +-+-+-+ + +-+-+-+-+ +-+-+-+-+-+-+-+-+-+ +-+-+ +
| |           |   | | |   | |       | | | |     |   | |     | |             |   | |   | |
+ +-+ +-+ +-+-+ +-+ +-+-+ + +-+-+ + + +-+ +-+ +-+ +-+ +-+-+ + + +-+ + + +-+ + +-+-+-+ + +
|   | | |   |   | |         |     | | | |   |   |               | | | |   | |           |
+-+-+-+ + +-+ +-+ +-+ +-+ + +-+ +-+ +-+ + +-+ +-+-+-+-+-+ + +-+ + +-+ +-+-+ +-+ + +-+ + +
|     |       |         | | |     |     |   | |       | | |   |   |       |     | |   | |
+ +-+ + +-+-+-+-+ +-+-+ +-+ + + + + +-+-+ + + + + + +-+ +-+ + +-+-+-+-+-+-+-+ +-+-+-+ +-+
|   |     |     |     | | | | | | |     | | |   | |   |   | |   |   | |   | | |   |     |
+-+-+-+-+-+-+ +-+ +-+ +-+ + +-+ +-+-+ + + + + + +-+ + + + +-+ +-+-+ + + +-+ + +-+ + + +-+
|   | |       | |   |   | | | |   | | |   | | |   | |   |   | | |     |   |     | | |   |
+-+ + + + +-+-+ + +-+-+ + + + +-+ + +-+-+ +-+ +-+-+ +-+-+ + +-+ + +-+ +-+ +-+ +-+ +-+-+-+
| |   | |           | | |     |     |       |   |   | |   | | |   | | |     | | | |     |
+ + +-+-+ + + +-+-+-+ +-+-+-+ +-+ +-+ + + +-+-+-+-+ + +-+ + + +-+-+ + +-+ +-+ + + + +-+ +
| |   |   | |   |       |     |     | | |   |   |       | |   | |   | |     |         | |
+ +-+ +-+ +-+ + +-+ + + +-+ + + +-+ +-+-+-+ +-+ + + +-+-+ +-+-+ + +-+ + +-+ + +-+-+ +-+-+
|     |   |   | |   | | | | |   |   |   |         |     |     |     |     |   | |   | | |
+-+-+ +-+ +-+-+-+-+ +-+ + +-+-+-+-+ + +-+ + + + +-+-+-+-+-+ +-+-+ + + +-+ +-+ + + +-+ + +
|     | |   |   |   | |   |   | | |     | | | | |   |   | |   |   |     |   | |       | |
+-+ + + +-+-+-+ +-+-+ + +-+ +-+ + +-+ + + +-+-+-+-+ + +-+ +-+-+-+ + +-+-+ +-+-+-+ +-+ + +
|   | |   |     | | | |       |     | | | | | |       |       |   | |       |   |   | | |
+ + + + + +-+ +-+ + + +-+-+ +-+ + + +-+-+-+ + +-+-+ +-+ +-+-+-+-+ +-+-+-+-+ + +-+-+-+ + +
| | | | |     |     | |   | |   | |   |     |   | | |     |     | |     |   |     |   | |
+ + +-+ + +-+-+-+ + + +-+ + + +-+-+-+ + +-+ + + + + + + + + + +-+-+ + +-+-+-+ +-+-+-+ + +
| |     |       | |       |     |   |   |     |   | | | |   | |   | | |     |   |   | | |
+-+ +-+ + +-+-+ +-+ + + +-+ + +-+-+ + + +-+ +-+ +-+ +-+-+ +-+ + +-+-+ + +-+ + +-+ +-+ + +
|   | | | |   |     | |   | |   | | | | |   |       | |     |   | |       |     | |   | |
+ + + + +-+ + + +-+-+-+-+-+ +-+ + + + +-+-+ +-+ +-+ + +-+ +-+ +-+ + +-+-+-+ + + + + +-+ +
| |   |   | | |           | |   |     | |     |   |       | |       |     | | |         |
+-+-+-+-+ + +-+-+-+ + +-+ + +-+ +-+-+-+ + +-+-+ + + +-+-+-+ +-+ +-+-+-+-+ + +-+ +-+-+-+ +
| |   |   |     |   | | |     |         | |     | |     |     |   | |     |   |     |   |
+ +-+ +-+ + +-+ +-+ + + + +-+-+-+ +-+-+-+-+-+-+ + +-+ +-+-+ + +-+ + +-+-+ +-+ +-+-+ + +-+
|   |     | |     | |   |   | |   |         | | | |         | |   |         | |   | |   |
+-+ +-+-+ + +-+-+-+ + + +-+-+ +-+ +-+-+-+ +-+ +-+ +-+ +-+-+ +-+-+ +-+ +-+ +-+ +-+ + + +-+
| |     |   | |     | |   | |   | |   |   |   |   |     | |   |   |   |   |   |   | |   |
+ +-+-+ +-+ + +-+-+-+-+ +-+ + +-+ + + + +-+ +-+ +-+-+-+ + + + +-+-+-+ +-+ + +-+-+ + + +-+
|   | |   | |       | | |   |   | | |     |         | |   | | |     | |           | | | |
+ + + +-+ + + +-+-+-+ + + +-+-+ +-+-+ +-+-+ + +-+ +-+ +-+-+-+-+-+-+ +-+ + + + +-+-+-+ + +
| |             |   |         | | | | | |   | |   | |   | |       |   | | | |   | | |   |
+ + +-+-+-+-+-+-+ + + +-+ +-+ + + + + + +-+ +-+ +-+ + +-+ + +-+ +-+ + +-+-+-+-+ + + + +-+
| |     |   | | | |     | | | | |         |   |               |     |   |         |     |
+ +-+ +-+ +-+ + + +-+-+ +-+ + + +-+ +-+ +-+-+-+ +-+ + +-+-+ +-+ + + + +-+ + +-+-+ +-+-+-+
| |     |       | |   |   |   | |     | | |       | |     |   | | | | | | | |         | |
+-+ + +-+-+ +-+ + +-+ + + + + + +-+-+ +-+ +-+-+-+ +-+-+ +-+-+-+ + + +-+ +-+ +-+ + +-+ + +
| | |   |     |       | | | | | |     |               |   |     | | |     |   | |   |   |
+ +-+ +-+-+-+-+-+ +-+-+ +-+ +-+ +-+ +-+ + +-+-+-+-+-+-+ +-+-+-+ +-+-+ + +-+-+-+ + +-+ +-+
|         | | | |     |   | | |         | |   | |     |   |           | |     | | |   | |
+-+ + +-+-+ + + + + +-+ +-+ + + + +-+ + + +-+ + + + +-+ +-+-+ +-+-+ +-+ + +-+-+-+-+-+ + +
|   |           | |   |   | |   |   | | |       | |     | |   | |     | |         | |   |
+ + +-+-+-+ + + + + +-+-+ +-+ +-+-+-+-+ +-+ +-+-+-+-+ + + +-+-+ + + + +-+ +-+-+-+ + +-+ +
| |   |     | | | |     |   |     |       |         | |       |   | |     |           | |
+-+-+-+-+-+-+-+-+-+-+-+-+-+-+-+-+-+-+-+-+-+-+-+-+-+-+-+-+-+-+-+-+-+-+-+-+-+-+-+-+-+-+-+-+