+-+-+-+-+-+-+-+
|             |
+ +-+ + +-+ +-+
|   | |   |   |
+ + +-+-+ + + +
| |     | | | |
+ +-+ +-+ +-+-+
|   |   |     |
+ + +-+ + + + +
| |   | | | | |
+ +-+ +-+ + +-+
|   |   | |   |
+ +-+ + +-+-+-+
|   | |       |
+-+-+-+-+-+-+-+