+-+-+-+-+-+-+-+-+-+-+-+-+-+-+-+-+-+-+-+-+
|         |       |         |           |
+-+-+-+-+ +-+-+ + +-+ +-+-+ +-+-+-+ +-+ +
|       | |     |   |   | |   |     |   |
+ + +-+ + + +-+-+-+ +-+ + +-+ + +-+-+ +-+
| |   | | |       |     | |   |   |   | |
+ +-+ +-+ + +-+-+ +-+-+-+ + +-+ + + +-+ +
|   |     |   |   |     |   |   | | |   |
+-+ +-+-+-+-+-+ +-+ +-+-+ +-+-+-+ + +-+ +
| | |         |   |     |   |     |   | |
+ + + +-+ +-+ +-+ +-+-+ +-+ + +-+-+-+ + +
|   | | |   |     |   |     | |     | | |
+ +-+ + +-+ +-+-+-+ + + +-+-+ + +-+ + + +
| |       |   |     | |       | |   |   |
+ +-+-+-+ +-+ + +-+-+ +-+-+-+-+ + +-+-+ +
|       |   |   |     |     |   |     | |
+-+-+-+ +-+ +-+-+ +-+-+ +-+ +-+ +-+ + + +
|   |   | | |   |         |   | |   | | |
+-+ + +-+ + +-+ +-+-+-+-+ +-+ + + +-+-+ +
|   |   | |     |   |   |   | | |   |   |
+ + +-+ + +-+-+ +-+ + + + +-+ + +-+ + +-+
| | |   |     |   | | | | |   | | |   | |
+ + + +-+ + + +-+ + + + +-+ +-+ + +-+-+ +
| | | | | | | | | | | |     | |       | |
+ +-+ + + + + + + + + +-+-+-+ +-+-+-+ + +
|     |   | |   |   |   |       |   | | |
+ +-+-+-+-+ +-+ +-+ +-+ + +-+ +-+ + + + +
| |       | | | |   | | |   |     | | | |
+ +-+ +-+ + + + + +-+ + + +-+-+-+-+ + + +
|   | |     |   |     | | |         | | |
+-+ + +-+-+-+ +-+ +-+-+ + + +-+-+-+ + + +
|   |       | | | |     | | |     | | | |
+ +-+-+-+-+ + + + + +-+-+-+ + + + + + + +
| |         |   | | |       | | | | |   |
+ + +-+-+ +-+-+-+ + + +-+-+-+ + +-+ +-+ +
| |     | |       | |   |     |       | |
+ + +-+ +-+ +-+-+-+ + + +-+-+ +-+-+-+-+ +
| |   |     |   |   | |     | |   |     |
+ +-+-+-+-+-+ + + +-+ +-+-+ +-+ + + +-+-+
|             |   |       |     |       |
+-+-+-+-+-+-+-+-+-+-+-+-+-+-+-+-+-+-+-+-+