+-+-+-+-+-+-+-+-+-+-+-+
|                     |
+-+-+-+-+ +-+-+ + +-+-+
|         |     |     |
+ +-+-+ + + + + + +-+ +
|   |   | | | | |   | |
+ +-+-+ + +-+-+-+ + + +
|     | | |       | | |
+ +-+ +-+-+-+-+ + + +-+
|   |     |     | |   |
+ + + +-+ + +-+ +-+ +-+
| | |   | |   |   |   |
+ +-+ + + +-+-+ + +-+ +
|   | | |     | | |   |
+ + + + +-+ + + + + + +
| | | | |   | | | | | |
+ + + +-+-+ +-+ + + + +
| | |   |     | | | | |
+ +-+ + +-+ + + + + + +
| |   | |   | | | | | |
+ + +-+ + + +-+ + +-+ +
| | |   | |   | |   | |
+-+-+-+-+-+-+-+-+-+-+-+