+-+-+-+-+-+-+-+-+-+-+-+-+-+-+-+-+-+-+-+-+
|                                       |
+ +-+-+ + +-+ +-+-+-+-+-+-+-+-+-+ + + +-+
|     | |   |                   | | |   |
+ + +-+ +-+-+ + + +-+ + +-+ + +-+ +-+ +-+
| |   |     | | |   | |   | |   |   |   |
+ +-+ +-+-+ +-+-+ + + + +-+ + + + +-+-+-+
|   |     |     | | | |   | | | |       |
+ +-+-+ + +-+-+ + + +-+ +-+ + +-+ +-+ + +
|     | |     | | |   |   | |   |   | | |
+ +-+-+-+ + + + +-+ +-+ + +-+-+ +-+-+ + +
|       | | | |   |   | |     |     | | |
+ + +-+ + + +-+ +-+ + + +-+-+-+ + +-+-+-+
| |   | | |   |   | | |       | |       |
+ +-+-+ +-+ + +-+-+ +-+-+ +-+ +-+ + +-+ +
|     |   | |     |     |   |   | |   | |
+ + +-+-+ + + + +-+-+ +-+ +-+ +-+ +-+-+-+
| |     | | | |     |   |   |   |       |
+ +-+ + + + + + + +-+ +-+ + + + +-+-+-+ +
|   | | | | | | |   |   | | | |       | |
+ +-+ + + +-+-+ +-+ +-+-+ +-+ +-+-+-+ + +
|   | | |     |   |     |   |       | | |
+ +-+-+ +-+ + + +-+ + + +-+ + +-+ +-+-+ +
|     |   | | |   | | |   | |   |     | |
+ +-+-+ +-+ +-+ + +-+ +-+-+-+ + + +-+-+-+
|     |   |   | |   |       | | |       |
+ + +-+ +-+ + + + + +-+-+-+ + + +-+ + +-+
| |   |   | | | | |       | | |   | |   |
+ + + + +-+ +-+-+-+ +-+ +-+ +-+-+-+-+ + +
| | | |   |       |   |   |         | | |
+ +-+-+ + + + +-+ + + + + + +-+-+-+-+-+-+
|     | | | |   | | | | | |             |
+ +-+-+ + + + + +-+-+-+-+ + +-+-+-+ +-+-+
|     | | | | |         | |       |     |
+ +-+-+-+-+ + + + + +-+-+ + + +-+ +-+-+ +
|         | | | | |     | | |   |     | |
+ +-+ +-+-+ +-+ +-+ + +-+ + +-+-+ +-+-+-+
|   |     |   |   | |   | |     |       |
+ +-+-+-+ +-+ +-+ +-+ + +-+ +-+ + +-+ + +
|       |   |   |   | |   |   | |   | | |
+-+-+-+-+-+-+-+-+-+-+-+-+-+-+-+-+-+-+-+-+