+-+-+-+-+-+
|         |
+-+-+-+-+ +
|.|     | |
+-+-+-+ + +
|.|.|.|   |
+-+-+-+-+-+
|.|.|.|.|.|
+-+-+-+-+-+
|.|.|.|.|.|
+-+-+-+-+-+
|.|.|.|.|.|
+-+-+-+-+-+
|.|.|.|.|.|
+-+-+-+-+-+
|.|.|.|.|.|
+-+-+-+-+-+
|.|.|.|.|.|
+-+-+-+-+-+
|.|.|.|.|.|
+-+-+-+-+-+
|.|.|.|.|.|
+-+-+-+-+-+
|.|.|.|.|.|
+-+-+-+-+-+
|.|.|.|.|.|
+-+-+-+-+-+
|.|.|.|.|.|
+-+-+-+-+-+
|.|.|.|.|.|
+-+-+-+-+-+
|.|.|.|.|.|
+-+-+-+-+-+
|.|.|.|.|.|
+-+-+-+-+-+
|.|.|.|.|.|
+-+-+-+-+-+
|.|.|.|.|.|
+-+-+-+-+-+
|.|.|.|.|.|
+-+-+-+-+-+
|.|.|.|.|.|
+-+-+-+-+-+
|.|.|.|.|.|
+-+-+-+-+-+
|.|.|.|.|.|
+-+-+-+-+-+
|.|.|.|.|.|
+-+-+-+-+-+
|.|.|.|.|.|
+-+-+-+-+-+
|.|.|.|.|.|
+-+-+-+-+-+
|.|.|.|.|.|
+-+-+-+-+-+
|.|.|.|.|.|
+-+-+-+-+-+
|.|.|.|.|.|
+-+-+-+-+-+
|.|.|.|.|.|
+-+-+-+-+-+