+-+-+-+-+-+-+-+-+-+-+-+-+-+-+-+-+-+-+-+-+-+-+-+-+-+-+-+-+-+-+-+
|                                                             |
+ + + +-+ +-+ + + + +-+ + +-+ + + + + + +-+ +-+ +-+-+ + +-+ + +
| | | |     | | | |   | |   | | | | | | |     |   |   |   | | |
+ +-+ + + + + + + + +-+ + + + + +-+-+ + +-+ + + +-+ + + + + + +
| |   | | | | | | | |   | | | | |     | |   | |   | | | | | | |
+ + + + +-+ + + +-+-+ + +-+ +-+ + +-+-+ + + +-+ +-+ +-+ + + + +
| | | |   | | |     | |   |   | |   |   | | |     | |   | | | |
+ +-+ + +-+ + +-+ +-+-+ + + +-+ +-+ + + + + +-+ +-+ + + + +-+ +
|   | | |   | |   |     | | |     | | | | | |     | | | | |   |
+ + +-+-+ + +-+ +-+-+ +-+ + + + + +-+-+ + +-+ +-+-+ +-+-+-+-+-+
| | |     | |       |   | | | | | |     |   | |               |
+ + + + +-+-+-+ + + + + +-+ + + +-+-+ + + +-+-+ + + +-+ +-+ + +
| | | |     |   | | | | |   | |   |   | | |     | |   |   | | |
+ + + + + +-+ + + + + + +-+-+ + + + +-+ + + + + + + + + + + + +
| | | | |   | | | | | |   |   | | |   | | | | | | | | | | | | |
+ + + +-+ + + + + + +-+-+ +-+-+ +-+ + + + +-+ + + + + + + +-+ +
| | | |   | | | | |   |     |   |   | | |   | | | | | | |   | |
+ + +-+ + + +-+ + + +-+ +-+ +-+-+ +-+ +-+-+-+-+ +-+-+-+ + +-+-+
| | |   | | |   | |   | |       |   |     |         |   |     |
+-+ +-+ + + + + +-+-+ + + + + +-+ +-+ + + + + + + + +-+ + + + +
|   |   | | | |     | | | | |   | |   | | | | | | |   | | | | |
+ + +-+-+ +-+-+ + +-+-+ +-+ + +-+ + +-+-+ +-+-+ +-+ +-+ +-+-+-+
| |   |   |     | |     |   |   | | |         | |   |         |
+ + +-+-+ + + + + +-+ + + + +-+ +-+-+-+ + + +-+ + + + +-+-+-+ +
| |     | | | | |   | | | | |       |   | |   | | | |   |     |
+ + + + + + + + + +-+ + +-+ + + + + + + + + + + + +-+ + +-+-+ +
| | | | | | | | | |   |   | | | | | | | | | | | |   | | |     |
+ + + +-+ + + + + +-+ + +-+-+-+-+-+ + + +-+ + + +-+-+ +-+-+-+ +
| | | |   | | | | |   |           | | | |   | | |           | |
+ + +-+ + + + + + + + +-+-+ + +-+ + + +-+ + + + + + + +-+-+ + +
| |   | | | | | | | | |     | |   | | |   | | | | | |     | | |
+-+ + +-+-+ +-+ + +-+ +-+ +-+ + + + + + + +-+-+ + +-+ +-+ +-+-+
|   |   |     | |   | |     | | | | | | | |     | |   |       |
+ +-+ + + + +-+ + + +-+ + +-+ + + +-+-+ + +-+ +-+ + + + +-+-+ +
| |   | | | |   | |   | |   | | | |     |   |   | | | |     | |
+ + + + +-+ +-+ + + +-+ + +-+ + + +-+ + +-+ + + + + + + +-+-+-+
| | | |   |   | | | |   |   | | |   | |   | | | | | | |       |
+-+ +-+ + + + + + + +-+ +-+ + + + +-+ + +-+ + + + + + + + + +-+
|     | | | | | | |   |   | | | |   | | |   | | | | | | | |   |
+ + + +-+-+-+ + + + + + + + + + + + + + + + + + +-+-+-+ + + +-+
| | |       | | | | | | | | | | | | | | | | | |       | | |   |
+ + + + +-+-+-+-+-+ +-+ + + +-+ +-+-+-+ + + +-+ +-+-+ + +-+ +-+
| | | |   |           | | | |   |       | | |     |   |   |   |
+ + + + + +-+ + + + +-+ + + + + +-+ +-+ +-+ + + + + +-+ + + + +
| | | | |   | | | |   | | | | |   | |     | | | | | |   | | | |
+ +-+ +-+ + + + +-+ + +-+ + + + + + + + + + + + + + + + +-+ + +
|   | |   | | |   | |   | | | | | | | | | | | | | | | |   | | |
+ +-+-+ + + +-+ + + +-+ + +-+ +-+ +-+-+-+ + + + + + + + + +-+-+
|   |   | |   | | |   | | |   |         | | | | | | | | |     |
+ + + +-+ +-+ + + +-+ +-+ +-+-+ +-+ + + + + + + +-+ + +-+ + + +
| | |   |   | | | |   |       | |   | | | | | |   | | |   | | |
+ +-+ +-+ + +-+ + +-+ + + + + + + +-+ +-+ +-+ +-+ +-+ + + +-+ +
|   | |   | |   |   | | | | | | | |     |   |   | |   | |   | |
+ +-+-+ + + + + + +-+ +-+ + + +-+ + + +-+ +-+ + + + + + + + + +
| |     | | | | |   |   | | | |   | |   |   | | | | | | | | | |
+ +-+-+-+ + + +-+-+ +-+ + +-+-+ + + + +-+ + +-+-+ +-+ + + + + +
| |       | |     |   | | |     | | |   | |   |     | | | | | |
+ +-+ + + + +-+-+ + + + + + +-+ +-+ + + + +-+-+-+-+ + + + +-+ +
| |   | | |     | | | | | | |     | | | |         | | | |   | |
+ +-+ +-+-+ + +-+ + +-+-+ + +-+ + +-+ + + + + +-+ + + +-+ +-+ +
|   |   |   | |   |     | | |   |   | | | | | |   | | |     | |
+-+-+-+-+-+-+-+-+-+-+-+-+-+-+-+-+-+-+-+-+-+-+-+-+-+-+-+-+-+-+-+