+-+-+-+-+-+-+-+-+-+-+-+-+-+-+-+-+-+-+-+-+-+-+-+-+-+-+
|         | |       |       |         |     | |     |
+-+-+ + +-+ +-+-+-+ + +-+ + + +-+ +-+-+-+ +-+ + +-+-+
| |   |       | |       | | | |   |     |       |   |
+ +-+ + + +-+-+ + + + + +-+-+-+ + + + +-+ +-+-+ +-+ +
|     | | | |     | | | |       |   |       |       |
+ +-+ +-+-+ + + + +-+ + +-+-+ +-+ + + + +-+ +-+-+ + +
| | | | |     | | |   |   |     | | | |   |     | | |
+ + +-+ + + + +-+-+-+-+-+ + +-+-+ +-+-+-+-+ +-+-+-+ +
|         | |     |     |     |         |     | | | |
+-+-+-+ +-+-+ +-+ +-+ +-+ +-+-+ +-+ + + + + + + + +-+
| |     | |   |     |         |   | | | | | |       |
+ + +-+ + + + +-+-+-+-+ + +-+-+ +-+-+-+-+-+-+-+ + +-+
|   |   | | |   |       |     |     |           |   |
+-+-+ + + +-+-+ + + +-+-+-+ + + +-+ + +-+-+ +-+ +-+ +
| | | | |       | | | |   | | | | | |   |     | |   |
+ + +-+-+ +-+-+-+-+-+ + +-+-+-+ + +-+-+-+-+-+ + +-+ +
| |   | | | | |     | |     |   | |   | |     | |   |
+ +-+ + + + + +-+ +-+ + + +-+ + + + +-+ + + + +-+-+-+
|   |   |       | | | | |   | |   |   | | | |   |   |
+-+ +-+ +-+-+-+-+ + + + +-+-+ + +-+ + + + + +-+-+ +-+
| | | | |         |   |     | |     | |   | | | |   |
+ + + + + + +-+-+-+ + +-+-+ + + +-+-+-+-+-+-+ + + + +
|       | |     |   |         |     |             | |
+-+ +-+-+ +-+ +-+-+ +-+ +-+-+ +-+ +-+ + + +-+ +-+-+-+
|       |   |     |   | | | | |       | |   | |     |
+-+-+-+ +-+ +-+-+ +-+-+-+ + + +-+ +-+-+-+ +-+-+-+-+ +
|       |       | |     | |     |   |   |           |
+ +-+-+ +-+ +-+-+ +-+ +-+ +-+-+-+-+-+ + +-+ +-+ +-+ +
| |   | |   |   |   | | |     |   |   |       | |   |
+ + +-+ + +-+ +-+-+-+ + +-+ +-+-+ +-+ +-+ +-+-+-+-+ +
|   |       |       |         |   |   | | | |   |   |
+ +-+-+ + +-+ +-+ +-+-+ +-+ +-+ + +-+ + + + + +-+-+-+
|     | |   | |     |     | |   | | | |     |   | | |
+-+-+-+-+-+ +-+ +-+-+ +-+-+-+ + +-+ + + +-+ + + + + +
| |     | | |   | | |     | | | | | | | |     | | | |
+ + +-+ + + +-+ + + +-+-+ + + +-+ + +-+-+-+ + +-+ + +
| |   | |       |   |     |     | |   |     | |     |
+ +-+ +-+ +-+-+ +-+ + +-+ +-+ +-+ +-+ +-+ +-+-+ +-+ +
|   | |     |   | | | | |         | |         | |   |
+ +-+ +-+ +-+ +-+ + + + +-+-+ +-+ + + +-+-+-+ +-+-+ +
|     | |   |     |   |   |     |           |     | |
+ + + + +-+-+ + + +-+ + +-+ + + +-+-+-+-+-+ +-+-+-+ +
| | |     |   | | |     | | | |   | |     |   |     |
+-+ +-+-+ +-+-+ + +-+ +-+ +-+-+-+ + + + +-+ +-+-+ + +
| |     |   |   |           |   |     |   |       | |
+ + + +-+-+ +-+-+ + +-+ +-+ + + + +-+-+ +-+ +-+-+ + +
|   | |     |     |   |   |   | |     |   | |     | |
+ +-+-+ +-+-+-+-+-+ +-+ +-+ + +-+-+ +-+-+ + + +-+-+ +
|   |               | | |   | |       |   | | | |   |
+ +-+-+-+-+ + +-+ +-+ +-+-+ + +-+-+ +-+-+ + +-+ + +-+
|     |     | |       |     |     |   |   | |       |
+-+-+-+-+-+-+-+-+-+-+-+-+-+-+-+-+-+-+-+-+-+-+-+-+-+-+