+-+-+-+-+-+-+-+
|             |
+ +-+ + + + + +
|   | | | | | |
+ +-+ +-+-+ + +
|   |     | | |
+ +-+ +-+ +-+ +
|   |   |   | |
+ + +-+-+-+-+-+
| |           |
+ +-+-+ + + + +
|     | | | | |
+ + + +-+ + + +
| | |   | | | |
+-+-+-+-+-+-+-+