+-+-+-+-+-+
|         |
+ + + +-+ +
| | |   | |
+ +-+-+ + +
|     | | |
+ +-+ + + +
|   | | | |
+ + + + + +
| | | | | |
+-+-+-+-+-+