+-+-+-+-+-+-+-+-+-+-+-+-+-+-+-+-+-+-+-+-+-+-+-+-+-+-+-+-+-+-+-+-+-+-+-+-+-+-+-+-+-+-+-+-+-+-+-+-+-+-+
|     |   |       |   | | |   | | | |   |       |     | |     | |       |     | |   |   |           |
+-+ + +-+ + +-+ +-+ +-+ + + +-+ + + +-+ + +-+-+-+ + +-+ +-+-+ + +-+-+-+ + +-+-+ + +-+-+ + +-+-+ +-+ +
|   | |   |   |   |       | |       |       | |   | |   | | |   | | |       |     | |         |   | |
+ + +-+ +-+ + +-+ + +-+-+-+ + +-+ +-+-+ +-+-+ +-+ +-+-+ + + +-+ + + +-+-+-+ + +-+ + +-+-+ + +-+ +-+-+
| | | | | | | | |     |   | | |     |   |     |     | |             |           |   |   | | | | | | |
+ +-+ + + +-+-+ + +-+ +-+ + +-+ +-+-+ +-+-+ +-+ + +-+ +-+-+ + +-+-+-+-+ + +-+ +-+-+-+-+ +-+ + + + + +
|       |   |     | | | |     |     | |   | |   |   |   |   |   |     | | |   | |       | | |       |
+-+-+ +-+ + +-+ +-+ +-+ +-+-+ +-+-+ + + + + + +-+ + + +-+-+ + +-+-+ + +-+-+ +-+ +-+ + + + +-+-+-+ + +
|       | |       | | |         |       |     |   |     | | |   | | |         |   | | | | |       | |
+ +-+-+-+-+-+ +-+-+ + + + +-+-+ +-+-+-+-+ + +-+-+-+-+ +-+ + + +-+ +-+-+-+-+ +-+ +-+-+ + + + +-+-+-+ +
|   | |   |           | | | |   |   |     |   | | |   |     |       |                 |   |       | |
+ + + + + +-+-+-+ + + +-+-+ + + +-+ + +-+ +-+-+ + +-+-+-+-+ +-+-+-+ + + + + + + +-+ + + + +-+ + + + +
| | |   | |   |   | |   | | | | |   | | |         |   |     | | |     | | | | |   | | | |     | | | |
+ + +-+-+ + +-+ +-+ +-+ + + +-+ +-+ + + +-+-+ +-+ + +-+-+-+ + + +-+-+ +-+ +-+-+ +-+-+ +-+-+ +-+ +-+-+
| | | |     |     |   |       |     | |     | | | |   | |   |           | | | | |   |   | |   |     |
+ + + +-+-+ +-+-+ +-+-+-+ + +-+ +-+-+ +-+ +-+ + + +-+ + + +-+-+-+-+-+ + + + + +-+ +-+ +-+ +-+ + + +-+
| | |         | | | |     |   |     |       |   | |   |   | |   | | | | | |     | |         | | |   |
+-+ +-+ +-+-+-+ +-+ + +-+-+-+ +-+ +-+ +-+ +-+ +-+ + + + +-+ +-+ + + +-+ +-+ +-+-+ + +-+ +-+-+-+ +-+-+
| |     |     | |     |       |   | |   | |   |   | |   |           | |     |   | |   |       |     |
+ +-+ + +-+ + + +-+ + + +-+-+-+ +-+ + +-+-+-+-+-+ +-+ +-+ + +-+ + + + + +-+-+ +-+ +-+-+ + + +-+-+-+ +
| | | |   | |   | | | |           | |   |   |         |   |   | | |     | | |       |   | |     | | |
+ + + +-+ +-+ +-+ +-+-+-+ + +-+ + + + + + + +-+ +-+-+-+-+-+ +-+ +-+-+ +-+ + + +-+ + +-+-+-+-+ +-+ +-+
|       | |     | |     | |   | |     |   |   |   |   |       |   |     |   | |   |     |     | | | |
+ + +-+-+-+-+-+ + + +-+ + +-+-+ +-+ +-+-+-+ + +-+ + + +-+ + + +-+ +-+ +-+ +-+ +-+-+-+-+-+ +-+ + + + +
| |     |         | |     |   |   | | | |   | |   | |   | | |   |   | |       | | | | | |   | |     |
+ +-+-+ + +-+-+-+ + +-+ +-+ + + +-+ + + + + + +-+ + +-+-+-+-+ +-+-+-+-+ +-+-+-+ + + + + +-+-+ +-+ +-+
|     |       |     |       | | |   | |   | | |         |     | | | |     |   |     |       |     | |
+-+ + +-+-+-+ +-+-+-+ +-+-+ +-+-+-+ + +-+ +-+ + +-+ +-+-+ + + + + + +-+ + +-+ + +-+-+-+ +-+ + +-+-+ +
| | |       |       |   |   |   |       | |   |   | | | | | |   |     | |     |     |     | |   |   |
+ + + + +-+-+-+-+ + +-+-+ +-+-+ + +-+ + + +-+-+-+ +-+ + +-+-+-+-+ + + + + +-+-+-+ + + +-+ + + +-+-+ +
|   | |   | |     |   | | | |   | | | | | | | |   | | |         | | |   | |   |   | | | | |   |     |
+ +-+-+-+ + +-+-+-+ +-+ + + +-+ +-+ +-+-+-+ + +-+-+ + + + + +-+ +-+-+ +-+-+-+ +-+ +-+-+ + +-+ + +-+ +
| |     |   |   |   |         |   | |   |     | |   |   | | |   |           |       | |     | | |   |
+ +-+ +-+ +-+ +-+-+-+-+ +-+-+-+-+ + + +-+ +-+ + +-+ +-+ + +-+-+ +-+-+-+ +-+-+ +-+-+ + + + + +-+ +-+ +
|       | |   | | |     |     |         |   |       | | | | | | |     |       |   |   | | | |   |   |
+ +-+-+ + + + + + + +-+ +-+-+ +-+ +-+ + + +-+-+-+ +-+ + + + + + +-+ +-+-+ + + +-+ + +-+-+-+ + + + + +
| | |   | | |   | | | |   |       |   |     |   |     | | | |   |     |   | | |               | | | |
+-+ + +-+ + +-+-+ + + +-+-+ +-+ +-+-+ +-+-+ + + + +-+ +-+-+ + +-+-+ +-+ + + +-+-+-+-+-+-+ +-+-+-+-+ +
|   |   | |   |   | |   |     |   | | |     | |     |   |         |     | |     | | |     |     | | |
+ + + +-+-+ +-+ + +-+ +-+ +-+-+ +-+ +-+ + +-+-+ +-+ + +-+ +-+ +-+-+ +-+-+-+-+-+-+ + + +-+-+ + +-+ + +
| | |   | | |   | | | | |     | |   |   |     |   | |   |   |   | |     |   |               | |   | |
+-+ +-+-+ + + +-+-+ + + + +-+-+-+ +-+ +-+-+ + +-+ +-+ +-+ +-+-+ + + +-+-+-+ +-+ + +-+ +-+-+-+-+ + +-+
|             |     |     |     | | |   |   |   |   | |   |               |   | | | |   | |     | | |
+-+ +-+ + + +-+ + + + + +-+ +-+-+ + +-+-+-+ +-+-+-+ + + + +-+-+ +-+-+-+-+ + +-+-+ + + +-+ +-+ +-+-+ +
|     | | | | | | |   | |   |   |   |       | | | | |   | |   | | | | |   | |       |   | |       | |
+-+-+-+ + +-+ +-+-+-+-+ + + + +-+ +-+-+-+-+ + + + +-+ + +-+-+ + + + + + +-+ + +-+ +-+ + + + +-+-+-+ +
|   | | |   | |         | |     |   |         | | |   | |   |       |   |     | | | | |       | | | |
+-+ + +-+-+ + +-+-+-+-+ +-+ +-+-+-+ + +-+ + + + + +-+ +-+ + + + + +-+ + +-+ +-+ +-+ + + + +-+ + + + +
|       |   |                 | | |   |   | | | | |     | | | | |   | | | | |       | | | | | | |   |
+ +-+-+ +-+ +-+-+ +-+ + +-+-+-+ + +-+ + +-+-+-+ + + + +-+-+ +-+-+ + + + + + +-+-+ + + +-+-+ + + +-+ +
|   |   | |         | |     | | |     | |           |         | | | | | | |   |   |         | |     |
+ + + + + + +-+ +-+-+ +-+ +-+ + + +-+ +-+-+-+-+ +-+ +-+-+-+-+ + + + + +-+ +-+ + +-+-+ +-+-+ + +-+ + +
| | | | |     |   | | |   |         |   | | |   |   |       | |   | | |   | | | |       |   | |   | |
+-+ + + + +-+ +-+ + + +-+-+-+-+-+-+-+-+ + + +-+ +-+-+ +-+-+ + +-+ +-+ +-+ + +-+ +-+-+ +-+-+ + + +-+-+
|   | |   |     | | | | |   |         | | |     |     |   |   |   | | | |       |   | | | | | |   | |
+ + +-+ + + +-+-+ + +-+ +-+ + + +-+ + + + +-+-+ +-+-+-+ + +-+-+ +-+ +-+ +-+-+-+-+ + + + + + + + +-+ +
| |   | | |   | |   | |   | | | |   | |     | | | | |   | |                     | |       | | |   | |
+-+-+ +-+-+-+ + +-+ + + + + +-+ +-+ +-+-+-+-+ +-+ + + + +-+-+-+ +-+ +-+ +-+-+-+-+-+-+-+ +-+ + +-+ + +
|   | | | |   |         | |   |   | | | | |     | |   | | | |   |   | |   |   |   | |   | | |     | |
+-+ +-+ + + +-+ + +-+-+-+-+ + + +-+ + + + + + +-+ + +-+ + + +-+-+-+ + +-+-+ + + +-+ +-+-+ +-+-+ +-+ +
|         | |   | |   |     | | |       |   | |   | |     |     |       | | |       |     | | |     |
+ +-+-+ +-+-+ +-+-+ +-+ +-+ + +-+ +-+ + + + + + +-+-+ + + + +-+-+ +-+ +-+ +-+-+-+-+ +-+ + + + +-+-+-+
| | | |           |     | | |       | |   | |   | | | | |   |       |   |       | | | | |   |   |   |
+-+ + + + + +-+-+ +-+-+ + + + +-+-+-+-+-+ +-+-+-+ + +-+ +-+ + +-+-+ +-+ +-+ +-+ + + + + + +-+ +-+-+ +
| |     | | | | |         | |   |   | | |       | | |     |   | | |   |   |   |         |           |
+ +-+ +-+-+-+ + + + + +-+-+-+-+ + +-+ + + +-+ +-+ + +-+ +-+ +-+ + + +-+ + + + + + +-+-+ + + +-+ + + +
|             |   | |   | |   | | |     |   |     |     |   | | |     | |   | | |   |   | | |   | | |
+ +-+ +-+ +-+-+-+-+ +-+ + +-+ + + +-+ + +-+-+-+ + +-+ +-+ +-+ + +-+ +-+ +-+ +-+-+-+-+-+ +-+ +-+-+-+ +
|   | |         |     | |   |       | | | |     |   | | |     |     |   | |   |   |     | |     | | |
+ + +-+ +-+-+ +-+ + + +-+-+ +-+-+-+ + +-+ +-+ +-+ +-+-+ + +-+-+-+ + +-+ + + + + + +-+ + + +-+-+-+ + +
| | |       | | | | | |         |     |     |   |   |       |     | |     | |   | |   | |   |     | |
+ + + + +-+ + + + + +-+-+-+-+-+ +-+-+ + +-+ +-+-+-+-+-+ + + +-+-+ +-+-+ +-+-+-+-+-+-+-+ +-+ +-+ +-+ +
| | | |   | |   | | |     |   | |   | |   |   |   | |   | | |   |     | |           |         | |   |
+ +-+ +-+ + +-+-+-+-+ +-+-+-+ + +-+ + +-+ + +-+ +-+ +-+-+-+ + +-+-+-+-+-+-+-+-+ +-+-+ +-+-+-+ + +-+-+
| | | |   |       |         | |   |       | |       |         |   |   |   |     |   |       |   |   |
+-+ +-+-+-+ +-+ + + +-+ + +-+ +-+ + +-+ + + +-+-+ +-+ +-+-+-+ + +-+-+ +-+ + +-+-+ +-+-+ +-+-+-+ +-+ +
|   | |     |   | |   | |     | | |   | | | |       | |     | | |   | |         |   | |   | | |   | |
+-+ + + + +-+-+ + + +-+-+-+-+ + + +-+-+-+ +-+ +-+-+ +-+-+ + + + +-+ + +-+-+ + +-+ +-+ +-+-+ + + + + +
|   |   | |     | |     | |         | | |   |   |   | | | | | | | |         |     | |         | | | |
+-+ + +-+-+ +-+-+ + +-+ + +-+-+ +-+ + + +-+-+-+-+ + + + + +-+ + + + +-+-+-+-+-+-+-+ + + +-+-+ +-+-+ +
|   | | |   | |     | |   | |     |         |     | |     |       | | |   |           | |         | |
+ +-+-+ +-+ + +-+ +-+ + + + +-+-+-+ +-+ +-+ +-+-+-+ + +-+-+-+-+ + + + + +-+-+ +-+ +-+-+-+-+ +-+ + + +
|               |     | |       | |   | | | |     |     |     | | |   |   | | | |   |   |   | | |   |
+ +-+ +-+-+ + +-+ + +-+ + + + +-+ +-+-+ + +-+ +-+ + +-+-+-+ +-+ +-+-+ + +-+ + + + + +-+ + + + +-+ + +
|   | |   | | |   | |   | | |       | |     | | |   |   | |     | | |       |   | |   |   | |   | | |
+ +-+ +-+ +-+ + + +-+ +-+-+-+-+-+ +-+ +-+ +-+-+ + + +-+ + + +-+ + + + +-+ +-+-+ +-+-+-+-+ +-+ + +-+-+
| | |   | |   | | |       | |   | |     | |       | |     | | | |   |   |   | |     |         |   | |
+-+ + +-+ + +-+-+ + +-+ +-+ + + + +-+ +-+-+-+-+ +-+ +-+ +-+ + + +-+ + +-+-+ + + +-+-+-+ +-+-+ +-+ + +
|     |         | |   |     | |   |       |   |   |   |   | |     |   | |   |     | |     |     | | |
+ + +-+-+ +-+ +-+-+-+ +-+ + +-+ + + +-+-+-+ + + +-+-+-+ + + + +-+-+ +-+ + +-+ + + + +-+-+-+-+ +-+ + +
| | | | | |     |   |   | | |   |   |     | |     | |   |   |   |   | |   | | | | |   |     | | |   |
+-+ + + + + + + + +-+ +-+ +-+ +-+ +-+-+ +-+-+-+-+ + +-+ + + +-+-+ +-+ + +-+ + + + +-+ + +-+-+ + + + +
|   | |   | | | |       | | | | | | |       |   |       | |       |       |   | | |   |       | | | |
+-+ + + +-+-+ +-+-+ + +-+-+ +-+ + + + +-+ +-+ +-+ + +-+ + +-+-+-+ +-+-+ + + +-+ + +-+ + +-+ +-+ + + +
|   | |     |   |   |   |       | |   |     |     | | | | |   |     | | |   | | | | | | |   |     | |
+ +-+ + +-+-+ + + +-+-+ + + +-+-+ +-+ +-+-+ + +-+ + + +-+-+-+ +-+ +-+ +-+ +-+ + +-+ + +-+ + +-+ +-+ +
|     |   | | | |   | |   | |   | | |     | | | | | |   |   |         |   |     |         | |     | |
+ +-+ + +-+ +-+ +-+ + + +-+ + +-+-+ +-+ +-+ + + + +-+-+ + +-+ +-+ +-+-+ + +-+ +-+-+ +-+-+ + +-+ + +-+
|   | |       | |     |   |             |   | |           |     |     | |   |     |     | | |   |   |
+-+-+-+-+-+-+-+-+-+-+-+-+-+-+-+-+-+-+-+-+-+-+-+-+-+-+-+-+-+-+-+-+-+-+-+-+-+-+-+-+-+-+-+-+-+-+-+-+-+-+