+-+-+-+-+-+-+-+-+-+-+-+
|   |       |     |   |
+ +-+-+ +-+ + + +-+ + +
| | | | |     |   | | |
+ + + +-+ + +-+-+ +-+ +
|   |     | | | |   | |
+-+ + + +-+-+ + +-+ + +
|   | | |   | |   |   |
+-+ + +-+ +-+ + +-+ +-+
|   |     | |   |   | |
+-+ +-+ +-+ + + + + + +
|       |   | |   | | |
+-+ +-+-+ +-+ + +-+ + +
|     | | | | | |     |
+ +-+-+ + + + +-+-+ +-+
|   |   |   | | | |   |
+ +-+ + + + +-+ + + +-+
|     | | | |         |
+ +-+ +-+-+ +-+-+-+-+ +
| |         | | |     |
+-+-+-+-+ +-+ + + +-+ +
|           |     |   |
+-+-+-+-+-+-+-+-+-+-+-+