+-+-+-+-+-+-+-+-+-+-+-+-+-+-+-+-+-+-+-+-+-+-+-+-+-+-+-+-+-+-+-+-+
| |       |   | | |       | | |   |     | | |       | |   | |   |
+ +-+-+ + + +-+ + +-+ +-+ + + + +-+ +-+-+ + +-+-+ +-+ +-+ + + +-+
|   | | |   | |   |   |           | |   |   |     | |     |     |
+ + + +-+-+ + + +-+-+-+-+ +-+-+ +-+ + + + +-+-+ +-+ +-+-+ +-+ + +
| | |     |     | |   | | | |   | |   |   |   |         | |   | |
+-+ +-+ +-+ +-+-+ + +-+ + + +-+ + + + +-+-+ +-+-+-+-+ +-+ +-+ + +
|   |     |     |       | |   | | | | | |                     | |
+-+ + +-+ +-+ + +-+-+ +-+ + + +-+ +-+ + + +-+ +-+ +-+-+-+ +-+-+ +
| | |   | | | |             | |         |   | | |     |       | |
+ + + + + + +-+-+ +-+-+-+ + +-+ +-+ +-+ + + +-+ + + +-+ +-+-+-+-+
|     | | |         |   | | |     |   |   | |   | |   |     |   |
+-+-+-+ +-+-+ + + +-+ +-+-+-+-+-+-+ +-+-+-+-+ +-+-+ + + +-+-+-+ +
| |   |       | | |     |     | |   |   |         | | | |       |
+ +-+ +-+-+-+-+ + + +-+ +-+ +-+ +-+-+ +-+ + +-+ +-+-+ +-+ +-+-+ +
|       |     | | | | | | |   | |   |     |   |         |   |   |
+ +-+-+ +-+ +-+ + + + +-+ + +-+ +-+ + +-+ + +-+-+-+ +-+-+ + +-+-+
|   |     |     |       |   | |       |   |       |   |   | |   |
+ +-+-+-+ + +-+ +-+ +-+-+ +-+ + +-+-+ +-+-+ +-+ +-+ +-+-+-+ + + +
|     |       |   | | |       |   | | | |     | | | |   |   | | |
+-+-+ + + +-+ + +-+ + + + + + +-+-+ +-+ + + + + + + + + + + +-+ +
|     | | |   | |       | | |     |     | | | | | | | | | |   | |
+-+ + +-+-+-+ + +-+-+ +-+ +-+ +-+ +-+-+ + +-+-+ + +-+ +-+ + + + +
|   | |   |   | |     |   |   |   | |       | |           | |   |
+-+-+-+ +-+-+ +-+-+-+ +-+-+ + +-+-+ +-+ + +-+ + +-+-+-+ +-+ +-+ +
|             |         |   |     |   | | |   | |         |   | |
+ + +-+-+-+ +-+-+ +-+ +-+ +-+-+ +-+ + + +-+-+ +-+-+-+ + +-+-+ + +
| |   |   | |     |     | | |       |   | |     | | | |     | | |
+ +-+-+ +-+-+-+ +-+-+-+ +-+ +-+ +-+ + + + + + + + + +-+-+ +-+-+-+
|   |     | |   |   | | |   | |   | | |   | | | | | |   |   | | |
+-+-+-+-+ + + +-+-+ + + + +-+ + +-+-+-+ +-+ + + + + + + + + + + +
|   | |           |           | | |     | | | |     | | | |   | |
+-+ + + +-+-+ +-+-+-+-+ +-+ + + + + + +-+ +-+ +-+ +-+ +-+ +-+ + +
|       |   | | |   | | |   | | |   | |     |   |   |   |   | | |
+-+-+ +-+ +-+-+ + +-+ + +-+ +-+ + +-+ + + +-+ +-+ +-+ +-+ + + + +
|           | |   | | |   |   | | |   | | |     |         | |   |
+-+ +-+-+ +-+ + +-+ + +-+-+-+-+ + +-+-+-+ + +-+ + +-+ +-+ + +-+-+
|     | | |         |   |       |   | | | |   | |   | |   |   | |
+ +-+ + +-+ +-+-+ +-+-+ +-+-+-+-+ +-+ + + + +-+ + +-+ +-+ + +-+ +
| |       |   | | | | |       |   |           | | |   |   |     |
+-+-+ + + + +-+ +-+ + +-+ + +-+ +-+-+-+ +-+ + + + +-+ +-+ + + +-+
|   | | |     | | |   |   |   |   |   |   | | | | |   | | | |   |
+ +-+-+-+-+-+ + + + + +-+ +-+ +-+-+ + +-+-+-+-+ +-+ +-+ + + + +-+
|   |     | | |   | | | |   |     | |   | |   |   | |     | |   |
+ +-+ + +-+ + + + +-+ + + + +-+-+ +-+ +-+ + + + +-+ + +-+-+-+-+ +
|   | |     | | |     | | |   |   |   |   | | | | | |   |   |   |
+ + + + +-+ + +-+ +-+-+ + + +-+-+ + + +-+ +-+ +-+ + + + + +-+-+-+
| | | |   | |   |   |     |   | |   |   |       |   | |       | |
+ + + +-+ +-+-+ + +-+-+-+-+-+-+ +-+-+ +-+-+ +-+-+ +-+ + +-+-+ + +
| | |   |           | |   |         |       | | | |   | |       |
+-+ +-+ +-+ +-+-+-+-+ +-+ +-+-+-+ +-+ +-+ + + + +-+-+-+ +-+-+-+ +
|   | |   |             | |       | | |   |       | |   | | |   |
+-+ + +-+-+-+ + +-+-+ + + + + +-+ + + + + +-+ +-+-+ +-+ + + + +-+
| |     |   | |   |   | |   | | |   | | |   | |   | | | |   | | |
+ +-+ +-+-+ +-+ +-+-+-+ +-+ +-+ + + + +-+-+-+-+ +-+ + +-+-+ + + +
|   |   |   |     |       |   |   |   | |     |       |     |   |
+ + + +-+ +-+-+-+ +-+ + +-+ +-+-+-+-+ + +-+ +-+ +-+-+ + +-+ + +-+
| |                 | | | |   |       |   |   | | | | | | |   | |
+-+ +-+-+-+-+-+ + +-+ +-+ +-+ + +-+-+ +-+ +-+ + + + + +-+ +-+ + +
|     |     | | |   | |   |   |   |                 | | | |     |
+ + + + + + + +-+-+-+ +-+ + +-+ +-+-+-+-+ +-+ +-+ +-+ + + +-+-+-+
| | |   | |       | | | |     |       |     |   | | |       |   |
+ +-+ +-+-+ +-+ + + + + +-+ +-+-+-+ + +-+ + +-+ + + +-+ + + + + +
| |     |   |   |   |           |   |   | | |   |   |   | |   | |
+-+-+-+-+-+-+-+-+-+-+-+-+-+-+-+-+-+-+-+-+-+-+-+-+-+-+-+-+-+-+-+-+