+-+-+-+-+-+-+-+-+-+-+-+-+-+-+-+-+-+-+-+-+-+-+-+-+-+-+-+-+-+-+-+-+-+-+
|     | |         |       | |         |       |           |         |
+ +-+-+ + + +-+-+-+ +-+ +-+ + + + + + + +-+-+ +-+ +-+-+ +-+-+-+-+ +-+
|   |   | |     | | | |   |   | | | | |   | |         | | |   |     |
+ + +-+ + + + + + +-+ + +-+ + + + +-+-+ +-+ + +-+ +-+ +-+ +-+ +-+ +-+
| |   | | | | | |         | | | |   | |     |   | |     |     | |   |
+ +-+ + + +-+-+-+-+-+ +-+ +-+ +-+ + + + +-+-+-+-+-+ +-+-+-+-+ + + + +
| |         |       |   |   | |   |   | |     | |       |   | |   | |
+ +-+-+-+ +-+ +-+-+-+-+-+-+ + +-+ + +-+-+-+ + + + +-+ +-+-+ + + +-+-+
| |   | |   |     |       | |   | |     |   |   | |         |     | |
+-+ +-+ + +-+ +-+-+-+-+ +-+ +-+ +-+ +-+-+-+ +-+ +-+-+ +-+ +-+ +-+-+ +
|   |     |     | |       | |   | | |   |   |   | | |   |     |     |
+-+ +-+ +-+ +-+-+ +-+-+-+ + + +-+ + + +-+-+ +-+-+ + +-+ +-+-+ + +-+ +
|   |   |             |           |   |     |   |   |   | |   |   | |
+ +-+ + +-+ +-+-+ +-+-+ +-+-+-+-+-+-+ +-+ +-+ +-+-+ +-+ + +-+ + +-+-+
|     |         |           | | |   | |   |     | | | | |   |   | | |
+ +-+-+ +-+ + +-+-+-+-+ +-+-+ + +-+ + + + + +-+ + + + + + +-+-+-+ + +
| |   | |   |     |   |         | | |   |   | | |   |         |     |
+ + +-+-+ +-+-+ +-+ +-+-+ +-+-+ + + + + + + + + + + +-+-+-+-+ + +-+ +
|       |   |       |       |       | | | | | | | | | | |   | | | | |
+ +-+ +-+-+-+-+-+-+ +-+-+-+-+-+ +-+-+ + +-+-+ + + +-+ + +-+ + + + +-+
| |     |                 |     | | | | |   |     |     | | | |     |
+ +-+-+-+-+ +-+-+-+-+-+ +-+ +-+-+ + +-+-+-+ +-+ + + +-+ + + + + +-+-+
|     |   |     |   |   | | |   | | |     | | | | |   |       |   | |
+ + +-+-+ +-+ + + +-+-+-+ +-+ + + + +-+ + + + +-+ +-+-+ +-+-+-+ +-+ +
| |   | |     |               | |       |     | |   |           | | |
+ +-+-+ +-+ +-+-+-+ + +-+-+-+ +-+ +-+-+ +-+ +-+ + +-+-+ + + + + + + +
|         | |       |   |       |   |     | |       | | | | | |     |
+ +-+ + +-+-+-+-+-+-+ +-+-+ + +-+ +-+-+ +-+ +-+-+-+-+ + +-+-+-+-+ + +
|   | |     |   |         | | | | | |     |   |       |     | |   | |
+ + + +-+-+ + +-+-+-+-+-+-+ +-+ +-+ + +-+-+-+ + +-+-+-+ +-+ + + +-+-+
| | |   |   | |     |         |   |   |   |           |   |   | |   |
+ +-+-+-+-+-+ +-+ + +-+-+-+ + + + + +-+ +-+-+ +-+-+ + + +-+ +-+ + +-+
| | |       |     | |       |   |     |     |     | | |   | |       |
+-+ + + +-+-+ +-+-+-+-+ +-+-+ + + +-+ +-+-+ +-+ +-+-+-+-+-+-+ +-+-+-+
|   | |   |                 | | |   | |       |           |   | | | |
+ + +-+ +-+-+ +-+ +-+-+ +-+ +-+-+ + +-+-+-+-+ + +-+-+ +-+ +-+ + + + +
| |     |     |       | | |     | |     | |       | | |         | | |
+-+-+ + +-+ + +-+-+ +-+ + + +-+-+-+-+ +-+ +-+-+ +-+ + + +-+ +-+-+ + +
|     | |   | |   |   | | | |       | | |   | | |   | |   |   |     |
+-+-+ +-+-+ +-+ +-+ +-+-+ + +-+ +-+ + + + +-+ +-+-+ +-+ +-+ + + +-+ +
|       |     | | |       | |     | | |   |       |   | |   | |   | |
+ +-+ +-+ + +-+ + +-+ +-+-+-+ +-+-+ +-+ +-+ +-+-+-+-+ +-+ + +-+-+-+ +
| |     | | |     | | |     |   | | |   | |         |     |         |
+-+-+-+ + +-+-+-+ + + + +-+-+-+-+ + + + + +-+ + + + + +-+ + +-+-+ + +
| |     | |     |   |   |       | | | |       | | | | | | |   | | | |
+ +-+ +-+ +-+ +-+ + + +-+-+ +-+ + + +-+ +-+ +-+ +-+ + + +-+-+ + +-+-+
|   | |     |     | |     |   |       |   | |   | | |     | | |   | |
+ +-+ + +-+-+-+-+ +-+-+-+ +-+-+-+-+-+ + +-+-+ + + +-+-+-+-+ + +-+ + +
| | |     |       |   |   |               | | |   | | | |   | |     |
+ + +-+ +-+-+ +-+ +-+ +-+ + +-+ +-+-+-+ + + +-+-+-+ + + +-+ + + +-+-+
|       | |   |       |   | |   |       | |         |         |     |
+-+ + +-+ + +-+ +-+-+ + +-+-+ +-+-+-+-+-+ +-+-+-+ + +-+ +-+-+ + + + +
|   |   |   |       | | |         | | | |         |     |       | | |
+ +-+ +-+-+-+-+ +-+-+-+-+-+ +-+ +-+ + + + +-+ +-+-+ +-+ +-+ + +-+-+-+
|   |           |     |   | |       |     | | |     |     | |   |   |
+-+-+-+ +-+-+-+ +-+ + +-+ +-+-+ +-+-+-+ +-+ +-+ +-+ +-+-+-+-+ +-+ + +
| |   |     | | | | |   |   | | | |         |     | | | |         | |
+ + +-+-+ +-+ +-+ +-+-+ + +-+ + + +-+ +-+ +-+-+-+ +-+ + +-+ + +-+ +-+
|             |         |   | |   |   | | |     | |   | |   | |     |
+-+-+-+-+ + +-+-+-+ +-+-+-+ + + + +-+-+ + + +-+-+-+ +-+ +-+ +-+-+-+ +
|   | |   |   |             |   | |     |   |   | |     |     | | | |
+ +-+ +-+ +-+-+ + + +-+-+ +-+-+-+ +-+-+ + +-+ + + +-+-+ +-+-+-+ + + +
|         |   | | |   |   |   |     |   |     | | | | |         | | |
+ +-+-+-+ +-+ + +-+ +-+ + + +-+ + +-+-+ + +-+-+ + + + + +-+ + + + +-+
| |     |         |   | |   | | | |         |           |   | |   | |
+ + +-+-+ +-+ +-+ + + +-+-+ + + +-+ +-+-+ +-+ + +-+-+ +-+-+-+ + + + +
|     |     |   | | | |     |     | |     |   |   |         | | |   |
+-+-+-+-+-+-+-+-+-+-+-+-+-+-+-+-+-+-+-+-+-+-+-+-+-+-+-+-+-+-+-+-+-+-+