+-+-+-+-+-+-+-+-+-+-+-+-+-+
|                     |.|.|
+-+-+-+-+-+-+-+-+-+-+-+-+-+
|.|.|.|.|.|.|.|.|.|.|.|.|.|
+-+-+-+-+-+-+-+-+-+-+-+-+-+
|.|.|.|.|.|.|.|.|.|.|.|.|.|
+-+-+-+-+-+-+-+-+-+-+-+-+-+
|.|.|.|.|.|.|.|.|.|.|.|.|.|
+-+-+-+-+-+-+-+-+-+-+-+-+-+
|.|.|.|.|.|.|.|.|.|.|.|.|.|
+-+-+-+-+-+-+-+-+-+-+-+-+-+
|.|.|.|.|.|.|.|.|.|.|.|.|.|
+-+-+-+-+-+-+-+-+-+-+-+-+-+
|.|.|.|.|.|.|.|.|.|.|.|.|.|
+-+-+-+-+-+-+-+-+-+-+-+-+-+
|.|.|.|.|.|.|.|.|.|.|.|.|.|
+-+-+-+-+-+-+-+-+-+-+-+-+-+
|.|.|.|.|.|.|.|.|.|.|.|.|.|
+-+-+-+-+-+-+-+-+-+-+-+-+-+
|.|.|.|.|.|.|.|.|.|.|.|.|.|
+-+-+-+-+-+-+-+-+-+-+-+-+-+
|.|.|.|.|.|.|.|.|.|.|.|.|.|
+-+-+-+-+-+-+-+-+-+-+-+-+-+
|.|.|.|.|.|.|.|.|.|.|.|.|.|
+-+-+-+-+-+-+-+-+-+-+-+-+-+
|.|.|.|.|.|.|.|.|.|.|.|.|.|
+-+-+-+-+-+-+-+-+-+-+-+-+-+