+-+-+-+-+-+-+-+-+-+
|   | | | |     | |
+ + + + + + + + + +
| | | | |   | |   |
+ +-+ + +-+ +-+-+ +
| | |   | |   | | |
+ + +-+ + + + + +-+
|   |   | | |     |
+ +-+ + + + +-+ +-+
|   | | | |   |   |
+-+ +-+ + + +-+-+-+
| |           |   |
+ +-+ +-+-+-+ + +-+
|       |       | |
+-+ +-+ + +-+ +-+ +
|     | | |     | |
+-+ + +-+ + +-+ + +
|   |   | | |     |
+-+-+-+-+-+-+-+-+-+