+-+-+-+-+-+
|         |
+ + + + + +
| | | | | |
+ + + + + +
| | | | | |
+ + + + +-+
| | | |   |
+ + + +-+-+
| | |     |
+-+-+-+-+-+