+-+-+-+-+-+-+-+-+-+-+-+-+-+-+-+-+-+-+-+-+-+-+-+-+-+-+-+-+-+-+-+-+
| |   |           |   |         |       |     |               | |
+ + + + + +-+ +-+-+ + + +-+-+-+ + +-+ + +-+ + + +-+-+ +-+-+-+ + +
|   | | |   | |     |     |     | | | |     | | |     |     |   |
+-+-+ +-+-+ +-+ +-+-+-+-+-+ + +-+ + + +-+-+-+ +-+ +-+-+ +-+-+-+ +
|   | |   |     | |         | |     |   |   |     | |   |       |
+ +-+ + + +-+ +-+ + +-+-+ +-+-+ +-+-+ + + + +-+-+-+ + + + +-+-+-+
|   |   |   |     |   |   |     |   | |   |   |       | |   |   |
+ + +-+-+-+ +-+-+-+-+ +-+-+ +-+-+ + +-+-+ +-+ +-+ +-+-+ +-+ +-+ +
| |   |   |         |         | | |     | | |   |     |   | |   |
+-+ + + + +-+-+-+-+ +-+-+-+-+ + + +-+-+ + + +-+ +-+-+-+ + + + +-+
|   | | |   |     |   |     | | | |   | | |   |       | | | |   |
+ +-+ +-+ + + +-+ +-+ + +-+ + + + + +-+ + + + +-+-+-+ + +-+ +-+ +
|   |     |   |   | |   |   |   | |     |   |   |     | |   |   |
+-+ +-+-+-+-+-+ +-+ +-+-+ +-+-+-+ + +-+-+-+-+ +-+ +-+-+ + +-+ +-+
|   | |         |       |     |   |   |   |   |   |   |   |     |
+ +-+ + +-+-+-+-+ +-+-+ +-+-+ + +-+-+ + + +-+-+ +-+ + + +-+-+-+ +
| |   |     |     |   | |   |   |   |   |     | |   | | |   |   |
+ +-+ +-+-+ +-+ + +-+ + + +-+-+-+ + +-+-+-+-+ + + +-+ + + + + +-+
|   |     |   | |   | | | |       |   |     |   | | | |   | |   |
+-+ + +-+-+-+ +-+-+ + + + + + +-+-+-+ + +-+ +-+-+ + + +-+-+ +-+ +
|   | |             | | |   |       | | |     |   | |     | |   |
+ +-+ + +-+-+-+-+-+-+ + +-+ +-+-+-+ + + + +-+-+ +-+ +-+ + + + + +
|   |     |     |     |   | |     | | | |       |     | | |   | |
+-+ + +-+-+ +-+ + +-+ +-+ + + +-+ + + + +-+-+-+-+-+ +-+ + +-+-+ +
|   |   |     | | | |   | | | | | | | |     |     |   | |     | |
+ +-+ +-+ +-+-+ + + +-+ + + + + + + +-+-+-+ + + + + + + +-+-+-+ +
| |   |     |   |   | |   |   | | |       | | | | | | |         |
+ +-+-+ +-+-+ +-+-+ + +-+-+-+-+ + +-+ +-+ + +-+ + +-+ +-+-+-+-+-+
| |     | |   |         |   | |   | |   | |     |   |     |     |
+ + +-+-+ + + +-+-+-+-+ + + + + +-+ +-+ + +-+-+-+-+ + +-+ + +-+ +
| |   |   | | |     |   | | |         | |         |   |   | |   |
+ +-+ +-+ + +-+ +-+ + +-+ + +-+-+ +-+-+ +-+-+-+-+-+-+-+ +-+ + +-+
|   |     |       | | |   |   |   |   | |   |       |   |   | | |
+ +-+ +-+-+ +-+-+-+ + + +-+-+ +-+-+ + + + + + +-+-+ + +-+ +-+ + +
|     |   | |       |   |           |   | | |   |   | | |   | | |
+ +-+-+ + +-+ +-+-+-+-+-+ +-+-+-+-+-+-+-+ + +-+ + +-+ + + + + + +
| | |   | |   |     |   | | |             | |   |     |   | |   |
+ + + +-+ + +-+-+ + + + + + + +-+-+-+-+-+-+ + +-+-+-+-+-+-+ +-+ +
|   | |   | |     |   | | | |   |   |     |   |   |       |   | |
+-+ + +-+ + + +-+-+-+-+-+ + +-+ + + + + +-+-+-+ + + +-+-+ +-+ +-+
| | |   |   | |           |   | | |   |       | | |     |   |   |
+ + +-+ +-+-+ + +-+-+-+-+-+-+ + + +-+-+-+-+ + + + +-+-+ +-+ +-+ +
| |   | |     |               | |     |   | |   | |     | | |   |
+ +-+ + +-+-+ +-+-+-+ +-+-+-+-+ +-+ +-+ + + +-+-+ + +-+-+ + + + +
|   | |     |         |         |   |   |   |   | |   |     | | |
+ + + +-+-+ +-+-+-+ +-+ +-+-+-+-+ +-+ +-+-+-+-+ + +-+ +-+ +-+ +-+
| | |   | |       |   | |       | | | |         |   |   |   |   |
+ +-+-+ + +-+-+-+ +-+ + + +-+-+ + + + +-+-+ +-+-+-+ +-+ +-+ +-+ +
|     | |       |   | |   | |   |   |     |           | | |     |
+ +-+ + + + +-+-+ + + +-+-+ + +-+-+ +-+-+ +-+ +-+-+-+ + + + +-+-+
| | |   | | |   | | | |   |   |       | |   |   |   |   |   |   |
+ + +-+-+ +-+ + + + + + + + +-+-+-+-+ + +-+ +-+-+ + +-+-+-+-+ + +
|   |     |   | | | |   | |   |     |   |   |   | |           | |
+-+ + + + + +-+ +-+ +-+-+ +-+ + +-+ +-+ + +-+ + + +-+-+-+-+-+-+ +
| | | | | | |       |       |   |   |   |     |     |         | |
+ + + + +-+ + +-+-+-+-+-+-+-+-+-+ +-+ +-+-+-+-+-+ +-+ +-+-+-+ + +
| | | | |   |   |   |           | |   | |       | |   |       | |
+ + + + + +-+-+-+ + + +-+-+ +-+-+ + +-+ + +-+-+ + + +-+ +-+-+-+ +
|   | | | |       |   |   |   |   |     | |     | |   |     |   |
+ +-+ + + + +-+-+-+-+-+-+ +-+ + +-+-+-+ + +-+-+ +-+-+ +-+-+ + + +
| |   | |   |             |   |       | |     |       |     | | |
+ +-+-+ +-+-+-+-+ +-+-+-+ + +-+-+-+-+ +-+-+-+ +-+-+-+-+ +-+-+ + +
|                 |       |                   |               | |
+-+-+-+-+-+-+-+-+-+-+-+-+-+-+-+-+-+-+-+-+-+-+-+-+-+-+-+-+-+-+-+-+