+-+-+-+-+-+-+-+-+-+-+-+-+-+-+-+-+-+-+-+-+-+-+-+-+-+-+-+-+
|     |       |       |             |       |           |
+-+-+ + +-+-+ + +-+-+ + + +-+-+-+ +-+ + +-+ +-+ + +-+-+ +
|   |   |   | |     | | | |   |   |   |   |   | |     | |
+ +-+-+-+ +-+ + +-+ + +-+ + + +-+-+ +-+-+ +-+ +-+ +-+ + +
|           | | |   |   |   |   |   |   | |     |   | | |
+ +-+-+-+ + + +-+ +-+-+ +-+-+-+ + +-+ + + +-+-+ +-+ + +-+
| |     | | |     |   | |       | |   | |     |   | |   |
+ + +-+ +-+ +-+-+-+ +-+ + +-+-+ + + +-+ +-+-+ +-+ +-+-+ +
| | | |   |     |       |   |   | |   |     |   | |   | |
+-+ + +-+ + +-+ + +-+-+-+ + +-+-+ +-+ +-+ +-+-+ + + + + +
|   | |   | | | |     | | | |       | |   |     |   | | |
+ +-+ + +-+ + + +-+-+ + + + + +-+-+ + +-+-+ +-+-+-+-+ + +
| |   | |     |     | |   | | |   |   |   | |       | | |
+ + + + +-+-+-+-+-+ + + +-+ + + + +-+-+ + + +-+ + +-+ + +
| | |     |         | |   | | | |       | |   | |   |   |
+ +-+-+-+ + +-+ +-+-+ +-+ + + + +-+-+-+-+ +-+ + +-+ +-+ +
| |   | | | |   |     |   |   |         |     | | |     |
+ + + + + + + +-+ +-+-+-+-+-+ +-+-+-+-+ +-+-+-+ + +-+-+-+
|   | |     |   | |         |   |   |   |     |     |   |
+-+-+ + +-+-+-+ + + +-+-+-+ +-+ + + + +-+ +-+ +-+-+ + + +
|     | |   |   | |     | |   |   | |     | |     | | | |
+ +-+-+-+ + +-+-+ +-+-+ + +-+ +-+-+-+ +-+-+ +-+-+ + +-+ +
| |       |   |   |   | |   | |     |           | |     |
+ + +-+-+-+-+ + +-+ + + + + + + +-+ + +-+-+-+-+-+ +-+-+ +
| |     |   |   |   | | | | |   |   | |         | |     |
+ +-+-+ + +-+-+-+ +-+ + +-+ +-+-+ +-+-+ +-+-+-+ + + +-+-+
|     | |           |   |   |   | |     |     |   |     |
+-+ + + +-+-+-+-+-+ +-+-+ + +-+ + + +-+-+-+-+ +-+-+-+-+ +
|   | |             |     |     |   |   |   |         | |
+ +-+-+-+-+-+-+-+-+-+ +-+ +-+-+-+-+-+ + + + +-+-+ +-+-+ +
| |     |     |   |   |   |   |       |   |     | |   | |
+ + +-+ + + + + +-+ + +-+-+ + + +-+ +-+-+-+-+-+ + + + + +
| | | | | | | |   | |   |   | | | |   |   | |   | | |   |
+ + + + + + + +-+ + +-+ + +-+ + + +-+ + + + + +-+ + +-+-+
|     |   | |   | | | | | | |     |   | |   |     |     |
+ +-+-+-+-+ +-+ + + + + + + +-+-+-+ +-+ +-+ + +-+-+-+-+ +
| |       | | |   | | |   | |     |   | |   | |         |
+-+ +-+-+ + + +-+ + + +-+-+ + +-+ + + + +-+-+ + +-+-+-+-+
|   |   |   |     |     |   | |   | | |       | | |     |
+ +-+ +-+-+-+ +-+-+-+-+ + + + + +-+-+ +-+ +-+-+ + + + +-+
|   |       |   |   |   | | | | |   |   |   |   | | |   |
+-+ +-+-+-+ +-+ +-+ + +-+ +-+ + + + + + +-+ + +-+ + +-+ +
|   |     |         | |   |   | | | | | |   | |       | |
+ +-+ +-+ +-+-+-+-+ + + + + +-+ + + +-+ +-+-+ +-+-+-+ + +
|     | |       | | | | | | |     | |   |     |     | | |
+ +-+-+ +-+-+-+ + + + + + + +-+-+-+ + +-+ +-+-+ +-+ +-+ +
| |     |   |   |   |   | |   | |   |   |   |   | |   | |
+ + +-+-+ + + + +-+-+-+-+ +-+ + + +-+-+ +-+ + +-+ +-+ + +
| |   |   |   | |       | |   |           | | |     |   |
+ +-+ + +-+-+-+-+ + +-+-+ + +-+ +-+-+-+-+-+ + +-+-+ +-+ +
|     |       |   |       | |     |       | |   |   |   |
+-+-+ +-+-+-+ + +-+-+-+-+-+ +-+-+ + +-+-+ + +-+ + +-+ +-+
|   |   | |   |           | |   | | |   | |     |   | | |
+ +-+-+ + + +-+-+-+-+-+-+ + + + +-+ + + + +-+-+-+ + + + +
|         |               |   |       | |         |     |
+-+-+-+-+-+-+-+-+-+-+-+-+-+-+-+-+-+-+-+-+-+-+-+-+-+-+-+-+