+-+-+-+-+-+-+-+
|             |
+ +-+ + + + + +
| |   | | | | |
+ + +-+-+ + +-+
| |   |   |   |
+ +-+-+ + +-+-+
| |     |     |
+ + +-+ + + +-+
| |   | | |   |
+ +-+ + + + +-+
|   | | | |   |
+ + + +-+ + + +
| | | |   | | |
+-+-+-+-+-+-+-+