+-+-+-+-+-+-+-+-+-+-+-+-+-+
|                         |
+ + +-+ + +-+-+-+ +-+-+-+ +
| |   | |       |       | |
+ +-+-+-+-+-+-+-+ + + + + +
|               | | | | | |
+ +-+ +-+ + +-+ + +-+ +-+ +
|   |   | |   | |   |   | |
+ + +-+-+-+ +-+ + +-+-+-+ +
| |       |   | |       | |
+ + + +-+-+-+-+ +-+-+-+-+-+
| | |         |           |
+ + + +-+-+ + + +-+ +-+-+-+
| | |     | | |   |       |
+ +-+ + +-+-+ +-+-+-+ +-+ +
|   | |     |       |   | |
+ +-+-+ +-+-+-+-+ +-+ + + +
|     |         |   | | | |
+ +-+ +-+-+-+ +-+-+-+-+ + +
|   |       |         | | |
+ +-+-+ + +-+-+-+-+-+-+-+-+
|     | |   |.|.|.|.|.|.|.|
+-+-+-+-+-+-+-+-+-+-+-+-+-+
|.|.|.|.|.|.|.|.|.|.|.|.|.|
+-+-+-+-+-+-+-+-+-+-+-+-+-+
|.|.|.|.|.|.|.|.|.|.|.|.|.|
+-+-+-+-+-+-+-+-+-+-+-+-+-+