+-+-+-+-+-+-+-+-+-+-+-+-+-+-+-+-+-+-+-+-+-+-+-+-+-+-+-+-+-+-+-+-+-+-+-+-+-+-+-+-+-+-+-+
|     |   |                 |   |     | |   | |     |       | |   |     | |   |     | |
+-+ +-+ +-+ + +-+ + +-+-+-+-+-+ +-+ +-+ + +-+ + + + +-+-+-+ + + + + +-+ + + +-+-+ +-+ +
| | | |     | |   | |   | |       | |   |     | | |   |     |   |   |   | | | | | |   |
+ + + +-+-+-+ +-+-+-+-+ + + +-+-+ + + +-+-+ + + +-+-+ +-+ +-+ +-+ + +-+ + + + + + + +-+
|       |     |   |       | | |         |   | |   |     |     |   |   | |     |   |   |
+-+-+ +-+ +-+-+-+ +-+-+-+ + + +-+-+ + +-+-+ + +-+-+ + + +-+ +-+-+-+-+ +-+ + + + +-+-+ +
|   |   |               |       |   | |     |     | | | |   | | |   |     | |       | |
+-+ + +-+-+ +-+ +-+-+ +-+-+ +-+-+ +-+-+-+-+-+ +-+ + + +-+-+ + + +-+ + +-+-+ +-+-+ +-+ +
| |     |   |       |       |       |   |   |   |   |   |     |     | | | |     | |   |
+ +-+-+ + +-+-+-+-+-+-+-+ +-+-+ + +-+ +-+ +-+-+ + +-+-+-+-+-+-+ + + + + + + +-+-+-+ + +
| | |   |   | |     |   | |     |   | | | |   | |               | |   |   |   |     | |
+ + + +-+ +-+ + +-+-+ +-+-+-+ + +-+-+ + + +-+ +-+-+-+-+-+-+ +-+-+ +-+-+-+ +-+ + + +-+-+
|       |     |       |   |   | |       | | | | | |         |   | | |   |   |   |     |
+-+ + +-+ +-+ + +-+-+-+-+ +-+-+-+-+ +-+ + + + + + +-+-+-+ +-+ +-+-+ +-+ +-+ + + +-+ +-+
| | |   | | |                   |   |               |         |               | |   | |
+ + +-+-+-+ + + + + + +-+ +-+-+-+-+ + +-+-+ +-+-+ + +-+-+-+ + +-+-+ +-+ +-+-+-+ +-+ + +
|             | | | |   |         | | |   | |   | | |       |     |   |   |     |   | |
+ +-+ + + +-+-+ +-+-+ + +-+-+-+-+ +-+-+ +-+ + +-+-+ + +-+-+ + +-+-+-+ + +-+ +-+ +-+ + +
| |   | | |   | | |   |   | | |         |       |     |   | |     |   | |     | |     |
+-+ +-+-+-+ + +-+ +-+-+-+-+ + +-+-+ +-+-+-+ +-+-+ +-+-+-+ +-+-+-+-+ +-+-+ +-+-+ + +-+-+
| | |     | |     |         | | |   |   | | | | | |     |     |         |   |   |     |
+ + + + +-+ +-+ +-+-+ + + + + + +-+ + + + + + + + +-+ + + +-+ +-+-+ + +-+-+-+-+ +-+-+-+
|     | |     | |     | | | | |   | | |       |     | |     |     | |     |   |   |   |
+-+ +-+ +-+ +-+ +-+-+ +-+-+ + +-+ + + +-+ +-+ +-+ +-+-+ + +-+-+-+ +-+-+-+ +-+ + + + +-+
|   |     |   | |   |     |   |   |   | |   | |     | | |   |           | |   | |     |
+ + +-+ +-+ +-+-+ +-+-+-+ +-+ +-+ +-+-+ +-+-+-+-+-+ + +-+-+-+ + + + +-+-+ + +-+ +-+-+ +
| | |     | |             |   |   | | |   |         |     |   | | | |       | |   | | |
+ + + +-+-+ +-+ +-+ +-+-+ +-+ + + + + + + +-+ + +-+ + +-+-+-+ +-+-+ +-+-+-+ + + + + +-+
| | | |       | | | |   | | | | | |     |   | | |           | | | | | |   |   | |     |
+-+ +-+ + +-+-+ + + +-+ + + +-+ +-+-+ +-+-+ +-+ +-+ +-+-+-+ +-+ + + + + +-+ +-+-+-+-+-+
| | |   | |   | |     |   |   |     |     | |     | |   |     |     |           | |   |
+ +-+ +-+-+-+ +-+-+ + +-+ +-+ +-+ + + +-+-+ +-+-+ +-+ +-+ +-+-+ + +-+ + +-+-+-+-+ + +-+
|     |       |     | |   |     | | | |     | |   | |   |       | |   |       |   | | |
+ + +-+ +-+ +-+-+ +-+ + + + +-+-+ +-+ +-+ +-+ +-+ + + +-+ +-+ + +-+-+-+ +-+ +-+-+ + + +
| |     | |     | |   | | |   |       |           |   | |   | |   | |     |   |     | |
+-+ +-+-+ + + + + +-+-+ + + +-+ + +-+ + +-+-+ +-+-+-+ + +-+ + +-+-+ + +-+-+ +-+-+ + + +
|     |   | | | | | |   |       | |   |   |               | | |   |       | | | | |   |
+-+ +-+-+ +-+-+-+ + + +-+ +-+-+ + +-+-+-+-+-+ +-+-+-+ + +-+-+-+ +-+-+-+-+ + + + + + +-+
| |       | | |     | |   | |   | |     |   | |       |       | | |   | | |   | | |   |
+ +-+ + +-+ + +-+ + +-+ + + + +-+ + +-+ + +-+ +-+ +-+-+-+-+ +-+ + +-+ + + + +-+ +-+ +-+
| |   |     |   | |   | |   | |   | |     | | | |     |     |     |   |   |   |   |   |
+ + +-+-+-+-+ +-+-+ +-+ +-+-+-+-+-+-+ +-+ + + + +-+ + +-+-+ + +-+-+ +-+-+ + + +-+ + + +
| |       |       |   |     |     |     |         | |   | | |     |   |   | | |   | | |
+ +-+ +-+ +-+ +-+-+-+ + + + +-+-+ +-+-+ + +-+ +-+ +-+ +-+ + +-+ +-+ + + +-+-+ +-+ + +-+
|       | | |   |     | | |     | |     | |   |     | |     | |   | |     | |         |
+ +-+-+ +-+ +-+ +-+-+ + +-+-+ +-+ +-+-+-+-+-+ + +-+-+-+ + + + + +-+ +-+-+ + + + +-+-+-+
| |       | |       | |   |   | |         |   | |       | |   | |   | | | |   |   |   |
+-+ +-+ + + + +-+-+-+-+ + +-+-+ +-+ +-+-+-+ + +-+ +-+ +-+-+ +-+ + +-+ + +-+-+-+-+ + +-+
|     | |   |   | |   | | |       |       | | |   |     |     |     | |   |       | | |
+-+-+ +-+ + + + + +-+ + +-+ + +-+-+-+ +-+ + +-+-+-+-+-+ +-+-+-+-+ + + +-+ +-+ +-+ + + +
|     |   | | | |   |     | | | |   | |       | |   | | |       | |     |       |     |
+-+ +-+-+-+ + +-+-+ + +-+ + +-+ + +-+-+ +-+ + + + +-+ +-+ +-+-+ +-+-+ +-+-+-+-+-+-+-+ +
|     |       | |     |       |   |   | |   | |   |   | | |       |   | |     |       |
+ +-+-+-+ +-+ + + +-+ +-+ + +-+ + + +-+-+-+-+-+ +-+-+ + +-+ +-+ +-+-+ + + + +-+ + +-+-+
|   |   | |         | | | | | | | |       |   | | | |     | | |           | |   | |   |
+-+-+-+ +-+ + + + +-+-+ + +-+ + +-+ +-+ +-+ +-+ + + +-+ +-+ + +-+-+ + + + +-+-+-+ + +-+
|   |       | | | | | | |   | | |     | |                 |   | | | | | |     | | |   |
+ +-+-+ + +-+ +-+ + + + + + + + + +-+-+ + +-+-+ + +-+-+ + + +-+ + + +-+-+-+-+-+ + + +-+
| |     |   | |     |     |         |         | | |   | | |     |         |   |     | |
+ + +-+ +-+ + +-+-+-+-+ +-+-+-+-+-+ +-+-+-+ +-+-+-+-+ +-+ +-+-+-+-+ +-+-+ + +-+-+-+-+ +
|     | | | | | |       |     | | | |   | |   |   | |             |   |           | | |
+-+-+ +-+ +-+ + +-+ + + + +-+-+ + +-+ +-+ +-+ +-+ + +-+-+ + +-+-+ + +-+-+-+-+ + +-+ + +
|     | | |   |   | | |   |   |   |       | |   |     | | | |   | |   |   |   | |     |
+ +-+-+ + +-+-+ + + +-+ +-+-+ +-+ +-+ +-+ + + +-+ + + + +-+-+-+ +-+-+ + +-+-+-+-+-+ + +
| | |     |     |   |   | |       | | |   |     | | |   |   | |       |             | |
+-+ +-+ +-+-+ + +-+ + + + +-+ +-+-+ + + +-+-+ +-+-+ +-+-+-+ + +-+-+-+ + + +-+-+-+ +-+ +
|     |     | | | | | | |   |     |   |       | |     |         |     | | |   |   |   |
+-+-+ + + +-+ +-+ +-+-+-+ + + +-+-+-+ +-+-+-+-+ + +-+ +-+-+-+ +-+ + + +-+ +-+ + + +-+ +
| |     |   | | | |   |   |     |         | | |   | |   | | | | | | |     |     |   | |
+ +-+-+ +-+ + + + + +-+-+-+-+-+ +-+-+-+ +-+ + +-+ + + +-+ + + + +-+ +-+-+ + +-+-+-+-+-+
|   | | |     |           |     |   |   |       |   | |           | |     |   |   |   |
+-+ + +-+ +-+-+ +-+ +-+-+ +-+-+ + + +-+ + + +-+-+ + +-+ +-+ + +-+-+ +-+-+-+-+-+ +-+ +-+
| |         |     | | | |         | |   | |       | | | | | | | |     | |         |   |
+ + + +-+ +-+-+-+ +-+ + +-+-+ +-+ +-+-+ + +-+-+-+ + + + + +-+ + + +-+ + + +-+-+ +-+ + +
| | | |     | |             | |     |   |   | |   | |   | |   |     |     |       | | |
+ + + + + + + + +-+ +-+ +-+ + + +-+-+ +-+ +-+ +-+ + +-+-+ + + + +-+-+ + + +-+-+-+ +-+ +
|   | | | |   |   | |   |   | |   |         |     | | |   | |     |   | |       |     |
+ +-+ + +-+-+-+ + +-+ +-+-+ + +-+ + +-+-+-+-+-+-+ + + + +-+-+ +-+ + +-+ + +-+-+-+-+ +-+
| |   | | |     |   |   |   |   |   |       |     | | |       |   | |   |   |   | |   |
+-+-+-+ + + +-+ +-+-+ +-+-+ +-+-+ + +-+ +-+ +-+-+ + + +-+-+ +-+-+ +-+-+ + +-+ +-+ +-+ +
|       | | |   |       | | |   | | |   |     |   | |     |     | | |   | |       | | |
+ +-+ + + + +-+-+ +-+ + + +-+ + + + +-+-+ +-+ +-+-+ +-+ +-+-+ + +-+ +-+ + + +-+-+ + +-+
| |   |   |     | |   |   | | |   |   |   | |           |     | |       |   | |       |
+ +-+ + +-+ + +-+-+ + +-+-+ + + + + +-+ +-+ +-+ + +-+ +-+ + + +-+-+ +-+ + + + + +-+ +-+
|   | |   | |   |   | |       | | | |       |   |   |   | | | |     |   | |   |   |   |
+-+-+-+-+-+-+-+-+-+-+-+-+-+-+-+-+-+-+-+-+-+-+-+-+-+-+-+-+-+-+-+-+-+-+-+-+-+-+-+-+-+-+-+