+-+-+-+-+-+-+-+-+-+-+-+-+-+-+-+-+-+-+-+-+-+-+-+-+-+-+-+-+-+-+-+-+-+-+-+-+-+
|     |         |   |   |             |       |       |           |       |
+-+-+ + +-+-+-+ + + + + +-+-+-+-+ +-+ + +-+ + + +-+-+-+ +-+-+-+ + +-+ +-+ +
|   | | |     |   | | | |         |   | | | |   |   |   |     | |     | | |
+ + + + + + + +-+-+ + + + +-+-+-+-+ +-+ + + +-+-+ + + +-+ +-+ + +-+-+-+ + +
| | |   | | |     |   | |   |       |     |       | | | | |     |   |   | |
+ +-+-+-+ + +-+ +-+-+-+ +-+ + +-+-+-+ +-+-+-+-+-+-+ + + + +-+-+-+ + + + + +
|       | |   | |     |     |   | |   | |   |     |     |   |     | | |   |
+ + +-+ + +-+ + + +-+ +-+-+-+-+ + + +-+ + + + +-+ + +-+-+-+ + +-+-+-+ +-+-+
| | | | |   | | | | |     |     |   |   | |   |   |   |     |     |   |   |
+-+ + + +-+-+ +-+ + +-+ + + +-+-+ +-+ + + +-+-+ +-+-+ + +-+-+ +-+ + +-+ +-+
|   | | |     |   |   | | | |     |   | | |   |     | | |     |   | |     |
+ +-+ + + +-+-+ +-+-+ + + + + +-+-+ + +-+ +-+ +-+-+ +-+ +-+-+-+ +-+ + +-+ +
| | |     |     |   | | | | | |     | |   |       |   |     |   |   | |   |
+ + + +-+-+ +-+-+ + + + +-+ + + +-+-+ + +-+ +-+-+ +-+ +-+-+ + +-+ +-+-+ + +
| |     |   |     |   |     | | |     | |   |   |   |   |   |   | |     | |
+ + +-+-+ +-+ + +-+-+ +-+-+-+ + + +-+-+ + + + + +-+-+-+ + +-+ + + + + +-+ +
| | |     |   |   |     |   |   |   | | | |   |     |     |   |   | |   | |
+ +-+ +-+-+ +-+-+ +-+-+ + +-+-+-+-+ + + +-+ +-+-+-+ + +-+-+-+-+-+ + +-+ +-+
| |   |     |   |   |   |         |   |   |       |   |     |   | |   |   |
+ + +-+-+ +-+-+ +-+ + +-+-+-+-+-+ +-+ +-+ +-+-+-+ +-+-+ +-+ + + + +-+-+-+ +
| |     | |     |   | |         |       |     | | |     |   | | |   |   | |
+ +-+-+ + + +-+ + +-+ + +-+-+-+ +-+ +-+-+-+-+ + + + +-+-+ +-+ + +-+ + + + +
| |     | | |   | |     |     |   | |         |   |   | | |   |   |   |   |
+ + +-+-+ + +-+ + +-+-+-+ +-+-+-+ + + +-+-+-+-+-+-+-+ + + + +-+-+ +-+-+-+-+
| | |   | |   | |       | |       | |   |           | | | | |   |         |
+ + + +-+ +-+ + +-+-+-+ + + +-+-+-+ +-+ + +-+-+-+-+ + + + + + + +-+-+ +-+ +
|   |         | |   |   |   |   |   | | |   |     |     |   | |     |   | |
+ +-+-+-+-+-+-+ + + + +-+ +-+ + + +-+ + +-+ +-+-+ +-+-+-+ +-+ +-+-+ +-+ + +
|     |     |   | |   |   |   | |     | |           |   | |   |   |   | | |
+-+-+ + +-+ +-+-+ +-+-+ +-+ + +-+-+-+ + + +-+-+-+-+-+ + +-+ +-+ +-+-+ +-+ +
|     | | |     | |   | |   |       | |   |     |     |   | | |     |   | |
+ +-+-+ + +-+-+ + + +-+ + +-+-+ +-+-+ +-+-+ +-+ + +-+-+-+ + + + + +-+-+ + +
| |     |     |   |     | |   |       |   | |     |       | |   |     | | |
+ + +-+-+-+-+ +-+-+ +-+-+ + + +-+-+-+-+ + + +-+-+-+ +-+-+-+ +-+-+-+ + + + +
|   |           |   |     | | |     | | |   |   |           |     | |   | |
+-+-+ +-+-+-+-+ + +-+ +-+-+ + +-+ + + + + +-+ + +-+-+ +-+-+ + +-+ +-+-+ + +
|     |       | | |         |     |   | | |   |   |   |   | | | | |   |   |
+ + +-+ + +-+-+ + +-+ +-+-+-+-+-+ +-+-+ + + +-+-+ +-+-+ + +-+ + + + + +-+ +
| | | | |     | |   | |       |   |     | |   | |     | |     | |   | |   |
+ + + + +-+-+ + +-+ +-+ +-+-+ +-+ + +-+-+-+-+ + +-+-+ + +-+-+-+ +-+-+ + +-+
| | |     | |   |   |   |   |   | |       |   |     |   |           | |   |
+ + +-+-+ + +-+-+ +-+ +-+ +-+-+ +-+-+-+ + + +-+-+ + +-+-+ + +-+-+-+ + +-+ +
| |     |   |   | |   |     |   |     | | | |   | |       | |       | |   |
+ +-+-+ +-+-+ + + + +-+ +-+ + +-+ +-+ +-+ + + + +-+-+-+ +-+ +-+-+-+ + + +-+
|   | |       | | | | |   | | |   |       |   |       |   | |     | | | | |
+-+ + +-+-+-+-+ + + + +-+ + + + +-+ +-+-+-+ +-+-+-+-+ +-+-+ + +-+ +-+ + + +
| |     |   |   |   |   | | | | |   |   |   |       |       |   | |   | | |
+ +-+-+ +-+ + +-+-+-+ +-+ + + + +-+-+ + + +-+ +-+-+ + +-+-+ +-+ + + +-+ + +
|     | |   | |           | | |       |     | |   | | |   | |   |   |     |
+ + +-+ + +-+ + +-+-+-+-+-+ + +-+-+ +-+-+-+-+ + + + +-+ + +-+ + +-+-+-+-+-+
| |   |   |   | |   |     | |     |       |   | | |     |   | | |         |
+-+-+ + +-+ + + + + +-+-+ + +-+-+ +-+-+ +-+ +-+ +-+-+-+-+-+ + +-+ +-+-+-+ +
|   |   |   | | | |     | |     |     | |   | |       |     |   | |   | | |
+ + +-+-+ +-+ + + +-+-+ + +-+ +-+-+-+ +-+ +-+ + +-+-+ + +-+-+ + + + + + + +
| |     | |   | | |   | |   |   |     |   |   | |     |   | | | |   |   | |
+ +-+-+ + + +-+ + + + + + +-+-+ + +-+-+ +-+ + + + +-+ +-+ + + + + +-+-+ + +
| |       |   | |   | |   |   | |       |   |   | | | |   |   |   |   | | |
+ + +-+-+-+-+-+ +-+-+ +-+ + + + +-+-+-+-+ +-+-+-+ + + + +-+-+-+-+-+ + +-+ +
| |   |   |   | |     |   | |           | |   |   |   |             |   | |
+ +-+ + + + + + + +-+-+-+-+ +-+-+-+-+-+-+ + + + +-+ +-+-+-+-+-+-+-+-+-+ + +
|   | | |   | | |         |               | |   | |       |       |   |   |
+-+ + + +-+-+ + +-+ +-+-+ +-+-+-+-+-+-+-+-+ +-+-+ +-+-+ +-+ +-+ + + +-+-+ +
|   | |   |   |   |     |   |       |     |   |         |   |   |   |   | |
+ +-+-+-+ + + +-+ +-+-+-+ + + +-+-+ + + + +-+ +-+ +-+-+-+ +-+ +-+-+-+ + + +
|   |     | |   |       | | | |   |   | |   |   | |       | |         |   |
+-+ + +-+-+ +-+ +-+-+-+ + + + + + +-+-+ +-+ +-+ +-+ +-+-+-+ +-+-+-+-+-+-+-+
|   |   | |   | | |     | |   | |   |   | | | | |   |         |           |
+ +-+-+ + +-+ + + + +-+-+-+-+-+ +-+ + +-+ + + + + +-+-+ +-+ +-+ +-+ +-+-+ +
|     |   | | |   |     |     | | |   |   | | | |     | |   |     | |   | |
+ +-+ +-+ + + + +-+-+-+ + +-+ + + +-+-+ + + + + +-+-+ +-+ +-+ +-+-+ + + + +
| | |   |   | | |     |   | |   | |   | | |   | |   |   |     |   | | |   |
+ + + +-+-+ + +-+ +-+ +-+-+ +-+-+ + + + + +-+ + + + +-+ +-+-+-+ + + + +-+-+
|   |       |       |               |   |     |   |             |   |     |
+-+-+-+-+-+-+-+-+-+-+-+-+-+-+-+-+-+-+-+-+-+-+-+-+-+-+-+-+-+-+-+-+-+-+-+-+-+