+-+-+-+-+-+
|         |
+ + + +-+ +
| | |   | |
+ +-+ + + +
| |   | | |
+ +-+ + + +
|   | | | |
+ + +-+ +-+
| |   |   |
+-+-+-+-+-+