+-+-+-+-+-+-+-+-+-+-+-+-+-+-+-+-+-+-+-+-+-+-+-+-+-+-+-+-+-+-+-+-+-+-+-+-+-+-+-+-+-+-+-+-+-+-+
|       |   |   |   |         |     |     |         |       |         |               |     |
+-+-+-+ + + + + + + +-+ +-+-+ +-+ +-+ + + +-+ + +-+-+ + +-+ + + +-+-+ +-+-+ +-+-+-+-+ +-+-+ +
| |   |   |   |   |   | |   |   |     | |   | |     | | |     | |   | |     |     | |   |   |
+ + + +-+-+-+-+-+-+-+ + + + +-+ +-+-+-+ +-+ + +-+-+ + + +-+-+-+ + + + + +-+-+ +-+ + +-+ + +-+
|   |           |   | |   |   |       | | | |   |   | |       | | | |   |       | |   | |   |
+ +-+-+ + +-+-+-+ + + + +-+-+ +-+-+-+ + + + +-+ + +-+ +-+-+-+ + + + +-+-+ +-+-+ + + +-+ +-+ +
|   |   | |       |   |     | |   |   | |   |   |   | |   | | | | |       |   | | |   |   | |
+-+-+ +-+-+ +-+-+-+-+-+-+-+ + + + + +-+ + +-+-+ +-+ + + + + + +-+ +-+-+-+-+ + +-+ + + +-+ + +
|     |     |         | |   |   | |   | |     |   | | | | | | |   |   |     |     | |   |   |
+ +-+-+ +-+-+ +-+-+ + + + +-+-+-+ +-+ + +-+-+ +-+-+ + + + + + + +-+ + + +-+-+-+-+-+ +-+ +-+ +
|       | |   | |   | | |   |   | | |   |   |     | | | |   |   |   | | |   |     | | |   | |
+ +-+-+-+ + +-+ + +-+ + +-+ +-+ + + +-+-+ + +-+-+ + + + +-+-+-+-+ + +-+ + + + + +-+ + + +-+ +
|       | | |   | |       | |   | |       |         | |           | |   | | | |   |   |     |
+-+-+-+ + + + + + +-+-+-+-+ + + + +-+-+-+-+-+-+-+-+ + + +-+-+-+ +-+ + +-+-+ + +-+ +-+ +-+-+-+
|   |   |     | |       |   | | | |   |     |   |   | | |     | |   | |     | | |     | |   |
+ + + +-+-+-+-+ +-+-+-+ + +-+ +-+ + + + +-+ + + +-+ + +-+ +-+ + + +-+ + +-+ + + +-+-+-+ + + +
| | | |     | |       | |   | |   | | |   |   |   | |   |   |   |   | |   | | |       |   | |
+ +-+ + +-+ + +-+ +-+-+ +-+ + + +-+ + +-+ +-+-+-+ +-+-+ +-+ + +-+-+ + +-+ +-+ +-+-+ +-+ +-+ +
|   | | |   |     |       | | |     |   |   |     |   | |   | |   | | |   |   |   |   | |   |
+-+ + + + +-+ +-+-+ +-+-+-+ + +-+-+-+-+ +-+ + + +-+ + + + +-+-+ + +-+ + +-+ +-+ + +-+ + + + +
|   |   | | | |   | |                 |     | | |   |   |     | |   | | |   |   |   |   | | |
+ +-+-+-+ + + +-+ + + +-+-+-+ +-+-+-+ +-+-+ + +-+ +-+-+-+-+-+ + +-+ + + + +-+ +-+-+ + +-+ +-+
| |     | | |   | |   |     | |     | |   | |     | |         |   |   |   |   |   | |   |   |
+ + +-+ + + +-+ + +-+-+ +-+ + + +-+ +-+ + +-+ +-+-+ + + +-+-+ +-+ +-+-+ +-+ +-+ +-+ +-+ +-+ +
|   |   | |   |       | | | | |   |   | |   |     |   | |     |   |         |     | |   |   |
+ +-+ +-+ + +-+-+-+-+ + + + + +-+ +-+ + +-+ +-+-+ +-+-+ +-+-+ + +-+-+-+-+-+-+-+ + + + +-+ + +
| | |     | |       | | |   |   |   | | | |     |       |   | | |             | |   | |   | |
+ + +-+-+-+ + + +-+-+ + + +-+-+-+ + + + + +-+-+ +-+-+-+ + + +-+ + +-+-+-+-+ + +-+ +-+-+ +-+ +
|   |     |   |       | |       | | |   |     |   |     | |   |     |     | |   | |     |   |
+-+ +-+-+ + +-+-+-+-+-+ +-+-+-+ +-+ +-+-+ +-+ +-+ +-+-+ + +-+ + +-+-+ +-+ +-+ + + + +-+-+ +-+
|   |   |   |     |   |   |   |   |     |   |   |     | | | | |   |   | |   | | |   |   |   |
+ +-+ + + +-+ +-+ + + +-+ + + +-+ +-+-+ + +-+-+ +-+-+ +-+ + + +-+-+ +-+ +-+ + + +-+-+ + +-+ +
| |   | | |     | | | |   | |   |       | |     |   |   | | |     |   |     | |     | |   | |
+ + +-+ + +-+ + + +-+ + +-+ + +-+-+-+-+-+ + +-+ +-+ +-+ + + +-+-+ +-+ + +-+-+-+-+ + +-+ + + +
|   |   |   | | | |   |   | |             | | | |     |   |   | |     |         | |   | | | |
+-+-+ +-+-+ +-+ + + +-+-+ +-+-+-+ +-+-+ +-+ + + + +-+-+-+-+ + + +-+-+-+-+-+-+-+ +-+ + + + + +
|   | | |   |   |   |     |     | |   | |   |   |   |     | |     |           |   | | | |   |
+-+ + + + +-+ +-+-+-+ +-+-+ +-+ +-+ + +-+ +-+ +-+-+ + + + + +-+-+ + +-+-+ +-+-+-+ +-+ +-+-+-+
|   | |       |       |     | |     |     | | |   |   | |   |   | | |     |   |   |   |     |
+ +-+ +-+-+-+-+ +-+-+-+-+ +-+ +-+-+-+-+-+-+ + + + +-+-+ +-+-+ +-+ + +-+-+-+ + + +-+ +-+ +-+ +
|     |         |         |       |   |       | |       | |       |     |   |   |       |   |
+ +-+-+ +-+-+-+-+-+-+-+ +-+ +-+-+ + + + +-+-+-+ +-+-+-+-+ + +-+-+-+-+-+ + +-+-+-+ +-+-+-+ +-+
|     | |   |         |   | |   | | |           |       |   |   |       | | |           |   |
+-+-+ + + + +-+ +-+-+ + + +-+ + + + +-+-+-+-+-+-+-+ +-+ + +-+ + + +-+-+-+ + + +-+-+-+-+ +-+ +
|   | |   |   | |   | | |   | | |   |   |           |   | |   |   |     | |   |   |   | | | |
+ + + + +-+-+ + +-+ + +-+-+ + + + +-+ + + +-+-+ +-+-+-+-+ + +-+-+ + +-+ + +-+-+ + +-+ + + + +
| | | | |     |   |       |   | | |   | |     |         | | | |   | | | |       |   |     | |
+ + + +-+ +-+-+ + +-+-+-+ +-+-+ + + +-+ +-+-+ +-+-+-+-+ + + + + +-+ + + +-+-+-+-+-+ +-+-+-+ +
| |   |   |   | |   |   |       | | | |   | |         |   | |   |   | |       |   |     |   |
+ +-+-+ +-+ + + +-+ +-+ +-+-+-+ +-+ + +-+ + +-+-+-+-+ +-+-+ +-+-+ +-+ + +-+-+-+ + +-+-+ + +-+
|   |   |   |     |   |         |   |   | |   |     | |     |   | |   |     |   | |   | |   |
+-+ +-+ +-+-+-+-+ +-+ +-+-+-+-+ + +-+ + + + + + +-+ + +-+ + + + + + + +-+-+ + +-+ + + + +-+ +
| |   |       | | | |         | | |   | | | | |   |       | | |   | |   | |   | |   | |   | |
+ +-+ +-+-+-+ + + + +-+-+-+-+ + + + +-+ + + +-+ +-+-+-+-+-+-+ +-+-+ +-+ + +-+-+ +-+-+ +-+ + +
|   | |       |     |       | | | |   | | |     |             |     | |   |   |     |     | |
+ +-+ + +-+-+-+-+ +-+ +-+-+ + +-+ +-+-+ + + +-+-+ +-+-+-+-+-+-+ +-+-+ +-+ + + + +-+ +-+-+-+ +
|   | | |       | |   | |   |           | | |   |   |       |   |       | | | | | |         |
+ + + + + +-+-+ +-+ +-+ + +-+-+-+-+-+-+ + +-+ + +-+ + +-+-+ + + +-+-+ +-+ + +-+ + + +-+-+-+ +
| |   |   |   | |   |   |   |   |       |     |     | | |   | |     | |   |   | | |       | |
+ +-+-+ +-+ + + + +-+ + +-+ + + + +-+-+-+-+-+-+-+-+-+ + + +-+-+-+-+ + + +-+-+ + + +-+-+-+ +-+
| |       | |   | |   | | |   | |     |         |     |   |         | |     |           |   |
+ +-+-+-+ + +-+-+ + +-+ + +-+-+ +-+-+ +-+ +-+ +-+ +-+ + +-+ + +-+-+-+ +-+-+ +-+-+ +-+-+-+-+ +
| |   |   | |     | |   |   |   |   |   | | |   |   | | | | |     |       |   | | |         |
+ + + + +-+ + +-+-+ +-+ + + + +-+ + +-+ + + +-+ +-+ + + + + +-+-+ +-+ + + +-+ + + + +-+-+-+ +
|   | | |   | |       | | | |     | | | |   | | |   | | |     | |   | | | |   |   |       | |
+-+-+ +-+ +-+ +-+-+-+ + + + +-+-+-+ + + +-+ + + + +-+ + +-+-+ + +-+ +-+ +-+ +-+-+-+-+-+-+ + +
|   |   | |   |   |   |   | |     | |   |     |     | |     |     |   | |   |     |   |   | |
+ +-+-+ + + +-+ + + +-+-+-+ + +-+ + + +-+-+-+-+ +-+-+ +-+-+ +-+ +-+-+ + + +-+ +-+ + + + +-+ +
|     | | | |   |   |   |   | | |   |   |     | |     |   |   | |     |   |   |     |   |   |
+ + + + + + + +-+-+-+ +-+ +-+ + +-+-+-+ + +-+ + + +-+-+ + +-+ +-+ +-+-+ +-+ + +-+-+-+-+-+ +-+
| | | | |   |     | |       | |   |   |   | | | |   |   |   |     |     |   | |         |   |
+ + +-+ + +-+-+-+ + + +-+-+-+ + + +-+ +-+-+ + +-+ + + +-+-+ +-+-+-+ +-+-+ + +-+ +-+-+-+ +-+ +
| |     |         |   | |     | |           |   | | | |   |       | |     | |   |     |   | |
+ +-+-+-+-+-+-+-+-+ +-+ + +-+-+ +-+-+ +-+-+-+-+ + + + +-+ + +-+-+-+ + +-+-+ + +-+ +-+ +-+ + +
|   | |       |   | |   | | |   |   | |     |   | | |   | |   |     |   |   | |     |   | | |
+-+ + + +-+-+ + + + + +-+ + + + + + + + +-+ + +-+-+ +-+ + +-+ + +-+-+ + + +-+ +-+-+-+ +-+ + +
|   |       | | |     |   | | |   | | | | |   |     |   |   |   |     | |   |       |   | | |
+ +-+-+-+-+ + + +-+-+-+ +-+ + +-+-+ +-+ + +-+-+ + +-+ +-+ +-+-+-+ +-+-+ +-+ +-+-+-+ + + + + +
| |   |     |       |   |   |     |     |       | | |   |         |   |   |   | |   | | | | |
+ + + +-+-+-+-+ +-+-+ +-+-+ +-+-+ +-+-+-+-+-+-+ + + +-+ + +-+-+-+-+-+ +-+ +-+ + + +-+ + + + +
|   |         | |     |   |   | |       |     | | |   | | |           | | | |   |   | | | | |
+-+-+-+-+-+-+ + + +-+-+ + + + + +-+-+-+ + +-+ +-+ + +-+ + + +-+-+-+-+ + + + +-+ +-+ +-+ + + +
|     |       | | |     |   |       |   |   |     |   | |   |         | | |       | |   | | |
+ +-+ + +-+-+-+-+ +-+ + +-+-+-+-+-+-+ +-+ + +-+-+-+-+ + +-+-+ +-+-+-+-+ + +-+ +-+-+ + + + + +
| |   | |       |   | |     |   |   |   | |         |   | |   |   |     |   |   |   | | | | |
+ + +-+ + +-+-+ + + + +-+-+ + + + + +-+ + +-+-+-+-+ + +-+ + +-+ + +-+ + +-+ + +-+ +-+ + + +-+
| | |   | | |   | | |     | | | | |     | | |     | |   |       |   | |   | | |       | |   |
+ + + +-+ + + +-+-+ +-+-+ + + + + +-+-+-+ + + +-+ + +-+ +-+-+-+-+-+ + +-+-+ +-+ +-+-+-+-+-+ +
| |   |   | | |     |   | | | | |   |       | | | |   | |         |   |   |     |           |
+ +-+-+ +-+ + + +-+-+ +-+ + + + +-+ +-+-+-+-+ + + +-+ + + +-+-+-+ +-+-+ + +-+-+-+ +-+-+-+-+ +
|       |       |         |   |               |       |   |             |         |         |
+-+-+-+-+-+-+-+-+-+-+-+-+-+-+-+-+-+-+-+-+-+-+-+-+-+-+-+-+-+-+-+-+-+-+-+-+-+-+-+-+-+-+-+-+-+-+