+-+-+-+-+-+-+-+-+-+-+
|                   |
+-+ + +-+ + +-+ + + +
|   |   | | |   | | |
+-+-+ + + + + + + + +
|     | | | | | | | |
+ + +-+-+ + + +-+ + +
| |     | | | |   | |
+ +-+ +-+ +-+ + +-+ +
|   |   |   | |   | |
+ + +-+ + +-+ + + + +
| |   | |   | | | | |
+ + +-+ + + + + + + +
| |   | | | | | | | |
+ + +-+ + + + + + + +
| | |   | | | | | | |
+ +-+ + + + + + + + +
|   | | | | | | | | |
+ + + +-+ + +-+ + + +
| | |   | |   | | | |
+-+-+-+-+-+-+-+-+-+-+