+-+-+-+-+-+-+-+-+-+-+-+-+-+-+-+-+-+-+-+-+-+-+-+-+-+-+-+-+-+-+-+-+-+-+-+-+-+-+-+-+-+-+-+-+-+
| |           |     |                 |   |   |                 |   |   |     |           |
+ +-+-+-+-+ + + + +-+ +-+-+-+-+-+ +-+ +-+ + +-+-+ +-+-+ + +-+-+-+ +-+ +-+-+ + +-+ + + +-+-+
| | | | |   |   | | |         |   | | | |   |   |     | |         |       | | |   | |   | |
+ + + + + + +-+ + + +-+ +-+-+-+-+ + + + +-+ + +-+-+-+ +-+-+ +-+-+-+ + +-+ + +-+ +-+ +-+-+ +
|   |   | |   | | | |       |     | | |       | |     | |   | |     | | |     |   |   |   |
+-+ + +-+-+ +-+-+-+ +-+ + +-+ + + + +-+-+ + +-+ +-+ +-+ + +-+ + + + + + +-+-+ +-+ +-+-+ + +
|         |     |       | |   | |         | | |         |   |   | | |   |   |           | |
+ + +-+-+ + + +-+-+-+-+ +-+-+ + +-+-+-+-+ +-+ +-+ +-+-+ + +-+-+-+-+-+-+ +-+ + + + + +-+-+ +
| |     |   |   |       |   | |     |             |   | | |   |   | |   |     | | |   | | |
+ +-+-+ +-+-+ + + + +-+ + +-+-+ + +-+ +-+-+ +-+-+-+ +-+ +-+ +-+ +-+ +-+-+-+-+ +-+ +-+-+ +-+
| | | | |     | | | | | |   |   | |     |     |   |     | |     |     |   | | |       | | |
+ + + + +-+ + + + +-+ +-+ +-+ + +-+-+-+-+-+ +-+-+ +-+ +-+ +-+ +-+-+-+ +-+ + +-+ + + +-+ + +
| |     | | | |       | |     | | |       | |   | |       |   |   | |   |       | | |     |
+ +-+-+-+ +-+-+-+ +-+-+ + +-+-+-+ + + +-+ +-+ +-+ +-+-+-+ +-+ +-+ + + + +-+-+ + +-+-+-+ + +
| | |     |   |   |   |     |   | | |   |   |   | |       |         | | |     |   | |   | |
+-+ +-+ +-+ + +-+-+ +-+ +-+-+ + + + +-+ +-+-+ +-+ +-+-+ +-+-+ +-+-+-+-+ +-+ +-+-+-+ + +-+-+
|   |   |   | | |     |   |   | |     |     | |         |     | |       |   |     | |     |
+ +-+ + +-+ +-+ +-+ + +-+ + +-+ + + + +-+ +-+ +-+ +-+ +-+ +-+ + +-+-+ + + +-+ +-+-+ + + +-+
| |   | |   |       |   | | |   | | | | | |         |   | |     |   | |         |   | |   |
+ + +-+ + + +-+-+-+-+ + +-+ + +-+-+ + + + + +-+-+-+-+-+-+-+-+ + + +-+ + + + +-+-+-+ +-+ +-+
|   |   | |   |   |   |   | |   | | | |   |         | |       |   | | | | | |         |   |
+-+-+-+ +-+-+ + +-+-+ +-+-+-+ +-+ + +-+-+ +-+ +-+-+-+ +-+-+ + + + + + +-+-+-+ + +-+-+ + +-+
|   |   | |     |     | |     |   |   |   |       |         | | |         |   |   |   |   |
+ +-+-+ + +-+ +-+ +-+-+ + + +-+ +-+-+ +-+-+ +-+ + + + +-+-+-+-+-+-+ + + + +-+ +-+-+ +-+ +-+
|       | | |         | | |       | |     | |   | | | |   | |       | | | | |   |         |
+-+ +-+ + + +-+ +-+-+-+ + + +-+ + + + +-+ +-+ +-+ +-+ + +-+ +-+ + +-+-+ +-+ + +-+ +-+ +-+-+
|     |     |       |     |   | |     | |     | | |     |     | | | |     | | |   |       |
+ +-+-+ +-+ +-+ +-+-+-+ +-+ +-+ +-+-+ + +-+ + + +-+-+-+ +-+-+ + + + +-+-+ + + +-+ +-+ + +-+
| | |   | | |   |   |   | |   | |       | | |     |   |   |     | |     |       | |   |   |
+-+ +-+-+ + +-+ + + + + + +-+-+-+-+-+-+-+ + + +-+ +-+ + + +-+ + +-+ +-+-+ +-+-+-+ +-+-+ +-+
|   |         | | |   |   | |     |     | | | |     |   | |   | |       | |     | | |     |
+ +-+-+ +-+-+-+ + +-+ + +-+ +-+ +-+-+ +-+ + +-+-+ + + + + + + +-+-+-+-+ +-+-+-+ +-+ +-+-+ +
| |           |   |   |     |         | |       | |   | | | |   |     | |             | | |
+ + + +-+-+ + +-+-+-+-+ +-+-+-+ + + +-+ + +-+-+ +-+-+ + +-+-+ + + + +-+ +-+ +-+ +-+ + + + +
| | | |     |             | |   | |     |   | |   | | | |     |   | |     | |   |   | | | |
+ +-+-+ + + + +-+ + +-+-+-+ +-+ +-+ +-+ + +-+ +-+-+ +-+ +-+ + +-+ +-+-+-+ +-+-+-+-+ +-+ +-+
|     | | | | |   |   | |       |     |   |   | |     | | | |   |   |       |   |   |   | |
+ +-+ + + +-+ +-+-+-+ + + + +-+-+-+-+-+ +-+ + + +-+ + +-+ + + + +-+-+-+-+ +-+-+ + + + +-+ +
| | |   |   | |   | | |   |   |         |   | |     | |   | | |     |       |     | | | | |
+ + + +-+ + + +-+ + +-+-+-+-+ +-+-+-+ +-+-+ +-+ +-+-+-+ + + + +-+-+ +-+ + +-+-+ + + + + + +
|   | |   | | |   |     | |         |   | |   |   |     |   | | |   | | |     | | |       |
+ + + +-+ +-+ + +-+ +-+-+ + + + +-+ +-+ + + + + +-+-+-+ +-+ +-+ +-+-+ +-+ +-+ + +-+ + +-+ +
| | | | | | |       | |     | | |   |     | | |       | |   | |     |   |   |   |   | |   |
+ + + + +-+ + +-+ + + +-+-+-+-+-+-+-+-+ + + +-+-+-+ +-+-+-+ + +-+-+ + + +-+-+-+-+-+ + + + +
| | | | |   | |   |     |       | |   | |         |         |       | | |   |   |   | | | |
+ + +-+ +-+ + +-+-+-+-+ +-+-+ +-+ + + +-+ +-+-+ +-+ +-+-+-+ +-+ + + + +-+ +-+ + +-+ +-+-+-+
| |   |     | |     |   | |     | | |   | |     | |   |     |   | |     |     |       |   |
+-+-+-+-+ +-+ + + +-+ +-+ +-+ +-+ + + +-+-+ + +-+ +-+ +-+-+ +-+ +-+ +-+ +-+-+-+-+-+ +-+ +-+
|   |         | |           | |   | |   |   |     |   |       | | | |   |         | | |   |
+ + +-+ +-+ + +-+ +-+ + +-+-+ + + + +-+ + +-+ +-+-+-+-+-+ +-+-+ + +-+-+ +-+-+-+ +-+ + + +-+
| | | | | | | |   | | |       | | |   |   |     |       | | |   |             |     |     |
+-+ + + + + +-+ +-+ +-+-+ + + + +-+-+-+ +-+-+ + + +-+-+ + + +-+-+ + + +-+-+-+ +-+-+ + +-+-+
|       |     |   |       | |     | |       | | | |   |   |   |   | | | | |   | |       | |
+-+-+ +-+-+ +-+-+-+-+-+-+-+-+-+-+-+ + +-+-+-+-+-+-+ +-+-+-+ + +-+ +-+-+ + +-+ + +-+ +-+-+ +
|     |   | |   |   | |     | | |           |   |       |   | |     |   |   |   | |     | |
+-+-+-+-+ + +-+ + + + +-+-+ + + +-+-+ + + +-+ + +-+-+ +-+ +-+-+-+-+ + + + +-+ +-+ + +-+-+ +
| |           | | |   |   | |     |   | | |   |   |         |   |   | | | | |   |     |   |
+ + +-+ +-+ + + + +-+ +-+ + +-+-+ +-+-+ + + +-+-+-+-+ + +-+ + +-+-+-+-+ + + +-+ + + +-+ + +
|     |   | | |     |   |     |       | |   |   | |   | | | |       |       |     |     | |
+ +-+ +-+-+ +-+-+-+ + +-+-+ +-+-+ +-+-+ +-+-+-+ + +-+ +-+ +-+ +-+ +-+-+ +-+-+-+ +-+-+ +-+-+
| |   | | | |       |     |       |       |     |               |   | |   |   | | |       |
+ +-+ + + +-+ +-+ + +-+-+-+-+ +-+-+-+-+-+ + +-+-+ +-+-+-+-+-+-+-+ +-+ +-+ + +-+ + + + + +-+
|   |       |   | | |       |     |   |         | |   |         |         |       | | |   |
+-+-+-+ +-+ + +-+-+-+-+ + +-+ +-+ +-+ +-+-+-+ +-+ +-+ + + +-+ + +-+ +-+-+-+-+-+ + +-+-+ +-+
|   | | |         | |   | | |   | |   | |   | | |   | | |   | |   | |     |     | |       |
+ +-+ + +-+ +-+-+-+ +-+-+ + +-+ +-+ +-+ + +-+ + + +-+ +-+-+-+-+ +-+ +-+ + +-+ +-+ +-+-+-+ +
| |       |     |       |   |     |                 |   |       |   | | |     |   |     | |
+ +-+ + +-+ + + + +-+ +-+-+ +-+ + +-+ +-+-+-+ + + +-+ +-+-+-+-+ + +-+ +-+ +-+-+ + + + +-+ +
|     |   | | | | | | | |     | |   |       | | | |         |         |     |   | | | | | |
+ +-+-+ +-+ + +-+-+ + + +-+ + + +-+-+ +-+ + + +-+ +-+ +-+ + + +-+ +-+-+-+-+ +-+-+ +-+ + +-+
| | |     | |   |       | | | | |       | | |   | | | | | |     |   |       |   | |   | | |
+ + +-+ +-+-+ + +-+-+ + + +-+ + +-+ + +-+-+-+-+ +-+ + + + +-+ +-+ +-+ +-+ +-+ +-+-+-+ + + +
|   |   | | | | |     |   |     | | | | | | | |   | | |   |   | |       |                 |
+ +-+ +-+ + + +-+-+ +-+-+ +-+-+ + + +-+ + + + +-+-+ + + +-+ +-+ + +-+-+-+ +-+ +-+ +-+ + + +
|   | | |   |     | |           | |         |     |   | |   |         |   |   | | | | | | |
+-+-+-+ +-+ +-+-+ +-+-+-+-+ +-+ + + + + + +-+ +-+-+ +-+-+ + +-+ +-+-+ + + +-+-+ + + + +-+ +
| | |         |             |   | | | | |     |         | | | | |   | | | |       | |   | |
+ + +-+-+ +-+-+-+-+ +-+ +-+ + +-+ +-+ +-+-+-+ + +-+-+ +-+-+-+ +-+-+ +-+-+ + +-+-+-+ + + + +
|   |             | |     | |     | | |   |   |   | | |   |               |       | | | | |
+ + +-+ + +-+ + + + +-+-+-+ +-+-+-+ + + +-+ +-+-+ + +-+ +-+-+ + + +-+-+-+-+-+ +-+ + + +-+-+
| | |   |   | | |   |     |   |   |   | |   |       |     |   | |   |         |   | |     |
+-+ + + +-+-+-+-+-+ + +-+ + +-+ +-+-+-+ +-+-+-+-+ + + +-+-+-+-+ + + + + + +-+ +-+-+ +-+-+-+
| |   |     |       |   |   |       |       |     | | | |   |   | | | | |   |           | |
+ + + +-+-+-+-+ +-+ +-+-+-+ +-+-+ +-+-+-+ + +-+-+-+ + + + +-+ +-+-+-+ +-+-+-+-+ + +-+ +-+ +
| | |     |   | | | | |   | |   |     | | | | |   |       |   |     |   |   |   |   |     |
+ +-+ + +-+-+ + + +-+ + +-+ +-+ + +-+ + + +-+ +-+ +-+ +-+ +-+-+ +-+ + + + +-+-+-+-+ +-+-+ +
|     | | |           |   | |       | |           | | | | | |   | | | | |   |     |     | |
+ +-+-+ + + + +-+-+ +-+ +-+ + +-+-+ + + + + +-+-+ + + + +-+ + +-+ + +-+ + +-+-+ + +-+ + +-+
|   |     | | |           | |   |   |   | | |               | |         |       |     |   |
+-+-+-+-+-+-+-+-+-+-+-+-+-+-+-+-+-+-+-+-+-+-+-+-+-+-+-+-+-+-+-+-+-+-+-+-+-+-+-+-+-+-+-+-+-+