+-+-+-+-+-+-+-+-+-+-+-+-+-+-+-+-+-+-+-+-+-+-+-+-+-+-+-+-+-+-+-+-+-+-+-+-+-+-+-+-+-+-+-+-+-+-+-+-+-+-+
| | |       | |     |   | |   |     |       |   | | |       | |       |   | |     |   |           | |
+ + + + +-+-+ + +-+ +-+ + + +-+ + + +-+-+ +-+ +-+ + +-+ +-+ + + +-+ + +-+ + +-+ +-+ +-+-+-+ + +-+-+ +
| |   | |     | |       | |   | | |     |     | | |     |     | |   |     |   |   |   |   | |   |   |
+ +-+ + + + +-+-+-+-+ +-+ +-+ +-+ +-+ +-+ + +-+ + + + +-+-+ +-+-+ +-+-+ +-+ +-+-+ + +-+ +-+-+ + + + +
|     | | | |     |     | | |   |   | | | |   |   | |     |   |   |   | |   | |   |       |   | | | |
+-+ + + + +-+ +-+-+ +-+ + + + + +-+-+ + + +-+-+ + + + + +-+-+-+-+ +-+ +-+ +-+ +-+ + + +-+-+ + +-+ +-+
| | | | |   | |     |   | | | |   |     |   |   | | | |   | |           | |         | |     |       |
+ + + +-+-+ + + +-+-+-+-+ + +-+ +-+ +-+-+ +-+-+ +-+-+-+ +-+ +-+ +-+ +-+-+ + +-+-+ +-+-+-+-+ +-+ + + +
|   |   | | |   |   |   | |   |       |     |   |   |   |     |   | |       | | | |     |     | | | |
+-+ +-+-+ + + +-+-+ + + + +-+ +-+-+ + + +-+-+ +-+-+ +-+ +-+ + + +-+ +-+-+ + + + +-+-+-+ +-+-+ +-+ +-+
|       |       |     | | |   |     | | | |               | |     |   | | |       | | | | |     | | |
+ + +-+ +-+ +-+ +-+ +-+-+ + + + +-+-+ + + + +-+-+-+-+ + +-+-+-+ +-+ +-+ +-+ +-+-+-+ + + + + + +-+ + +
| | | | | | |   |   | |     | |   |     |       |     | |   |   |   |     |     |     | | | | |     |
+-+ + + + + +-+-+ + + + + + +-+-+ +-+-+ +-+ + + +-+ +-+ + + + +-+-+ +-+-+ +-+ + +-+ +-+ + + +-+ +-+-+
| | |     | |   | | |   | |     | | |     | | | | | |   | |   | | | |   |     | | | | |       | | | |
+ +-+ + +-+ + + + + +-+-+-+ +-+-+ + + +-+-+-+-+ + +-+-+-+-+ +-+ + + + +-+ +-+ + + + + +-+-+-+ +-+ + +
|   | |   |   |   |   | |     |     |     |       | | |   |   |           |   |   | |     | |   |   |
+-+ +-+ + + + +-+-+ + + +-+ +-+ +-+ +-+ +-+-+ + +-+ + + +-+ +-+-+-+-+-+ +-+-+ +-+ + + + +-+ + +-+ + +
|     | |   | |     | |   |   |   | |     |   |     |   |       |       |     |     | |       |   | |
+ +-+-+-+ +-+-+-+ +-+-+ +-+ +-+-+-+-+-+-+ +-+-+-+ + + + + + +-+-+-+-+-+ + +-+-+-+ +-+-+-+ + + + +-+-+
|     |   |   | |   |       |       | |         | |   |   |     |   | | |     |     |     | |   |   |
+-+-+ + + +-+ + +-+ +-+ +-+ + +-+-+-+ + +-+-+ + +-+ +-+-+ +-+-+ +-+ + + +-+-+-+-+ +-+ + + + + +-+ +-+
| |     | | |   |   |   |   | |   | | |   | | |     |   | | |     |         |         | | | | |     |
+ + +-+-+-+ + +-+-+ + +-+-+-+ +-+ + + + +-+ + +-+-+ + +-+-+ + +-+-+ +-+-+-+-+-+-+ + + +-+-+ + +-+ + +
|   |           |       | | |   | |   |     | |     | | | |   | |     |           | | |   | |     | |
+ +-+ +-+-+ + + +-+ + +-+ + + +-+ + +-+ +-+ +-+ +-+ + + + +-+ + +-+-+-+ + +-+ + +-+-+-+ +-+ + +-+ +-+
| |   |   | | | |   |       | | | | | | | | |     | |   |     | | |   | | |   |   |       | | |   | |
+-+ + +-+ +-+-+-+-+-+ +-+ +-+ + + + + +-+ +-+-+-+ +-+ +-+-+ +-+ + + +-+-+-+-+-+-+-+-+-+ +-+ +-+-+ + +
|   | | |         |   |       | |                         | |       |             | |   |   | |   | |
+-+ +-+ + + + + + +-+-+-+ +-+-+ +-+-+-+-+ +-+-+-+-+ +-+-+ +-+ +-+-+-+ +-+ +-+-+-+-+ +-+ + + + +-+ + +
|   | |   | | | |   | | |   |   | |               | |   |             | |     |     | | | |   |     |
+ + + + + +-+-+ +-+-+ + +-+ + +-+ +-+ +-+-+ +-+ + + + +-+ +-+-+ +-+-+-+ +-+ +-+ + + + + +-+ +-+-+-+-+
| |     | | | | |   |       |   | |   | |   |   | |   |     |     |   |     |   | | |   |   |   |   |
+ + + + +-+ + +-+-+ +-+-+ + + +-+ +-+ + + +-+-+ + +-+ +-+-+-+-+-+-+-+ +-+ +-+-+ +-+-+ + +-+ +-+ +-+ +
| | | | | |   |         | | |   |       | |   | |   | |     |   |   |     | |         | | |         |
+-+-+ + + + +-+ + +-+-+ +-+ + +-+-+-+-+-+-+ +-+ + + +-+ + +-+-+ + + +-+-+ + +-+ + + +-+ + +-+-+ +-+-+
| |   | |   | | |   |   | | | |       |   |     | |     | |       |     |       | |   | | |         |
+ +-+ +-+ + + + +-+-+ +-+ + + + + +-+-+-+ + +-+-+-+-+-+-+ +-+-+ +-+-+ +-+-+ +-+-+ + +-+-+ +-+-+ +-+-+
|   |   | | |   |   |   |       |   |         |     | | |   | | | | |           | | | | | | |   |   |
+-+ + + +-+ + + + +-+-+-+-+-+ +-+ + +-+ +-+-+-+-+ + + + +-+-+ + + + + + +-+-+ +-+-+ + + + + + +-+ + +
|   | |       |   | | |     | | | | |   | |   | | |   |     |   |     |   | | | |         |   | | | |
+ +-+-+-+ +-+ + + + + +-+ +-+ + + + +-+ + + + + +-+ + +-+-+ + +-+-+-+-+ +-+ +-+ +-+ + +-+-+-+ + + + +
|   |     | | | |       | | | | | | | |   | |   |   |   |         | | |   |   |     | | |         | |
+ + +-+-+-+ +-+-+ +-+ +-+ + + + + +-+ +-+-+-+ + + +-+-+ + +-+ +-+ + + +-+-+ + + +-+-+ + +-+-+-+-+-+ +
| |       |     |   |   | |     | | |       | |   |         | | | | |       | | | |       |         |
+ +-+-+ + +-+ + + + + + + + +-+-+-+ + + +-+-+-+ +-+-+ + + +-+ + + + +-+-+ +-+ +-+ + +-+-+-+ +-+-+-+ +
| | |   |   | |   | | |         | | | |         |     | | | | |   |   |     |           | |       | |
+ + + + +-+-+ + + +-+-+-+ +-+-+ + + +-+-+ +-+-+-+-+-+ + +-+ +-+-+ + + + + + +-+-+-+-+-+ + + + +-+-+ +
| |   |     | | | | | |   | | | | |           | |     | |   | |   | |   | | |         | | | |   | | |
+ + +-+-+-+ +-+-+-+ + +-+ + + + + + + + +-+-+-+ +-+-+-+-+ +-+ +-+ +-+-+-+-+-+ +-+-+ +-+ + + + + + +-+
| |       | |     |       | |     | | |       |   |     |           |     | | |   |     | | | | | | |
+ +-+-+-+-+-+-+-+ + + +-+-+ + +-+ +-+-+ +-+-+-+ +-+ +-+ +-+ +-+-+ + + +-+-+ +-+ +-+ +-+-+ +-+-+-+ + +
| |       | |   | | | | | | | |       |           | |   |     |   |     | |   |   | | |     |     | |
+ +-+ +-+ + + +-+ + + + + + +-+ + +-+-+ + +-+-+ +-+ + +-+-+ + + + +-+-+ + +-+ + +-+ + + + +-+ +-+ + +
| |   |   |   |     | |     |   |       |   | |   | | |     | | |     | | |         | | |   | | |   |
+ +-+ +-+-+-+ +-+-+ + +-+-+ + +-+-+ + +-+ +-+ + +-+ +-+-+-+-+-+-+ + +-+ + +-+-+-+ + + + +-+-+-+ +-+ +
|   |     |         | |     |     | | | | |     | |     | |   | | |   | |     |   |   | | |         |
+ + +-+-+ + + +-+-+ + + +-+-+ + +-+-+-+ +-+-+ + + + +-+ + +-+ + +-+ + +-+ + + +-+ +-+-+ + + + +-+-+ +
| |   | |   | |     | |       |   |   |   | | | | | |   | |       | |     | | |   | | | |   | |     |
+ + +-+ + +-+ + +-+ + + + +-+ +-+-+ + +-+ + +-+-+ + + +-+ +-+ +-+-+-+-+-+ +-+-+-+-+ + + +-+-+ + +-+-+
| |     | |   | | | | | | | | |   | |     |       | |   |     |     |   | |   |   |       | | |     |
+ +-+ + +-+-+-+-+ +-+-+ +-+ + + + +-+ +-+ + +-+-+ + +-+-+ + +-+-+ + +-+ +-+ + + + + + + +-+ +-+-+ + +
| |   |   |   |           | |   |   | | |       |   | |   |       | |     | |   |   | |         | | |
+-+-+-+ + +-+ +-+ + +-+ +-+ +-+-+ + +-+ + +-+-+-+-+-+ +-+-+ + + +-+ +-+-+ +-+ +-+ +-+ +-+-+-+ +-+ +-+
|     | |     |   |   | | |     | |     |   | |   | |     | | | |     |         |   |     |       | |
+-+-+ + + + + +-+ + +-+-+ +-+ +-+-+ +-+-+-+ + + +-+ + + + + +-+-+-+-+-+ +-+-+-+-+ +-+ + +-+-+-+ +-+ +
|   | | | | | | | | |   |   |               |       | | |   | |       | |         | | |       |     |
+-+ + +-+ + +-+ + +-+ +-+-+ + +-+ +-+-+-+-+ +-+ +-+ + +-+ + + +-+-+-+ +-+ + +-+-+ + +-+ + + +-+-+ +-+
|         |         |   | |   | |         |   | |   |   | |   |   |       | | |   |   | | | |   |   |
+-+-+-+ + +-+ +-+ +-+-+ + + +-+ +-+ + +-+-+-+-+-+ + +-+ +-+ + + +-+ +-+-+-+-+ +-+ + +-+-+-+-+-+ +-+ +
|       | | | | |       |       | | |       |     |   | | | |     | |       | |       |       | |   |
+-+ +-+ + + + + +-+-+ + + +-+ + + + + +-+ + +-+-+-+ + + + + +-+ +-+ +-+-+ +-+ +-+ +-+-+-+ + +-+ +-+ +
| |   | | |   |       | |   | | |   |   | | |     | | | |   | |         |         | |   | | |   | | |
+ +-+ + +-+-+-+-+-+ +-+-+-+ +-+-+-+-+ +-+ + + +-+-+ +-+-+ + + + +-+ + + +-+-+-+-+ + + +-+ +-+ + + +-+
|     |   | | |       |     |     |   | | |       |   | | | |   |   | |   |             | | | |   | |
+ + + +-+ + + + +-+-+-+-+-+-+-+ +-+ + + + + +-+ +-+-+ + + +-+-+ +-+ + +-+-+ + +-+-+-+ +-+ + + +-+-+ +
| | | | | |       | |   |         | |   | | | | |   |   |   |     | | |   | |   |     |       | |   |
+ +-+ + +-+ +-+ +-+ +-+ +-+ +-+ + +-+-+-+ +-+ + + + +-+ +-+ +-+ +-+-+ + + +-+-+-+-+ +-+-+-+ +-+ +-+ +
| |   | | |   | |   | | |   |   | |         |   | | |   | | |   |       |   |           |       |   |
+ + +-+ + +-+ +-+ + + + +-+ + +-+ + + +-+ +-+-+-+-+ +-+ + + +-+ + +-+-+ + +-+-+ +-+-+ +-+-+-+ +-+ +-+
| |   | | |       | |     | | | | | | |     | |       | |     | | |   | | | |   | | | |       | |   |
+-+ +-+ + +-+-+-+-+-+ + + + +-+ +-+-+ +-+-+-+ +-+-+ +-+ + +-+ +-+-+ +-+-+ + + +-+ + + + + +-+-+ +-+ +
|         |       |   | |   | |     |     |   | |       | | |   |   | |     |       |   | | |       |
+-+ +-+-+ +-+ +-+ +-+ +-+ +-+ + +-+ + + + + +-+ +-+ +-+ +-+ +-+ + + + +-+ +-+-+-+ + +-+-+ + +-+ +-+-+
|   |   | |   | |   |   |     |   | | | |           | | |         | |     | | | | | |           |   |
+ + +-+ + + +-+ + +-+ +-+-+ + +-+ + + +-+-+-+ + + + + + + + +-+-+-+-+-+-+-+ + + +-+-+-+-+-+-+ +-+ + +
| |     | | | |       |     |     | |   |     | | |   |   |   | |   |   |       | | |   | |       | |
+-+-+-+ +-+-+ +-+ +-+ +-+-+-+-+ + + +-+-+-+ +-+ +-+-+ + + +-+-+ + + +-+ + +-+ +-+ + +-+ + + + +-+-+-+
| | |     |     |   | | |     | | |   |     |   |     | |     |   | |       | | |     |     | |     |
+ + +-+-+-+-+ + + + +-+ + + +-+ + + +-+-+ +-+ +-+-+-+-+ +-+-+ + + +-+-+-+ +-+-+ + + +-+-+ +-+-+-+-+ +
|       | |   |   |       |   | | | |     |         | | |       | | |     |   | | |                 |
+ +-+-+ + + +-+-+-+-+-+-+ + +-+ +-+-+-+ + + +-+ + +-+ +-+ +-+ +-+-+ + +-+ + +-+ + +-+-+ +-+ + + +-+ +
| |     |       |     |   |   |         | |   | |   |     |       |   |       |     | | |   | | | | |
+-+-+ + + +-+-+-+ + +-+ +-+-+ +-+-+-+ + +-+ +-+-+ +-+-+ +-+ +-+-+ +-+ + + + +-+ +-+-+ +-+-+ +-+-+ + +
|   | |   |       | |       |   |     | |       |     | |     |     | | | |               |   | |   |
+ +-+ +-+-+-+ +-+-+ +-+ +-+-+ +-+ + + + + +-+-+ +-+-+-+ +-+-+-+ + +-+ + +-+-+-+ +-+ + +-+ + + + + + +
|   |   | |       | |     |     | | | | |   | |   |   |   |   | |   | |   | |     | | |   | | |   | |
+ + + +-+ +-+ +-+ + +-+ +-+-+ + +-+-+-+-+ +-+ +-+ + + + + + + +-+-+ +-+-+ + + +-+ +-+-+ +-+-+-+ +-+ +
| |     |     |   |     |     |         |       | | |   | | |       |     |   |   |           | |   |
+-+-+-+-+-+-+-+-+-+-+-+-+-+-+-+-+-+-+-+-+-+-+-+-+-+-+-+-+-+-+-+-+-+-+-+-+-+-+-+-+-+-+-+-+-+-+-+-+-+-+