+-+-+-+-+-+
|         |
+ + +-+-+ +
| |     | |
+-+ +-+ +-+
|   |     |
+ + +-+-+ +
| | |   | |
+ + + +-+ +
| |     | |
+-+-+-+-+-+