+-+-+-+-+-+
|         |
+ +-+ + + +
| |   | | |
+-+ + + + +
|   | | | |
+ +-+ + + +
|   | | | |
+ + +-+ +-+
| |   |   |
+-+-+-+-+-+