+-+-+-+-+-+-+-+-+-+-+-+-+-+-+-+-+-+-+
| |               | |         |   | |
+ + +-+-+-+-+-+-+ + + + +-+-+ + + + +
| |           |   | | |     | | | | |
+ +-+ +-+-+-+ +-+ + + +-+-+ + + + + +
|   |       |   |   |   | | |   |   |
+-+ +-+-+-+-+-+ +-+ +-+ + + +-+-+-+-+
| | |         |   |   |   |   |     |
+ + + +-+-+-+ +-+ +-+-+-+ +-+ + +-+ +
|   | |   | |   |     |   | | | |   |
+ +-+ + + + +-+ + +-+ + +-+ + + + +-+
| |   | |   |   | | |       |   |   |
+ + +-+ +-+ + +-+ + +-+-+-+-+ +-+-+ +
| | |   | | | | | |   |     |   | | |
+ + + +-+ + + + + + + + +-+ +-+ + + +
|   |   | | | |     | |   | |     | |
+-+-+ + + + + + +-+-+-+-+ + +-+-+-+ +
|     | |   | |   |     | |     |   |
+ +-+-+ + +-+ +-+ + +-+ + +-+-+ + + +
| |     | | | |   | | |   |   | | | |
+ + +-+-+ + + +-+ + + +-+-+ + + + + +
| | |   | | |   | | |   |   | |   | |
+-+ + +-+ + +-+ + + + + + + +-+-+-+ +
|   |   |   |   | | | |   | |     | |
+ +-+ + + +-+ +-+-+ + +-+-+ + +-+ + +
|   | |   |   |     | |     | | |   |
+ + +-+ +-+ +-+ +-+-+ + +-+ + + +-+-+
| |   |   | | |     | | |   |   |   |
+-+-+ +-+-+ + + +-+ + + + +-+-+ + +-+
|   |     | | | |   | | |   | | |   |
+ + +-+-+ + + + + +-+ + +-+ + + +-+ +
| |       | |   | | | |   |   |   | |
+ +-+-+-+-+ + +-+ + + +-+ +-+-+-+ + +
| |   |   | |   | | | | | |       | |
+ + + + + + +-+-+ + + + + + +-+-+-+ +
|   |   |         |     |           |
+-+-+-+-+-+-+-+-+-+-+-+-+-+-+-+-+-+-+