+-+-+-+-+-+-+-+-+-+-+-+-+-+-+-+-+-+-+-+-+-+-+-+-+-+-+-+-+-+-+-+-+-+
|                                                                 |
+ +-+-+-+-+-+ + +-+ + + +-+-+ +-+ +-+ + +-+-+-+-+-+-+ + + +-+-+-+-+
|           | |   | | |     |   |   | |             | | |         |
+ + +-+-+ + +-+ +-+-+-+ + + +-+ + +-+ +-+ + +-+-+-+-+ + +-+ + + + +
| |     | |   |       | | |   | |   |   | |         | |   | | | | |
+ + +-+ +-+-+-+ + +-+-+ +-+-+-+-+ + + + + +-+ + +-+ +-+ + + + +-+-+
| |   |       | |     |         | | | | |   | |   |   | | | |     |
+ + +-+-+ +-+ + + +-+ +-+-+-+-+-+ +-+-+-+-+-+-+-+ +-+ + + +-+ +-+-+
| |     |   | | |   |           |               |   | | |   |     |
+ + + +-+ +-+-+ + +-+ + + + + +-+ +-+-+ + + + + +-+ +-+-+-+-+-+-+ +
| | |   |     | |   | | | | |   |     | | | | |   |             | |
+ + + +-+ +-+ + +-+ + +-+-+ +-+ +-+ +-+-+ + +-+-+ +-+ + +-+ + + +-+
| | |   |   | |   | |     |   |   |     | |     |   | |   | | |   |
+ +-+ + + +-+ + + +-+-+-+-+-+-+-+-+ +-+ +-+ +-+ + +-+ +-+ +-+-+-+ +
|   | | |   | | |                 |   |   |   | |   |   |       | |
+ + +-+-+ + +-+-+-+ + +-+-+-+ +-+-+ +-+-+ +-+ + +-+-+-+-+-+-+ + + +
| |     | |       | |       |     |     |   | |             | | | |
+ + +-+ + + +-+-+ + + + + +-+-+ + + + +-+-+ +-+-+-+-+-+ +-+ + +-+ +
| |   | | |     | | | | |     | | | |     |           |   | |   | |
+ +-+ +-+ + + + + +-+ +-+-+-+-+-+ +-+-+-+-+-+-+ +-+-+ +-+-+-+-+ +-+
|   |   | | | | |   |           |             |     |         |   |
+ +-+ + + + + + + +-+ + + +-+-+ + + + + +-+-+-+ +-+-+ + + +-+-+ + +
|   | | | | | | |   | | |     | | | | |       |     | | |     | | |
+ +-+-+ +-+ +-+ +-+ + +-+-+-+ + +-+-+-+-+ +-+ +-+ +-+-+-+ + +-+ + +
|     |   |   |   | |       | |         |   |   |       | |   | | |
+ +-+ + +-+-+ +-+-+-+ + +-+-+ + +-+-+ + +-+ +-+-+-+-+-+ + + + +-+ +
|   | |     |       | |     | |     | |   |           | | | |   | |
+ +-+ + + +-+ + +-+ +-+-+ +-+ + +-+ + +-+ +-+-+-+-+-+-+ + +-+ +-+ +
|   | | |   | |   |     |   | |   | |   |             | |   |   | |
+ +-+ + + +-+ + +-+ + +-+ +-+ +-+ + +-+-+-+ +-+-+-+-+ + +-+ + + + +
|   | | |   | |   | |   |   |   | |       |         | |   | | | | |
+ + +-+ +-+ +-+-+ +-+-+-+-+-+ +-+ + + +-+ + + + +-+-+ +-+-+-+-+ +-+
| |   |   |     |           |   | | |   | | | |     |         |   |
+ + +-+ + + + +-+-+ +-+-+ + + +-+ +-+-+-+ +-+ +-+ +-+ + + +-+ + +-+
| |   | | | |     |     | | |   |       |   |   |   | | |   | |   |
+ +-+ +-+ + + + +-+-+ + +-+-+-+ + + +-+ +-+-+ +-+ + + +-+ + +-+ + +
|   |   | | | |     | |       | | |   |     |   | | |   | |   | | |
+ + + + + +-+ + +-+-+ + + +-+-+ + + + + +-+-+-+-+-+ + + +-+-+-+ + +
| | | | |   | |     | | |     | | | | |           | | |       | | |
+ +-+ + + + + + + + +-+ +-+ +-+ + +-+ + + + + + + +-+ + + + + + +-+
|   | | | | | | | |   |   |   | |   | | | | | | |   | | | | | |   |
+ +-+-+-+-+-+-+ + + + + +-+ + +-+-+-+ +-+ + + +-+-+ +-+ + +-+ +-+-+
|             | | | | |   | |       |   | | |     |   | |   |     |
+ +-+-+-+ + +-+-+ + +-+ +-+ +-+ +-+ + +-+-+ +-+ +-+ +-+-+-+ + +-+ +
|       | |     | |   |   |   |   | |     |   |   |       | |   | |
+ +-+-+-+-+-+-+ +-+-+-+-+ + +-+ + + + +-+-+-+ +-+-+-+-+-+ + +-+-+-+
|             |         | |   | | | |       |           | |       |
+ +-+-+ + + + +-+-+-+ +-+ +-+-+ + +-+-+-+ + + + + +-+-+-+-+-+-+-+-+
|     | | | |       |   |     | |       | | | | |                 |
+ +-+-+ + + + + + + + +-+ + +-+ +-+ + +-+ +-+ + + + +-+ +-+ + + +-+
|     | | | | | | | |   | |   |   | |   |   | | | |   |   | | |   |
+ +-+-+ +-+-+ +-+-+-+-+ +-+-+ +-+-+ + +-+-+-+-+ +-+ +-+-+-+ + + + +
|     |     |         |     |     | |         |   |       | | | | |
+ +-+-+ +-+ + + + + + + + +-+-+ +-+ + + +-+ +-+-+-+-+-+ +-+ + +-+ +
|     |   | | | | | | | |     |   | | |   |           |   | |   | |
+ +-+-+-+-+-+-+ +-+-+ +-+ +-+ + +-+-+ +-+ +-+-+-+ +-+-+ + + +-+-+ +
|             |     |   |   | |     |   |       |     | | |     | |
+ + +-+-+-+ + +-+-+ + + +-+-+ +-+ +-+-+-+ +-+-+-+ +-+ +-+ +-+ + +-+
| |       | |     | | |     |   |       |       |   |   |   | |   |
+ +-+ +-+ +-+-+-+ + + + + +-+ + + +-+ + +-+-+-+ + + + + +-+ + + + +
|   |   |       | | | | |   | | |   | |       | | | | |   | | | | |
+ +-+-+ + +-+-+ +-+-+ +-+-+-+ +-+-+-+-+-+ +-+ + +-+ + + +-+-+-+-+-+
|     | |     |     |       |           |   | |   | | |           |
+ + +-+ + +-+-+-+-+ +-+-+-+-+ +-+-+-+ + + +-+-+ +-+-+-+-+ + + +-+-+
| |   | |         |         |       | | |     |         | | |     |
+-+-+-+-+-+-+-+-+-+-+-+-+-+-+-+-+-+-+-+-+-+-+-+-+-+-+-+-+-+-+-+-+-+