+-+-+-+-+-+-+-+-+-+-+-+-+-+-+-+-+-+-+-+
|                                     |
+-+-+ + +-+ + + + + +-+ + +-+-+ + + + +
|     |   | | | | |   | |     | | | | |
+ + + +-+ +-+-+-+-+ + + + + + +-+ + +-+
| | |   |   |       | | | | | |   |   |
+ + + + + +-+ + +-+ +-+-+-+-+ + + + + +
| | | | |   | |   |   |       | | | | |
+ + + + + +-+ +-+ +-+ + + + +-+ + + + +
| | | | |   |   |   | | | | |   | | | |
+ + +-+-+ + +-+ + + + + + + + +-+ +-+ +
| |     | | |   | | | | | | | |     | |
+ + + + + + +-+-+ +-+ +-+ +-+-+-+ + + +
| | | | | |     |   | |   |       | | |
+ + +-+ + +-+ + + + +-+ + + + +-+ + + +
| |   | |   | | | |   | | | |   | | | |
+-+-+ + +-+-+ + +-+ + + + + + + + + + +
|     |   |   |   | | | | | | | | | | |
+-+ + +-+ +-+-+ +-+-+ +-+ +-+-+ + + + +
|   | |   |       |     |   |   | | | |
+-+-+-+ + +-+ + + + + + + + + +-+ + +-+
|       | |   | | | | | | | | |   |   |
+ + + +-+ + + +-+-+ + + +-+-+ + +-+ + +
| | |   | | |     | | | |     | |   | |
+ + + +-+ + +-+-+ +-+-+-+-+-+ +-+-+ +-+
| | |   | |   |           |     |     |
+-+ +-+ +-+ +-+-+ + +-+ +-+ + + + +-+ +
|   |   |   |     |   | |   | | |   | |
+ + +-+ +-+ +-+ + + + +-+ +-+ +-+ +-+ +
| | |   |     | | | | |     |   | |   |
+ +-+ + + + + + + + + + + + + + + +-+ +
|   | | | | | | | | | | | | | | | |   |
+-+ +-+-+ + +-+-+-+-+ + +-+ + + + +-+ +
|       | | |         |   | | | | |   |
+ + +-+ + + + +-+ +-+ + + + + +-+ +-+ +
| | |   | | | |     | | | | | |   |   |
+ + +-+ +-+-+ + + + +-+-+-+ + + +-+ + +
| | |     |   | | | |       | |   | | |
+-+-+-+-+-+-+-+-+-+-+-+-+-+-+-+-+-+-+-+