+-+-+-+-+-+-+-+-+-+-+-+-+-+-+-+-+-+-+-+-+-+-+-+-+-+-+-+
|                                                     |
+ +-+-+ +-+ +-+-+-+ + +-+-+-+-+ +-+-+-+-+-+-+ +-+-+-+-+
|     |   |       | |         |             |         |
+ +-+ +-+-+ +-+ + + +-+-+ + +-+ + +-+ + +-+-+-+-+-+ +-+
|   |     |   | | |     | |   | |   | |           |   |
+ +-+-+ +-+-+ +-+-+-+-+-+-+-+ + +-+-+ +-+-+ +-+-+-+ +-+
|     |     |               | |     |     |       |   |
+ +-+-+ +-+ + +-+-+ + +-+ + + + +-+ + +-+-+ + + + + +-+
|     |   | |     | |   | | | |   | |     | | | | |   |
+ +-+-+-+-+ + + + + +-+-+ + + +-+-+-+-+ +-+ +-+ + + +-+
|         | | | | |     | | |         |   |   | | |   |
+ +-+ +-+ +-+ +-+-+-+-+-+-+ + + +-+-+-+ + +-+ +-+ + + +
|   |   |   |             | | |       | |   |   | | | |
+ +-+-+ + + +-+ +-+-+-+ + +-+-+-+-+ + +-+ +-+ + + + +-+
|     | | |   |       | |         | |   |   | | | |   |
+ +-+-+-+ +-+-+-+-+ + + +-+ + + +-+-+ +-+-+ +-+ +-+-+ +
|       |         | | |   | | |     |     |   |     | |
+ +-+-+ + +-+ + +-+-+ + + + + +-+ + + + + +-+-+ +-+ + +
|     | |   | |     | | | | |   | | | | |     |   | | |
+ + + +-+ +-+-+ + + + +-+-+ +-+-+ +-+-+ +-+ +-+ +-+-+-+
| | |   |     | | | |     |     |     |   |   |       |
+ + + + +-+ +-+-+ + +-+-+-+ + +-+-+-+-+-+ + +-+-+ +-+-+
| | | |   |     | |       | |           | |     |     |
+ + +-+-+-+-+ + + +-+ +-+-+ + + +-+ + + +-+-+-+-+ +-+ +
| |         | | |   |     | | |   | | |         |   | |
+ +-+ +-+ + +-+ + +-+-+-+-+ +-+-+ + + +-+-+ +-+-+-+-+ +
|   |   | |   | |         |     | | |     |         | |
+ +-+-+-+-+ + + + + + +-+-+-+ +-+-+-+ +-+-+ +-+-+ + +-+
|         | | | | | |       |       |     |     | |   |
+ +-+-+ + +-+-+-+-+-+-+-+ +-+-+-+-+-+-+ +-+ + + +-+ +-+
|     | |               |             |   | | |   |   |
+ + +-+-+ + + +-+ +-+ + + +-+ + + +-+ + +-+ + + +-+-+-+
| |     | | |   |   | | |   | | |   | |   | | |       |
+ + + +-+ +-+-+-+-+-+ + +-+ + +-+ +-+ + + + + +-+-+-+-+
| | |   |           | |   | |   |   | | | | |         |
+ +-+ +-+ +-+ + + +-+-+-+ +-+-+ + + +-+-+-+-+-+ + +-+-+
|   |   |   | | |       |     | | |           | |     |
+ +-+-+ + +-+-+ + +-+ + + +-+ + +-+ + + +-+ +-+-+-+-+ +
|     | |     | |   | | |   | |   | | |   |         | |
+ + + +-+-+ + +-+ +-+-+ +-+ +-+ +-+ +-+-+-+ + + +-+ +-+
| | |     | |   |     |   |   |   |       | | |   |   |
+ + +-+ + + + + + +-+-+-+ + + + + + + + + +-+ +-+-+ +-+
| |   | | | | | |       | | | | | | | | |   |     |   |
+ +-+ +-+ + +-+ +-+ + +-+-+ + + +-+-+-+-+ +-+-+-+-+ + +
|   |   | |   |   | |     | | |         |         | | |
+ +-+-+-+-+ + +-+-+-+-+ + +-+-+-+-+ + + + +-+-+ +-+-+ +
|         | |         | |         | | | |     |     | |
+ + +-+ +-+ +-+ +-+ + +-+-+ + +-+ +-+-+-+ + +-+ + + +-+
| |   |   |   |   | |     | |   |       | |   | | |   |
+ + + + + + + + +-+ +-+-+ +-+ +-+ +-+ + +-+-+-+-+ +-+-+
| | | | | | | |   |     |   |   |   | |         |     |
+ +-+-+-+-+-+-+ +-+-+-+ + + +-+-+ + +-+-+-+ +-+ + +-+-+
|             |       | | |     | |       |   | |     |
+-+-+-+-+-+-+-+-+-+-+-+-+-+-+-+-+-+-+-+-+-+-+-+-+-+-+-+