+-+-+-+-+-+-+-+-+-+-+-+-+-+-+-+-+-+-+-+-+-+-+-+-+-+-+-+-+-+-+-+-+-+-+-+
|                                                                     |
+ + + + +-+ + +-+-+ +-+-+ + + +-+ +-+ + + +-+-+-+ + +-+ +-+-+-+-+-+ + +
| | | |   | |     |     | | |   |   | | |       | |   |           | | |
+ +-+ + +-+ +-+ +-+-+-+ + + +-+-+ +-+ + +-+-+ + +-+ + +-+ +-+-+ +-+-+-+
|   | |   |   |       | | |     |   | |     | |   | |   |     |       |
+ + +-+-+ + +-+ +-+ +-+-+ + +-+-+ +-+-+-+ + + +-+ +-+-+ + +-+-+-+-+-+-+
| |     | |   |   |     | |     |       | | |   |     | |             |
+ + + +-+-+ + + + +-+-+-+ +-+-+ +-+ + + +-+-+-+ + +-+ +-+-+ + + +-+ +-+
| | |     | | | |       |     |   | | |       | |   |     | | |   |   |
+ + +-+ + +-+-+-+-+ +-+ + + +-+-+ + +-+-+ + + +-+ +-+-+ + +-+ + + + +-+
| |   | |         |   | | |     | |     | | |   |     | |   | | | |   |
+ + + +-+-+ + +-+-+ + +-+-+ + + +-+-+ + +-+ + + +-+ +-+-+-+-+ + +-+-+-+
| | |     | |     | |     | | |     | |   | | |   |         | |       |
+ +-+-+-+-+ +-+ +-+-+-+ + +-+ +-+ +-+-+ + + +-+-+ + +-+ +-+ +-+-+-+ +-+
|         |   |       | |   |   |     | | |     | |   |   |       |   |
+ + + + +-+ + +-+-+ +-+-+ +-+-+-+ + + + +-+-+-+-+-+ +-+-+-+-+-+ +-+-+-+
| | | |   | |     |     |       | | | |           |           |       |
+ + + + +-+-+ + +-+ +-+ +-+ + + +-+ + + + + +-+-+-+ +-+ +-+ +-+ + + +-+
| | | |     | |   |   |   | | |   | | | | |       |   |   |   | | |   |
+ + +-+ + + +-+-+-+-+ +-+ + +-+-+-+-+ + + + + +-+-+-+-+-+ + +-+-+ + +-+
| |   | | |         |   | |         | | | | |           | |     | |   |
+ +-+-+-+-+-+ + +-+-+-+-+-+ +-+ + +-+-+ +-+ + +-+-+-+-+-+ + +-+ +-+ +-+
|           | |           |   | |     |   | |           | |   |   |   |
+ + + +-+ + + + + +-+-+-+-+ +-+ +-+-+-+-+ + + +-+-+ +-+ +-+-+ +-+-+-+ +
| | |   | | | | |         |   |         | | |     |   |     |       | |
+ + +-+ +-+-+-+-+-+-+ + + +-+ +-+ + +-+ +-+ +-+ + +-+-+-+-+ + + +-+ + +
| |   |             | | |   |   | |   |   |   | |         | | |   | | |
+ + + +-+-+ + +-+-+-+ + +-+ + +-+ +-+ +-+ +-+ +-+-+ + +-+ + +-+-+-+ + +
| | |     | |       | |   | |   |   |   |   |     | |   | |       | | |
+ + + + +-+-+-+ +-+ +-+ +-+-+-+ +-+ +-+ +-+-+ +-+ +-+ +-+ + + +-+-+-+-+
| | | |       |   |   |       |   |   |     |   |   |   | | |         |
+ + +-+ + +-+ + +-+-+ + + + +-+-+-+-+-+ +-+-+ + + +-+ +-+-+-+-+ + +-+-+
| |   | |   | |     | | | |           |     | | |   |         | |     |
+ + + + + +-+ +-+-+ + + +-+ + + + + + + + +-+ + + +-+-+-+ +-+ + +-+-+-+
| | | | |   |     | | |   | | | | | | | |   | | |       |   | |       |
+ + + + + + + + +-+-+ +-+-+-+-+ +-+-+ + + +-+-+-+-+ + +-+ +-+ + +-+ +-+
| | | | | | | |     |         |     | | |         | |   |   | |   |   |
+ +-+-+ +-+ + + +-+-+-+ + + + +-+-+ +-+-+ + + + +-+ +-+ +-+-+ + +-+ +-+
|     |   | | |       | | | |     |     | | | |   |   |     | |   |   |
+ + +-+ +-+-+-+-+-+-+ + + + +-+ + + + +-+-+-+ + +-+ + +-+-+-+ + + + + +
| |   |             | | | |   | | | |       | |   | |       | | | | | |
+ +-+ +-+ + +-+ + +-+ + + +-+ +-+ +-+-+-+ +-+ +-+-+ + + +-+ + + + + +-+
|   |   | |   | |   | | |   |   |       |   |     | | |   | | | | |   |
+ +-+ + + +-+-+-+-+ +-+-+ + +-+ + + + + +-+ +-+ + + + +-+ +-+-+ +-+-+-+
|   | | |         |     | |   | | | | |   |   | | | |   |     |       |
+ +-+ + + + +-+-+ + + +-+-+-+-+ + +-+-+ +-+-+ +-+-+ +-+ + + + +-+ + +-+
|   | | | |     | | |         | |     |     |     |   | | | |   | |   |
+ + +-+ +-+ + +-+-+-+ + + +-+-+ +-+ +-+ +-+ +-+-+-+-+-+ +-+ +-+-+ +-+ +
| |   |   | |       | | |     |   |   |   |           |   |     |   | |
+ +-+-+ + +-+-+-+ + + + +-+ +-+ + + + + +-+-+-+ + + +-+ + + +-+-+ +-+ +
|     | |       | | | |   |   | | | | |       | | |   | | |     |   | |
+ +-+-+ +-+-+ +-+ +-+ +-+-+ +-+ +-+-+ +-+-+ + + + +-+ + +-+ + + + + + +
|     |     |   |   |     |   |     |     | | | |   | |   | | | | | | |
+ +-+ +-+ + +-+-+ + +-+ +-+-+-+-+-+ + +-+-+ +-+-+ +-+-+ + + +-+-+ + + +
|   |   | |     | |   |           | |     |     |     | | |     | | | |
+ +-+-+-+-+-+ + +-+ + +-+ + + + +-+-+ +-+ + + +-+ + + +-+-+-+ +-+-+ + +
|           | |   | |   | | | |     |   | | |   | | |       |     | | |
+ +-+ +-+ + + + + + + + +-+-+-+ +-+-+ + + + +-+-+-+-+-+-+ +-+ + +-+-+ +
|   |   | | | | | | | |       |     | | | |             |   | |     | |
+ + +-+ + + +-+ +-+-+-+-+-+ +-+-+-+ + +-+-+ +-+ +-+ + + +-+-+-+-+ +-+-+
| |   | | |   |           |       | |     |   |   | | |         |     |
+ +-+-+ + +-+-+-+-+ + + + + + +-+ +-+ +-+-+-+-+ +-+-+ + +-+ + + +-+ +-+
|     | |         | | | | | |   |   |         |     | |   | | |   |   |
+ + + + + + +-+ +-+ +-+ +-+ + + +-+-+-+ +-+ +-+ + + +-+-+ +-+ +-+-+ + +
| | | | | |   |   |   |   | | |       |   |   | | |     |   |     | | |
+ + +-+ + + + +-+-+ +-+-+ +-+ + + + + + +-+ + + +-+ +-+ +-+-+ +-+-+ +-+
| |   | | | |     |     |   | | | | | |   | | |   |   |     |     |   |
+ + + +-+-+-+ + +-+ +-+-+-+ + +-+-+ + + + +-+-+-+ +-+-+-+ + + +-+-+ + +
| | |       | |   |       | |     | | | |       |       | | |     | | |
+-+-+-+-+-+-+-+-+-+-+-+-+-+-+-+-+-+-+-+-+-+-+-+-+-+-+-+-+-+-+-+-+-+-+-+