+-+-+-+-+-+-+-+-+-+-+-+-+-+-+-+-+-+-+-+-+-+-+-+-+-+-+-+
|   |   |     |           |   | |         |   |     | |
+-+ + +-+-+-+ +-+-+ +-+-+-+ + + + + +-+ +-+-+ +-+-+ + +
|       | |       |     | | |     |   |             | |
+-+ + +-+ +-+ +-+-+ +-+ + + +-+-+-+ +-+ +-+-+-+-+ +-+ +
|   |       | |   | |     |   |       | | | |       | |
+ +-+-+-+ + + + + +-+-+-+ +-+ +-+ +-+-+ + + +-+-+ + + +
| |       | |   | | | | | |     |     |   |   |   | | |
+-+-+-+ +-+ + + +-+ + + + +-+-+-+-+ + + +-+ + + +-+ + +
|       | | | | |       |     | | | | | |   | | |     |
+ +-+-+ + +-+ +-+-+ +-+ + + + + + + +-+-+ +-+-+-+-+ +-+
| |                   | | | | | | | |   |         |   |
+ +-+-+ +-+-+ +-+-+-+ +-+-+-+ + + + + +-+ +-+ +-+-+-+ +
|   |   |     |   | |     |       |       |       | | |
+-+-+-+ + + + + +-+ +-+ + + + + +-+-+-+ +-+-+-+-+ + +-+
| |   | | | | |         |   | | | |     | |   |       |
+ + + + +-+-+-+ +-+-+ + +-+-+-+-+ +-+ + + + + + + + + +
| | | | |   |   | |   | | |   |     | | |   | | | | | |
+ +-+ + + +-+ + + + +-+-+ + +-+-+ + + + + +-+-+-+-+-+ +
|     | |   | |   |     |         | | |   |   |     | |
+ +-+-+ + +-+-+ +-+-+-+ + + + +-+ + + + + +-+ +-+ + + +
|       | |   |   |       | |   | | | | |     | | | | |
+-+ +-+ + + + + + +-+ + +-+-+-+-+-+ + +-+-+-+-+ +-+ + +
| |   | |   |   | |   |     | |         |           | |
+ +-+-+ +-+-+-+ +-+-+ +-+ +-+ +-+-+ + +-+-+ +-+-+ +-+-+
|   |       |   | |     | | |   | | | | |     | |     |
+-+ +-+-+ + + + + +-+ + +-+ + +-+ +-+ + + +-+-+ + + + +
|   | |   | | | |   | | | |     |           |   | | | |
+-+ + +-+-+-+-+-+ +-+ +-+ + + +-+-+-+-+ +-+-+-+ + +-+-+
| |     |   |       |   |   |   |   |   | |   | |     |
+ + + +-+ +-+ +-+ +-+-+-+ +-+ + + +-+ + + +-+ + +-+-+ +
|   | |         | |   |   |   |   |   |   | |         |
+-+ +-+ +-+ +-+ +-+-+ + + +-+-+ + + + +-+-+ +-+-+-+ +-+
|     |   | | | |     | |   |   | | |   | |       |   |
+-+-+ + +-+ + + +-+ +-+-+-+-+-+-+ + +-+ + +-+-+-+ + +-+
|   |   |   | | |     |   |   |   | | | |   | |       |
+-+ +-+ +-+-+ +-+-+ +-+-+ + +-+-+ + + +-+-+ + +-+-+-+-+
|     | |     |   |     |   |     | | | |   |     | | |
+ + +-+ + +-+-+ + + + +-+-+ + + +-+ + + + +-+ + +-+ + +
| |   | | |   | | | |     |   | | |       |   | | |   |
+ + + + + +-+ +-+ + +-+-+-+-+ +-+ + + + +-+ + +-+ +-+ +
| | |     |       | |     | |   | | | |     |         |
+-+ + + + + +-+ +-+ + +-+ + +-+ + + +-+-+ + + +-+ +-+-+
|   | | |     |       |       |     |   | | | |     | |
+-+ + +-+-+-+-+-+-+ +-+-+-+-+ +-+ + +-+ +-+-+-+-+-+ + +
|   | | |   |   | | | | |   | |   |       |         | |
+-+-+ + +-+ +-+ + + + + + +-+-+ +-+-+-+ +-+ +-+-+ +-+ +
|       |   | |   |   | |   |     | |   |   |     |   |
+-+ +-+-+-+ + + +-+-+ + +-+ + + +-+ + + + + + +-+-+ + +
|   |   | |       | |         |     | | | | | |     | |
+ +-+ +-+ + + +-+ + + + +-+-+ + + + +-+-+ +-+ +-+-+-+ +
|       |   | |       | |     | | | | |     | |   |   |
+-+-+-+ +-+ + +-+ + +-+ +-+ +-+-+ + + +-+-+ +-+ + + + +
|       |   |   | |   | |       | |   |         |   | |
+-+-+-+-+-+-+-+-+-+-+-+-+-+-+-+-+-+-+-+-+-+-+-+-+-+-+-+