+-+-+-+-+-+-+-+-+-+-+-+-+-+-+-+-+-+
|   |   |   | |         | | |   | |
+ +-+ + + +-+ +-+ +-+-+-+ + +-+ + +
|     | | | | |   |   |       |   |
+ +-+-+-+ + + + +-+ + + +-+-+-+ + +
|   | | |     |     |           | |
+ +-+ + + + +-+-+-+-+-+-+ +-+-+-+-+
| | |   | | | |       |   | | |   |
+ + +-+ +-+ + +-+ + + + +-+ + + +-+
|     |   | | |   | | |   |       |
+ +-+-+-+ + + + +-+-+-+-+ +-+ +-+ +
| |   |     |   |   |   | | | |   |
+ + + +-+-+ + +-+-+ + +-+ + +-+-+ +
|   | |     |         | |   |     |
+ +-+ +-+ +-+ +-+ + +-+ + + + +-+-+
|   | |         | |       |       |
+-+ +-+ +-+ + +-+-+ +-+-+-+-+-+ +-+
|   |   |   |   |       |         |
+ +-+-+-+ +-+-+-+-+ + + +-+ +-+ + +
|     | | | |       | | |     | | |
+-+-+ + + + +-+ +-+-+-+-+-+ +-+ +-+
|       | |   |   | |   |   | |   |
+-+ +-+-+ + + +-+ + + + +-+ + +-+ +
| |     | | | |     | | |     | | |
+ + +-+ + +-+ + +-+-+ + +-+-+ + + +
|   | |   | | |       |     |   | |
+ +-+ + +-+ + +-+-+ +-+ + + +-+-+ +
| |   |       |   | |   | | |     |
+ + + + + +-+-+ +-+ +-+-+-+-+-+ + +
| | |   | |   |   | | |     |   | |
+ +-+ +-+-+ +-+-+ + + +-+-+ +-+ + +
| |       |               |   | | |
+ + +-+-+-+ +-+-+-+ +-+ + + + + + +
| |   |           |   | | | |   | |
+-+-+-+-+-+-+-+-+-+-+-+-+-+-+-+-+-+