+-+-+-+-+-+
|         |
+-+-+-+-+ +
|       | |
+ +-+-+ + +
| |   |   |
+ +-+ +-+-+
|     |   |
+-+-+ +-+ +
|   |     |
+ + +-+-+ +
| |       |
+ +-+-+-+-+
| |.|.|.|.|
+ +-+-+-+-+
| |.|.|.|.|
+ +-+-+-+-+
|   |.|.|.|
+-+ +-+-+-+
|   |.|.|.|
+ +-+-+-+-+
| |.|.|.|.|
+ +-+-+-+-+
|     |   |
+-+-+ + + +
|.|.| | | |
+-+-+ + + +
|.|.|   | |
+-+-+-+-+ +
|.|.|.|   |
+-+-+-+ +-+
|.|.|.|   |
+-+-+-+-+ +
|.|.|.|.| |
+-+-+-+-+ +
|.|.|.|.| |
+-+-+-+-+-+
|.|.|.|.|.|
+-+-+-+-+-+
|.|.|.|.|.|
+-+-+-+-+-+
|.|.|.|.|.|
+-+-+-+-+-+
|.|.|.|.|.|
+-+-+-+-+-+
|.|.|.|.|.|
+-+-+-+-+-+
|.|.|.|.|.|
+-+-+-+-+-+
|.|.|.|.|.|
+-+-+-+-+-+
|.|.|.|.|.|
+-+-+-+-+-+
|.|.|.|.|.|
+-+-+-+-+-+
|.|.|.|.|.|
+-+-+-+-+-+
|.|.|.|.|.|
+-+-+-+-+-+
|.|.|.|.|.|
+-+-+-+-+-+