+-+-+-+-+-+-+-+-+-+-+-+-+-+-+-+-+-+-+-+-+-+-+-+
|   |                 |   | |         |   |   |
+-+ + +-+-+-+-+-+-+-+ + + + + +-+-+ + + + + + +
| | | |             | | | |   |     | | |   | |
+ + + +-+-+ +-+-+ +-+ + + +-+ + +-+-+ + +-+-+ +
|   |     | |   | |   | |   | |     | |     | |
+ +-+-+-+ + + + +-+ +-+ +-+ +-+-+ + +-+-+-+ + +
| |       | | |     |   |   |   | |         | |
+ + +-+-+-+ + +-+-+-+ +-+ +-+ + +-+-+-+-+-+-+ +
|   |     |   | |     | | |   | |             |
+-+-+-+-+ + +-+ + + +-+ + +-+ + + +-+-+-+-+-+ +
|         | |   | |   |       |   |     |     |
+-+ +-+ +-+ + + + +-+ + +-+-+-+-+-+ +-+ + +-+-+
|   |   |   | | |   | | |     |       | | |   |
+ +-+-+-+ +-+ + +-+ + +-+ +-+ + +-+-+ +-+ + + +
|         |   |     |     |   | | |   |   | | |
+ +-+-+-+-+ +-+-+-+-+-+-+-+ +-+ + + +-+ +-+-+ +
|   | |   | |   |   |     |   |   |       |   |
+-+ + + + + +-+ + + + +-+ +-+ +-+-+-+-+-+ + +-+
|   |   | |   | | |     |   |         |   |   |
+ +-+-+ + +-+ + + +-+-+-+ + +-+-+-+-+ + +-+-+ +
|     | | |   | | | |   | |       | | |   |   |
+-+-+ +-+ + +-+ + + + + +-+ +-+-+ + + +-+ + + +
|   |   |     |   | | |   |   |   | |   |   | |
+ +-+-+ +-+-+ + +-+ + +-+ +-+ + +-+ +-+ +-+-+ +
| |   |   | | |     | | |     |       |   |   |
+ + + +-+ + + +-+-+-+ + + +-+-+-+-+-+ +-+ +-+ +
|   |     |           |   |       |     |   | |
+ +-+-+-+-+-+-+-+ +-+-+-+ + +-+-+ +-+-+ +-+ +-+
|     | |     |   |     | | |   |   |     |   |
+-+-+ + + + + +-+-+ +-+ +-+ + +-+-+ +-+-+-+-+ +
|   | |   | | |     | |   | |     | |   |   | |
+ + + +-+ + + + +-+-+ +-+ + +-+-+ + + + + + + +
| | |   | | |   |       |   |     | | |   |   |
+ + +-+ + + +-+-+ +-+-+-+-+-+ +-+ + + +-+-+-+ +
| |     | | |   |     |       |   | |   |   | |
+ +-+-+-+ + + + + +-+ + +-+ +-+-+ + + + + + + +
|   |   | | | |   | | |   |     | | | |   | | |
+-+ + +-+ + + +-+-+ + +-+ +-+-+ + + +-+-+ + +-+
| | |     | | |     |   |     | | |     | |   |
+ + +-+-+-+ + +-+ + +-+ +-+ +-+ +-+-+-+ + +-+ +
| |     |   |   | |   |   | |   |     | |   | |
+ +-+-+ + +-+-+ +-+-+ + +-+ + + + + +-+ +-+-+ +
| |   | | | |   |     | |   | | | |   | |     |
+ + + + + + + +-+ +-+ + + +-+ +-+ +-+ + + +-+ +
|   |     |       |   |     |       |     |   |
+-+-+-+-+-+-+-+-+-+-+-+-+-+-+-+-+-+-+-+-+-+-+-+