+-+-+-+-+-+-+-+-+-+-+-+-+-+-+-+-+-+-+-+-+-+-+-+-+
|                                               |
+ +-+-+-+ + + +-+ + +-+-+ + +-+-+-+ + +-+ +-+-+ +
|       | | |   | |     | |       | |   |     | |
+ + + + + +-+-+ +-+-+ +-+-+-+ + + +-+-+-+-+-+-+-+
| | | | |     |     |       | | |               |
+ +-+ + + +-+ + +-+-+-+-+ + +-+-+-+-+ + + + + + +
|   | | |   | |         | |         | | | | | | |
+ +-+-+ +-+ +-+-+-+ + + + +-+-+-+ +-+ + +-+ + +-+
|     |   |       | | | |       |   | |   | |   |
+ +-+-+ +-+-+ +-+ + +-+-+ +-+ + +-+-+ + +-+-+-+ +
|     |     |   | |     |   | |     | |       | |
+ + + + +-+-+-+ + +-+-+ +-+ +-+-+ + +-+-+ + +-+-+
| | | |       | |     |   |     | |     | |     |
+ +-+ + +-+-+ + + +-+ + +-+-+ + + +-+ + +-+ +-+-+
|   | |     | | |   | |     | | |   | |   |     |
+ + + +-+ + +-+-+-+-+ +-+ +-+-+ +-+ + + +-+-+-+-+
| | |   | |         |   |     |   | | |         |
+ +-+ + + + + +-+ + +-+ + + + + + +-+ + +-+-+-+ +
|   | | | | |   | |   | | | | | |   | |       | |
+ + +-+ +-+ + +-+-+ +-+-+ + + +-+-+ + +-+ +-+-+ +
| |   |   | |     |     | | |     | |   |     | |
+ +-+ +-+-+ +-+ +-+-+-+-+-+-+-+-+ + + +-+ +-+ + +
|   |     |   |                 | | |   |   | | |
+ +-+-+ + + +-+ + +-+ +-+-+ +-+ + +-+-+ + +-+-+ +
|     | | |   | |   |     |   | |     | |     | |
+ + +-+-+ +-+ + +-+-+ + +-+ + + +-+ +-+ + + +-+ +
| |     |   | |     | |   | | |   |   | | |   | |
+ +-+ +-+-+-+ + + + +-+-+ +-+ +-+ + +-+ +-+ +-+ +
|   |       | | | |     |   |   | |   |   |   | |
+ +-+ +-+ + +-+-+-+-+-+ + +-+ + + + + +-+-+ + +-+
|   |   | |           | |   | | | | |     | |   |
+ +-+ +-+-+ +-+-+ +-+ +-+ +-+ + +-+ +-+-+-+ +-+-+
|   |     |     |   |   |   | |   |       |     |
+ +-+ +-+-+-+ +-+-+-+-+-+-+ +-+-+ +-+ +-+ +-+-+-+
|   |       |             |     |   |   |       |
+ +-+ + + +-+ + +-+-+ + +-+-+ + +-+-+-+ +-+ +-+-+
|   | | |   | |     | |     | |       |   |     |
+ +-+-+-+-+ + +-+-+ +-+ + +-+-+-+-+ +-+ +-+-+-+-+
|         | |     |   | |         |   |         |
+ +-+-+-+ +-+ + + + + +-+ + + + +-+ +-+-+-+-+ + +
|       |   | | | | |   | | | |   |         | | |
+ + +-+ + + +-+-+-+-+-+-+-+-+-+-+ + +-+-+ +-+ +-+
| |   | | |                     | |     |   |   |
+ +-+-+-+-+-+ +-+ + + +-+ +-+ +-+ + + +-+ +-+-+-+
|           |   | | |   |   |   | | |   |       |
+ + + +-+-+-+ +-+ + + +-+ + + + + +-+ +-+-+-+-+ +
| | |       |   | | |   | | | | |   |         | |
+-+-+-+-+-+-+-+-+-+-+-+-+-+-+-+-+-+-+-+-+-+-+-+-+