+-+-+-+-+-+-+-+-+-+-+-+-+-+-+-+-+-+-+-+-+-+-+-+-+-+-+-+-+-+-+-+-+-+-+-+-+
|                                                                       |
+ +-+ + +-+-+ +-+-+ + + +-+ +-+ + +-+ + + + + + +-+ + + + +-+ + +-+ + + +
|   | | |         | | |   |   | | |   | | | | |   | | | | |   | |   | | |
+ + + + +-+ +-+ + +-+-+-+ + +-+ +-+ + + +-+ + +-+-+ + + + + + +-+ + +-+-+
| | | | |     | |     |   | |     | | |   | |   |   | | | | |   | |     |
+ + + +-+ + + +-+-+ + +-+-+ +-+-+ +-+ + + + + +-+-+ + + + + + +-+ + +-+ +
| | |   | | |     | |     |   |     | | | | |   |   | | | | |   | | |   |
+-+ +-+-+ + + + + +-+ + + +-+ + + + + +-+ + +-+ +-+ + + + + + + +-+-+ + +
|       | | | | | |   | |   | | | | |   | |   |   | | | | | | | |     | |
+ + + + + +-+-+-+ +-+ +-+ + + +-+ + + + +-+ + +-+ + +-+ + + +-+-+-+ +-+ +
| | | | |       | |   |   | | |   | | |   | | |   | |   | |       |   | |
+ +-+ +-+ +-+ + + + +-+-+ + + + + +-+-+ +-+-+ +-+ + + +-+ + + + +-+-+ + +
| |     | |   | | |     | | | | | |     |     |   | |   | | | |     | | |
+ + + +-+ + + +-+ + + +-+ + +-+ + + + + +-+ + + + + + + + +-+-+ +-+ + + +
| | | |   | | |   | |   | |   | | | | |   | | | | | | | |   |     | | | |
+ + + + +-+ + + + + +-+ +-+-+-+ + + +-+ +-+ +-+ + + + +-+ +-+-+-+ + + +-+
| | | | |   | | | | |         | | | |   |     | | | |   |   |     | |   |
+ + +-+ +-+ + + + + +-+ +-+-+ +-+ + + + + +-+ + +-+-+-+ + + + +-+ + + + +
| |   |   | | | | | |     |   |   | | | | |   |       | | | | |   | | | |
+ +-+ + + + + + +-+-+ + + + + +-+-+ +-+ + + + + + +-+ + +-+ +-+ + +-+-+ +
|   | | | | | | |     | | | |     | |   | | | | | |   |   | |   |   |   |
+ +-+ + +-+ +-+ + + +-+ + + +-+ + + +-+ + + +-+ +-+ +-+ + + + + +-+-+-+ +
| |   |   |   | | |   | | | |   | |   | | |   |   |   | | | | | |       |
+-+ + + +-+-+-+ + + + + + + + + + + + + + +-+-+ + + + + + +-+-+-+-+-+ + +
|   | |     |   | | | | | | | | | | | | |   |   | | | | | |           | |
+ + + + + +-+ + +-+ + +-+ +-+ + + +-+ + + + + +-+-+ + +-+-+ + + + + +-+ +
| | | | | |   |   | |   | |   | |   | | | | | |     |     | | | | | |   |
+ +-+ +-+ + + + +-+-+-+ + + +-+-+ + + + +-+-+ + + + + +-+ + + +-+ +-+ + +
|   | |   | | |       | | |   |   | | |   |   | | | | |   | | |     | | |
+ + + + + +-+ + + + + + +-+ + +-+ + +-+-+-+-+ +-+ +-+-+ + + +-+-+-+ + + +
| | | | |   | | | | | |   | |   | |       |   |   |     | |       | | | |
+-+-+ +-+ +-+ +-+ + + +-+ +-+ + +-+-+ + +-+ + +-+-+-+-+-+ + +-+ +-+ +-+-+
|     |   |   |   | |   |   | |     | |   | |   |         | |     |     |
+ +-+ +-+ + + + + +-+ +-+-+-+ + +-+ + + + + + + + + +-+ +-+ +-+ +-+ + + +
|   | |   | | | | |   |       |   | | | | | | | | |   | |   |     | | | |
+ +-+-+ + +-+ + +-+-+-+-+ + + + + +-+ +-+ + + + + + + +-+ +-+ + + + + + +
|   |   | |   |   |       | | | | |     | | | | | | | |     | | | | | | |
+ +-+ + + +-+-+ + + +-+ +-+ +-+-+ + + + + +-+-+ + + +-+-+-+-+ +-+ + + + +
| |   | |     | | | |   |   |     | | | | |     | |         | |   | | | |
+ + + +-+-+ + +-+ + + + +-+ + +-+ + +-+ + +-+ + + +-+-+-+-+-+ + + + + +-+
| | | |     | |   | | |   | | |   | |   |   | | |         |   | | | |   |
+ +-+ +-+ +-+-+ + +-+-+ +-+ + +-+-+ + + + + + + +-+-+ + +-+ + +-+-+ + + +
|   |   | |     |     | |   |   |   | | | | | | |     | |   |   |   | | |
+ +-+ +-+ +-+-+ + + + + + +-+ + + + + +-+ + + + + +-+ + + + + +-+ + +-+ +
|   | |     |   | | | | |   | | | | | |   | | | | |   | | | | |   |   | |
+ + + +-+ +-+ + + + + +-+ + + + +-+ +-+ + +-+ + + + + + +-+ + + + + +-+ +
| | | |   |   | | | | |   | | | |     | | |   | | | | | |   | | | | |   |
+ + + + +-+-+ + +-+ + + + + + +-+ +-+ + + + +-+ + +-+ + + + + +-+-+-+ + +
| | | |   |   |   | | | | | | |     | | | | |   |   | | | | | |       | |
+ +-+-+-+ +-+-+-+ + + +-+-+ +-+-+ + +-+ + +-+ + + + +-+ +-+ +-+-+-+-+ + +
| |         |     | | |     |     |   | |   | | | |   | |     |       | |
+ +-+ + + + +-+ + +-+ +-+ +-+ +-+ + + + + + + +-+ +-+ +-+-+ +-+ + +-+ + +
|   | | | |   | | |     |   |   | | | | | | |   |   |   |     | | |   | |
+-+-+ + + + + + + + + + + +-+ +-+ +-+ + + + + +-+ +-+-+ +-+ + + + + + + +
|     | | | | | | | | | |   | |   |   | | | | |       |   | | | | | | | |
+ + + + +-+ + + + +-+ + +-+ + +-+ + + + + + +-+ +-+ + + + + + +-+-+ + + +
| | | | |   | | | |   |   | |   | | | | | | |     | | | | | | |     | | |
+ + + + + +-+-+ + + + + + +-+-+-+ +-+ + + + +-+ +-+ + + + + + + +-+ + + +
| | | | | |     | | | | | |         | | | |   |   | | | | | | | |   | | |
+ + + + +-+ +-+ +-+ + + + + + + +-+ + +-+ + +-+ + + + + + + + +-+-+ + +-+
| | | | |     |   | | | | | | |   | | |   |   | | | | | | | |   |   |   |
+-+ + + + +-+-+-+ + + + + + +-+ + + + +-+-+ + + + +-+ +-+ + +-+-+-+ + + +
|   | | |   |     | | | | |   | | | | |     | | | |     | |   |     | | |
+ + +-+ +-+-+-+ + + + +-+ + + +-+ +-+ + + + + +-+ + +-+-+ +-+ + + + +-+ +
| | |         | | | | |   | | |   |   | | | |   | | |     |   | | | |   |
+ +-+ + + +-+ + + + +-+-+ +-+-+-+ +-+ +-+ + + + + + +-+ +-+ +-+ + + +-+ +
|   | | | |   | | |   |         |   |   | | | | | |   | |     | | | |   |
+ + + + +-+-+-+ +-+ + +-+ + +-+ + + +-+ +-+ + +-+ + + +-+ + + + +-+ +-+ +
| | | |       |   | | |   |   | | |   |   | |   | | |   | | | | |   |   |
+ + + + + + + + + +-+-+ + + +-+ +-+ +-+-+ +-+ + + + + + + + + +-+-+ + + +
| | | | | | | | |     | | | |   |   |       | | | | | | | | | |     | | |
+-+-+-+-+-+-+-+-+-+-+-+-+-+-+-+-+-+-+-+-+-+-+-+-+-+-+-+-+-+-+-+-+-+-+-+-+