+-+-+-+-+-+-+-+
|             |
+ + + + +-+ + +
| | | |   | | |
+ +-+ + + +-+ +
| |   | | |   |
+ + +-+ + + + +
| | |   | | | |
+-+ +-+-+-+ + +
|       |   | |
+ + + + + +-+ +
| | | | |   | |
+-+ +-+ + + + +
|     | | | | |
+-+-+-+-+-+-+-+