+-+-+-+-+-+-+-+-+-+
|                 |
+ + + + +-+ +-+ + +
| | | |   | |   | |
+ + +-+ +-+-+ + + +
| | |     |   | | |
+ + +-+ +-+ +-+-+ +
| | |   |       | |
+ + + +-+ + +-+ + +
| | |   | | |   | |
+ +-+ + +-+ + + + +
|   | |   | | | | |
+ + + +-+ + +-+ + +
| | | |   | |   | |
+ + +-+ + +-+ + + +
| |   | |   | | | |
+ + + +-+-+-+ + +-+
| | |       | |   |
+-+-+-+-+-+-+-+-+-+