+-+-+-+-+-+-+-+-+-+-+-+-+-+-+-+-+-+-+-+-+-+-+-+-+-+-+-+
|   |             |     |   | |     |         |   |   |
+-+ + + +-+-+-+-+ + + + + + + + + +-+ + +-+-+ + + + +-+
|   | | |       | | | |   | |   |   | |     |   | |   |
+ +-+-+ +-+-+ +-+ +-+ +-+-+ +-+-+-+ + +-+-+ +-+-+ +-+ +
| |   |     |   |     |   |   |     | |   |   | |     |
+ + + +-+-+ +-+ +-+-+-+-+ +-+ + +-+-+ + +-+-+ + +-+-+ +
|   |     |   |   |         | |       |     | |   |   |
+-+-+-+-+ +-+ + + + +-+ +-+-+ + +-+-+-+ +-+ + + + + +-+
|       |     | | | | |     | |   |     |   | | | |   |
+ +-+-+-+-+-+-+ + + + +-+-+ + +-+ + +-+-+ + + + +-+-+ +
|       |       | |   |   |   | | | |     | | |       |
+ +-+-+ + +-+-+-+ +-+ + +-+-+-+ + + + +-+-+-+ +-+ +-+-+
| | |   |     | |   | |         | | |       |   |     |
+ + + + +-+-+ + +-+ + + + +-+-+-+ +-+-+-+-+ +-+ +-+-+ +
|   | | |     |   |   | |       |     |   | |   | |   |
+-+-+ +-+ +-+-+ + +-+-+ +-+-+-+ +-+-+ + + + + +-+ + +-+
|   | |   |   | |     |   |   |     |   |   |   | | | |
+ + + + +-+ + +-+ +-+ +-+ + +-+-+-+ +-+-+-+ +-+ + + + +
| |   |     |     | | | | |       |       | | | |   | |
+ +-+-+-+-+-+-+-+-+ + + + + +-+ +-+-+ +-+ + + + +-+ + +
| |         |     |   |   |   |   |   |   | | |   | | |
+ + +-+ +-+ + +-+ + +-+ +-+-+-+-+ + +-+ +-+ + +-+ + + +
| |   | |   | | |   | |   |       |   | |   | |   | | |
+ + +-+ + +-+ + +-+-+ +-+ + +-+-+ +-+ + + +-+ + +-+ + +
|   |   | |   | |   |       |   | | | | | |   | |     |
+ +-+ +-+ + +-+ + + + +-+-+-+-+ + + + + + + +-+ +-+-+ +
|   | | | | | |   |   |       |     | | | | |   |   | |
+-+ + + + + + + +-+-+-+ +-+-+ +-+-+-+ + + + + +-+ + +-+
|   | |   | | | |     | |       |     | | | |     |   |
+ +-+ +-+-+ + + + +-+ + + +-+-+ + +-+-+ + + +-+-+-+-+ +
| |   |     |   | | | | | |   |   |   | |     |     | |
+-+ + + +-+-+ +-+ + + + +-+ + +-+-+ + + +-+-+ + +-+ + +
|   | | |       | | | |   | | |   | |   |   | |   |   |
+ +-+-+ + +-+-+-+ + + + + + + + + + +-+-+ + + +-+ +-+-+
|     | | |       | | | |   | | | |     | |   | |     |
+ +-+ + + + +-+-+-+ + +-+-+ + + + +-+ +-+ +-+-+ +-+-+ +
| |   | | |       | |     | |   | |   |   |   |     | |
+ + + + +-+ +-+-+ + +-+-+ + +-+-+ +-+-+ +-+ + + +-+ + +
| | | |   |   |   |   |   |   |   |         |   |   | |
+ + + +-+ +-+ + +-+-+ + +-+ +-+ + + +-+-+-+-+-+-+-+ + +
| | | |   |   |     |     | |   | |     |         | | |
+-+ + + +-+ +-+-+-+ +-+-+ + + +-+-+-+-+ + +-+-+-+ + + +
|   | | |     |   | |   | | | |         |     |   | | |
+ +-+ + + +-+-+ + + + + + +-+ + +-+-+-+-+-+-+ + +-+-+ +
| | | | | |     | | | | |     | |     |       |     | |
+ + + + + + +-+-+ + + + +-+-+-+ +-+ +-+ +-+-+-+-+-+ + +
| |   | | |     |   | | |           |   |         | | |
+ +-+-+ +-+-+ + +-+-+ + + +-+-+ +-+-+ +-+-+-+-+ + + + +
| |   |     | |       |   |   | |   |   |       | |   |
+ + + +-+-+ +-+ +-+-+-+-+-+ + +-+ + +-+ + +-+-+ +-+-+ +
| | |     |   |       |   | | |   | |   |   |   |     |
+ + +-+ +-+-+ +-+-+-+-+ + + + + +-+ + +-+ + +-+-+ +-+-+
|     |                 |   |   |     |   |           |
+-+-+-+-+-+-+-+-+-+-+-+-+-+-+-+-+-+-+-+-+-+-+-+-+-+-+-+