+-+-+-+-+-+
| |       |
+ + +-+-+ +
| | | |   |
+ + + + +-+
| | |   | |
+ + + +-+ +
|   | |   |
+-+-+ + + +
|       | |
+-+-+-+-+-+