+-+-+-+-+
|       |
+ +-+ + +
|   | | |
+ + + +-+
| | |   |
+ + + + +
| | | | |
+-+-+-+-+