+-+-+-+-+-+-+-+-+-+-+-+-+-+-+-+-+-+-+-+-+-+-+-+-+-+-+-+-+-+-+-+-+-+
|                                                                 |
+ +-+ + + + + +-+ + + + + + +-+-+-+ + +-+-+-+ + +-+ +-+ + +-+ + + +
|   | | | | |   | | | | | |       | |   |     |   | |   | |   | | |
+ +-+ +-+-+ + + + +-+ + + +-+ +-+ + + + + + + + +-+ + + + +-+ +-+ +
|   |     | | | |   | | | |   |   | | | | | | |   | | | | |     | |
+ + + +-+-+ +-+ +-+ + +-+ +-+ +-+-+ + + +-+-+-+-+ + + + + + + + + +
| | |   |     |   | |   |   |     | | |         | | | | | | | | | |
+ + +-+ +-+ +-+ + + +-+ + + +-+ +-+ +-+ + + + +-+ +-+-+ + + +-+ + +
| |   | |   |   | | |   | | |     | |   | | |   |     | | |   | | |
+ + +-+ +-+ +-+ + +-+-+-+-+ +-+ +-+-+ + + + +-+ + + +-+ + + +-+-+ +
| |   |   | |   |   |       |       | | | | |   | | |   | |   |   |
+ + + + + + + + + + +-+-+ + +-+-+ +-+ + + + + + + + + +-+ +-+ + + +
| | | | | | | | | |     | | |       | | | | | | | | | |   |   | | |
+ + + + + +-+-+-+ + + + + + +-+-+-+ + + + +-+ + + +-+ +-+ +-+ +-+-+
| | | | | |       | | | | |       | | | | |   | | |     |   |     |
+ +-+ + + +-+ +-+-+ + + + + +-+ +-+ + +-+ + + + +-+ + +-+ +-+-+ + +
| |   | |   | |     | | | | |   |   | |   | | |   | | |     |   | |
+-+ + + +-+ + +-+-+ + +-+ + + + + + +-+ + + +-+ +-+ + + + +-+ +-+ +
|   | |   | |     | | |   | | | | | |   | | |   |   | | | |   |   |
+ +-+-+ +-+-+ + +-+ + + + +-+ + + + +-+ + +-+-+-+ +-+ +-+ + +-+ + +
|     |   |   |   | | | | |   | | | |   |   |       |   | |   | | |
+-+ +-+ + +-+ +-+ + + + + + + + + + + +-+-+-+-+ +-+-+-+ +-+ +-+ + +
|     | | |   |   | | | | | | | | | |   |             |   |   | | |
+ +-+ + + + + +-+ +-+ +-+ +-+ + + + + +-+ + + + + + + +-+-+ + + +-+
|   | | | | |   | |   |   |   | | | |   | | | | | | | |     | |   |
+ + + + + +-+ +-+ +-+ + +-+ +-+ + + + + + + + + +-+-+-+-+-+ + + +-+
| | | | | |   |     | |   |   | | | | | | | | |   |         | |   |
+ + + +-+-+ +-+-+-+ +-+ + + + +-+ + +-+ + + +-+ +-+ +-+ +-+ + + + +
| | | |         |     | | | |   | |   | | | |   |   |     | | | | |
+ + + + +-+ +-+-+-+-+-+ +-+ + + +-+-+ +-+ + + +-+ + + + + + +-+ + +
| | | | |   |           |   | | |       | | |   | | | | | | |   | |
+ +-+-+ + + +-+-+ + + +-+ +-+-+ + + +-+-+-+-+ +-+ + +-+-+ + + + + +
| |     | |     | | | |   |     | |   |       |   |     | | | | | |
+ + + + +-+ + +-+ + + + + +-+-+ + + + + + + +-+ + + + +-+-+ + +-+ +
| | | | |   |   | | | | |     | | | | | | | |   | | |     | | |   |
+-+-+ + + +-+ + + +-+ + + + + + + + + +-+ +-+-+ +-+-+ + + + +-+ + +
|     | |   | | | |   | | | | | | | | |   |       |   | | |   | | |
+ + + + + + +-+ +-+-+-+ + +-+-+ + + + + + + + + + + + + +-+-+-+-+ +
| | | | | | |         | | |     | | | | | | | | | | | | |         |
+ + + + +-+-+ + + + +-+-+ + +-+ +-+-+ +-+-+-+ +-+ +-+ + +-+ + + +-+
| | | |     | | | | |     |   | |         |   |   |   | |   | |   |
+ + + + + +-+ + + + + +-+-+ +-+ +-+ + + +-+ +-+ +-+-+ +-+-+ + + + +
| | | | |   | | | | |   |   |     | | | |   |       |     | | | | |
+ + +-+ +-+-+-+-+ +-+-+-+ + +-+ +-+-+ +-+ +-+ + +-+-+ + + + + + + +
| | |         |   |       | |     |   |     | |     | | | | | | | |
+ + + + + + +-+-+ + + + +-+ + + + + + + + + + + +-+ + + +-+ +-+-+ +
| | | | | |     | | | | |   | | | | | | | | | |   | | |   |     | |
+-+ +-+ +-+ + + + + + +-+ +-+-+ + + + +-+ + +-+ +-+-+ + +-+ + +-+ +
|     | |   | | | | |   | |     | | | |   | |       | |   | | |   |
+ + + + +-+ + + + + + +-+-+ +-+ + +-+ + + +-+ +-+ + + + + +-+ + + +
| | | | |   | | | | |   |   |   | |   | | |   |   | | | | |   | | |
+-+ +-+-+ + + + + + +-+ + + +-+-+ + +-+ + + + +-+-+ + + + + + + + +
|       | | | | | |   | | | |     |   | | | | |     | | | | | | | |
+-+-+ +-+ +-+ +-+ + + + +-+ + +-+-+-+ + + + + +-+-+ + + + + +-+ + +
|       | |     | | | |   | |       | | | | | |     | | | | |   | |
+ + + + +-+-+ +-+ + +-+-+ +-+ + + +-+-+-+ + +-+ + + + +-+ +-+-+ + +
| | | | |     |   | |       | | |   |     |   | | | | |       | | |
+ + +-+ + + + +-+ + + + + + +-+ + + +-+ + + +-+ + +-+ +-+ +-+ + +-+
| |   | | | |   | | | | | | |   | |   | | | |   |   | |     | |   |
+-+ + + +-+-+-+-+ +-+ + +-+ + +-+ +-+-+-+-+ + + + +-+ +-+ +-+ + +-+
|   | |       |   |   | |   | |   |         | | |   | |   |   |   |
+-+ +-+ + +-+-+ + +-+ + + +-+-+ +-+ +-+ + + + + + + + +-+ +-+ +-+ +
|   |   |     | | |   | |   |     | |   | | | | | | |   |   | |   |
+-+ + + + + + +-+ + + + + + +-+ +-+-+ +-+-+-+ + + +-+ +-+ +-+-+ + +
|   | | | | | |   | | | | |   |     |     |   | |   | |       | | |
+-+-+-+-+-+-+-+-+-+-+-+-+-+-+-+-+-+-+-+-+-+-+-+-+-+-+-+-+-+-+-+-+-+