+-+-+-+-+-+
|     |.|.|
+-+-+-+-+-+
|.|.|.|.|.|
+-+-+-+-+-+
|.|.|.|.|.|
+-+-+-+-+-+
|.|.|.|.|.|
+-+-+-+-+-+
|.|.|.|.|.|
+-+-+-+-+-+
|.|.|.|.|.|
+-+-+-+-+-+
|.|.|.|.|.|
+-+-+-+-+-+
|.|.|.|.|.|
+-+-+-+-+-+
|.|.|.|.|.|
+-+-+-+-+-+
|.|.|.|.|.|
+-+-+-+-+-+
|.|.|.|.|.|
+-+-+-+-+-+
|.|.|.|.|.|
+-+-+-+-+-+
|.|.|.|.|.|
+-+-+-+-+-+
|.|.|.|.|.|
+-+-+-+-+-+
|.|.|.|.|.|
+-+-+-+-+-+
|.|.|.|.|.|
+-+-+-+-+-+
|.|.|.|.|.|
+-+-+-+-+-+
|.|.|.|.|.|
+-+-+-+-+-+
|.|.|.|.|.|
+-+-+-+-+-+
|.|.|.|.|.|
+-+-+-+-+-+
|.|.|.|.|.|
+-+-+-+-+-+
|.|.|.|.|.|
+-+-+-+-+-+
|.|.|.|.|.|
+-+-+-+-+-+
|.|.|.|.|.|
+-+-+-+-+-+
|.|.|.|.|.|
+-+-+-+-+-+
|.|.|.|.|.|
+-+-+-+-+-+
|.|.|.|.|.|
+-+-+-+-+-+
|.|.|.|.|.|
+-+-+-+-+-+
|.|.|.|.|.|
+-+-+-+-+-+
|.|.|.|.|.|
+-+-+-+-+-+