+-+-+-+-+-+-+-+
|             |
+ + +-+ + +-+-+
| |   | |     |
+ + + +-+ + +-+
| | |   | |   |
+ + + + +-+-+-+
| | | |       |
+ +-+ + + +-+-+
|   | | |     |
+ + + +-+ +-+-+
| | |   |     |
+ + + +-+ + + +
| | |   | | | |
+-+-+-+-+-+-+-+