+-+-+-+-+-+-+-+-+-+
|                 |
+ +-+ +-+-+ +-+-+-+
|   |     |       |
+ +-+-+-+-+ + +-+ +
|         | |   | |
+ + +-+ + + +-+-+-+
| |   | | |       |
+ + +-+-+ +-+ + + +
| |     |   | | | |
+ + +-+-+-+ +-+ +-+
| |       |   |   |
+ + +-+-+-+ + +-+-+
| |       | |     |
+ +-+ +-+-+-+-+-+-+
|   |             |
+ + +-+-+-+ +-+ +-+
| |       |   |   |
+-+-+-+-+-+-+-+-+-+