+-+-+-+-+-+
|         |
+ +-+ +-+ +
| |     | |
+ + + + + +
| | | | | |
+ + + +-+ +
| | |   | |
+-+ + + + +
|   | | | |
+-+-+-+-+-+