+-+-+-+-+-+-+-+-+-+-+-+-+-+-+-+-+-+-+-+-+-+-+-+-+-+-+-+-+-+-+-+-+-+-+-+-+-+-+-+-+-+-+-+-+-+-+-+
|                                                                                             |
+ + + + +-+ +-+ + + + +-+-+ + +-+-+ + + + + + +-+ +-+ + + + +-+-+ +-+ + + + + + + + + +-+ +-+ +
| | | |   |   | | | |     | | |     | | | | | |     | | | | |       | | | | | | | | |   | |   |
+ +-+ +-+ + + +-+ + + + + + + + +-+ + + + + +-+-+ + + + +-+ + + +-+ + + + +-+ + +-+-+ + + +-+-+
| |   |   | | |   | | | | | | | |   | | | | |     | | |   | | |   | | | | |   |     | | |     |
+ +-+ + +-+ +-+-+-+ +-+ + +-+ + + + + +-+ + +-+-+ + + + + + + + + + + +-+ + +-+-+ + + +-+-+ + +
| |   |   |   |       | |   | | | | | |   | |     | | | | | | | | | |   | | |     | | |     | |
+-+ + + + + + +-+-+-+ +-+ +-+ +-+ + + + + + + +-+ + + + + +-+ + + + +-+ + + + + + + + +-+ + + +
|   | | | | | |       |     | |   | | | | | |   | | | | |   | | | |   | | | | | | | | |   | | |
+-+ + + + + + + + +-+ + + +-+-+-+-+-+-+ +-+ + + +-+-+-+ + + + + + +-+ + + +-+ + + +-+ +-+ + + +
|   | | | | | | | |   | | |               | | |     |   | | | | |   | | | |   | |   |   | | | |
+ + + + + +-+ + +-+ + + +-+ + + + +-+ + + +-+ + + + +-+ +-+ + +-+ + + + + +-+-+ +-+ + + +-+-+ +
| | | | | |   |   | | |   | | | |   | | | |   | | | |   |   | |   | | | | |       | | | |     |
+ + + + + +-+ + + + + + + + +-+ + + +-+ + + + +-+ +-+ +-+ + + +-+ + + + +-+-+ + + + +-+ + + + +
| | | | |   | | | | | | | |   | | | |   | | |   |   | |   | | |   | | |   |   | | |   | | | | |
+ + + + + + + + + + + + + +-+ + + +-+-+ + + +-+ +-+ + + + + + + + + + + + +-+-+ +-+ + + + + + +
| | | | | | | | | | | | |   | | | |     | |   | |   | | | | | | | | | | |     | |   | | | | | |
+ +-+ + +-+ + +-+ + + + + + +-+ + +-+-+ + +-+ + + +-+ + + +-+ +-+ + +-+ + + +-+ + + + + + + + +
| |   | |   |   | | | | | | |   |     | | |   | | |   | | |     | |   | | |   | | | | | | | | |
+ +-+ +-+ +-+ + + + + + + + +-+ + +-+ + +-+ +-+ + + + + +-+-+ + +-+ + +-+ + + + + + + + + + + +
| |     | |   | | | | | | |   | | |   |   | |   | | | |     | |   | |   | | | | | | | | | | | |
+ + +-+ + +-+-+ +-+-+ + + +-+ + +-+-+ + +-+-+ + + + + +-+ +-+ + + +-+ + + + + +-+ +-+-+-+ + + +
| |   | | |       |   | |   | |     | |     | | | | | |     | | |   | | | | | |     |     | | |
+ + + + +-+ + + + + +-+-+-+-+ +-+ + + + +-+-+-+ +-+ + + +-+ + + + + + +-+ + + + +-+-+ +-+ + + +
| | | | |   | | | |         | |   | | |   |       | | | |   | | | | | |   | | | |       | | | |
+ + + +-+ + +-+ +-+ + + + +-+ +-+-+ + + + + +-+-+ + +-+ +-+-+ + + + + + + +-+-+ + + + + + + +-+
| | | |   |   |   | | | |   | |     | | | | |     | |       | | | | | | | |     | | | | | |   |
+ +-+ + +-+ + + + + + + + + + +-+-+ +-+ +-+ + +-+ + + +-+ +-+-+-+ + + + +-+ + + +-+ + + + +-+-+
|   | | |   | | | | | | | | |   |     |   | |   | | | |   |       | | |   | | |   | | | |     |
+ + + +-+ + +-+ + + + +-+-+ +-+ +-+-+-+-+ + + +-+-+-+ + +-+-+-+ + + + + + + + +-+ +-+ + +-+ + +
| | |   | | |   | | | |     |   |         | |   |     |   |     | | | | | | |   | |   |   | | |
+ + +-+-+ + + +-+ + +-+ + + +-+ +-+ + +-+-+ + +-+ + +-+-+-+ +-+-+-+ + + + + +-+ +-+ + + + + + +
| | |     | | |   | |   | |   | |   |   |   | |   |       | |       | | | | |     | | | | | | |
+ +-+ +-+-+ + + +-+-+ + + + + + +-+ +-+ + + + + + + +-+ + + + + + + +-+ + +-+ + + +-+ + +-+ + +
|   |     | | | |     | | | | |   | |   | | | | | |   | | | | | | |   | | |   | |   | | |   | |
+ +-+ + +-+ + +-+ + +-+ +-+ +-+ + + + + + +-+ + +-+ +-+-+ +-+ +-+-+-+ + + +-+-+-+ +-+-+ +-+ + +
|   | | |   |   | | |   |   |   | | | | | |   |   |     | |   |       | | |           |   | | |
+ + + +-+-+-+ +-+-+-+ + + + +-+-+ + + + + +-+ +-+ +-+ +-+-+ +-+-+ +-+ + + +-+-+ +-+-+ +-+ + + +
| | | |           |   | | |     | | | | | |   |     | |         |   | | | |       |     | | | |
+ +-+ +-+ +-+ + + + +-+-+-+ + +-+-+-+-+ + +-+ + + +-+ +-+ + +-+ + + + + +-+ + + + +-+-+ + + + +
|   | |     | | | |   |     |     |     | |   | |   |   | | |   | | | | |   | | |   |   | | | |
+ + + + + + + + + + + + + +-+ +-+ + + + + + +-+ + +-+ +-+-+-+-+-+ + +-+-+ +-+ + + + + + + + + +
| | | | | | | | | | | | | |     | | | | | |   | | |     |         |     | |   | | | | | | | | |
+ +-+ + +-+ + + + + + + + + +-+-+-+-+ +-+ +-+ + +-+ +-+ +-+-+ + + + + +-+ +-+ + + +-+-+-+ + + +
|   | | |   | | | | | | | |         |   | |   |   | |     |   | | | | |     | | |       | | | |
+ +-+ + + +-+ + +-+ +-+ +-+-+-+ +-+ +-+ + + +-+ +-+ +-+ +-+ + +-+ + + + + + + +-+ +-+ +-+-+ + +
|   | | | |   | |     | |       |   |   | |   | |   |     | | |   | | | | | |   |   |     | | |
+ + + +-+ + +-+ +-+ +-+ + +-+ + + + +-+ +-+ + + + + + + + +-+ +-+-+ +-+-+ + + + + +-+ + + + + +
| | | |   |   | |     | |   | | | | |     | | | | | | | | |       |     | | | | |   | | | | | |
+ + + + +-+-+ +-+ + +-+ + +-+ + + +-+ + + + +-+ +-+ + +-+ +-+ +-+ + + +-+ + + + + + + + + +-+ +
| | | | |     |   |   | | |   | | |   | | |   |   | | |   |     | | |   | | | | | | | | |   | |
+ +-+ +-+-+ + +-+-+-+ + +-+-+ + +-+ + + + + +-+ + + + + +-+-+ +-+-+-+ + + +-+-+ +-+-+-+ + + + +
| |       | |   |     |   |   |   | | | | |   | | | | |   |       |   | |   |     |     | | | |
+ +-+-+ +-+ + + + +-+-+-+ + +-+ + + + + + + + +-+ + + + + +-+ + +-+-+ +-+-+-+ + + + + +-+-+ + +
|   |     | | | |   |     |   | | | | | | | | |   | | | | |   | |         |   | | | |     | | |
+-+ +-+ + + + +-+-+ + + + + + +-+ +-+-+ + + +-+ + +-+-+-+ + +-+ + +-+ + + + + + + + + + +-+ +-+
|   |   | | |   |   | | | | |   |     | | | |   |   |     | |   |   | | | | | | | | | | |     |
+ + +-+-+-+-+ +-+-+-+ +-+-+-+ + + + + + +-+ + + +-+ + + + + + + +-+ + + + + + + + + +-+ +-+-+ +
| |       |   |           |   | | | | | |   | | |   | | | | | | |   | | | | | | | |   | |     |
+ + + +-+ +-+ + + + +-+ + +-+-+-+-+ + + + + + + + + +-+-+-+-+ +-+-+ +-+ +-+ +-+ + + + + + +-+ +
| | |   | |   | | | |   |   |       | | | | | | | |       |   |       |   |   | | | | | |   | |
+ + + + + +-+ + + +-+-+ +-+ +-+-+-+ + + +-+ + + +-+ + +-+ +-+ +-+ +-+ +-+ + +-+ +-+ + + + + + +
| | | | | |   | | |       |     |   | | |   | |   | |   | |     |   |   | | |     | | | | | | |
+ +-+ + + +-+ + + + + + + + + +-+ + +-+ + + +-+ + +-+ +-+ + + + + + +-+-+-+ + +-+ + + + + + + +
|   | | |   | | | | | | | | |   | | |   | | |   | |     | | | | | |   |     | |   | | | | | | |
+-+ +-+-+-+ + + + +-+ + + + +-+-+-+ +-+ + + +-+ +-+ + + +-+-+-+-+-+ +-+ +-+-+-+ + + +-+-+ + + +
|       |   | | | |   | | |       |   | | |   |   | | |         |     | |       | |     | | | |
+ +-+-+ + + + + +-+ +-+ +-+-+ +-+ +-+ +-+ +-+ + +-+ + + + +-+ + +-+-+ + + + + + + + +-+ +-+ + +
|   |   | | | | |     |     | |   |   |     | | |   | | | |   | |     | | | | | | |   | |   | |
+ +-+ +-+ + + +-+-+ +-+-+ + +-+ +-+ + +-+ + + + +-+ + + + + + +-+ +-+-+-+ + +-+ + + +-+-+ + + +
| |     | | |     |   |   | |     | | |   | | | |   | | | | |   |       | | |   | | |     | | |
+ + + + +-+ +-+ +-+-+-+ +-+-+ + + + +-+ + + +-+ + + + + + + +-+ + +-+ +-+-+ + +-+-+-+-+ + + +-+
| | | | |     |   |       |   | | | |   | | |   | | | | | |   | |   |   |   |     |     | |   |
+-+ + + +-+ + +-+-+-+-+ + +-+ + + +-+ + + + + + + + + + +-+-+-+ + + +-+-+-+ + + + +-+ + +-+-+ +
|   | | |   |       |   |   | | |   | | | | | | | | | |     |   | |     |   | | | |   |     | |
+ +-+ + + +-+ +-+-+ + + + + +-+ +-+-+ + +-+ +-+-+ +-+-+-+ +-+ + + + + + + +-+ + +-+ + + +-+-+ +
|   | | |   |   |   | | | | |     |   |   | |         |     | | | | | | |   | | |   | |     | |
+ +-+ + + + + +-+-+-+ +-+-+ + + + +-+ +-+ + +-+ +-+ +-+ + + + + + + + +-+-+ + + + + +-+-+ +-+-+
|   | | | | | |         |   | | |   | |   |   |   | |   | | | | | | |   |   | | | |     |     |
+ + + +-+-+ + +-+ + + + + + + + + + + +-+ + +-+-+-+ + + + + +-+-+-+ + +-+ + + + + +-+ + +-+-+ +
| | |     | |   | | | | | | | | | | | |   |       | | | | | |       |   | | | | |   | |   |   |
+ +-+-+ + + +-+ +-+ + + + +-+-+ + +-+ + +-+ + +-+ + + +-+ +-+-+-+-+ + +-+ + + +-+ +-+-+ + + + +
|   |   | |   | |   | | | |     |   | |   | |   | | | |           | | |   | |   |     | | | | |
+ + +-+-+ +-+ + + + + +-+ + + + +-+-+ + +-+-+ + + + + + +-+ + +-+-+ +-+ + + + + + +-+ + + + + +
| | |       | | | | | |   | | |     | |   |   | | | | |   | | |       | | | | | |   | | | | | |
+ + + + + +-+ +-+ + + + + + +-+ + + + + + +-+ + +-+-+ + + +-+-+ +-+ +-+-+ +-+ +-+ + + + +-+-+ +
| | | | | |     | | | | | |   | | | | | | |   |     | | |   |   |     |     |   | | | |   |   |
+-+-+ +-+ + + + + + + + +-+ + + + + + + +-+ +-+ +-+ +-+ + +-+-+ +-+ + + + +-+-+ +-+ + + + + + +
|       | | | | | | | |   | | | | | | |   |   |   |   | |   |     | | | |     | |   | | | | | |
+ + +-+ + +-+ +-+-+ + + +-+ +-+ + + + + + + + + +-+-+-+-+ + +-+ + + + + + +-+-+ +-+ + + + + + +
| | |   | |       | | |   | |   | | | | | | | |     |     |   | | | | | | |       | | | | | | |
+ + + + + + +-+ +-+ + +-+-+ + + + +-+ +-+ + +-+-+-+-+ +-+-+ +-+ + + +-+-+ +-+ + + +-+ + + + + +
| | | | | |   |   | | |     | | | |   |   |     |       |     | | | |     |   | | |   | | | | |
+-+-+-+-+-+-+-+-+-+-+-+-+-+-+-+-+-+-+-+-+-+-+-+-+-+-+-+-+-+-+-+-+-+-+-+-+-+-+-+-+-+-+-+-+-+-+-+