+-+-+-+-+-+-+-+-+-+-+-+-+-+-+-+-+-+-+-+-+-+-+-+-+-+-+-+-+-+-+-+-+-+-+-+
|   | |       |   |   |   |   |   |     |   |   |         |   |       |
+-+ + +-+-+ + + +-+-+ +-+ +-+ +-+ + +-+-+-+ +-+ +-+ +-+ +-+ +-+ +-+-+ +
|   |   |   |   | | |       |         |     |   |   | | |     | | | | |
+-+ +-+ +-+-+ +-+ + +-+-+ + + +-+-+-+ + +-+-+-+ + +-+ +-+-+-+ + + + +-+
|   |   |   |         | | |         |       | |         |   |     | | |
+-+ + + +-+ +-+-+-+-+ + +-+ + + +-+ + + +-+-+ + +-+ + +-+ +-+-+ +-+ + +
|   | | |     |     |       | | |   | | |     | | | |   | |   |     | |
+-+ +-+ +-+ +-+ +-+-+ + + +-+ + + + +-+-+-+ +-+-+ + + + + + + + + +-+ +
|     |     |       | | |   | | | | |           |   | | | | | | |     |
+-+ +-+-+ +-+-+-+ +-+-+ +-+ + +-+ +-+ +-+-+ +-+ +-+ + +-+ +-+ +-+-+ +-+
|     |         |   |     | |   | |   | |   | | | | |     | | |       |
+-+ +-+ +-+-+ +-+-+ +-+ + + +-+ +-+ +-+ +-+-+ + + +-+-+ + + + + + +-+ +
|       |             | | | |   |     |             |   |       |   | |
+-+ +-+-+ +-+-+ + +-+-+-+ +-+ +-+ +-+ +-+ +-+ +-+ +-+ +-+-+-+-+ + +-+ +
|       | |   | |         | | | |   | | |   | | | | |     |     | | | |
+-+ +-+ + + +-+-+ + + +-+ + +-+ + +-+ + + +-+ + + + + + + + +-+-+-+ + +
|     | | |   |   | | | | |     | |     |   |   | | | | | | |   |   | |
+ +-+-+ +-+-+ +-+-+-+ + + +-+ +-+-+-+ +-+ +-+ +-+ + +-+ +-+-+-+ + + + +
|   | | | |       |   | |       | | |   |   | |   | | |     |   | | | |
+-+-+ + + +-+ +-+-+ + + +-+-+ +-+ + +-+-+-+ +-+ +-+ + +-+ + + +-+-+ + +
|   |   | | |     | | |   | |       |   |   |   | | |   | | |       | |
+ + + + + + + + +-+-+-+-+ + +-+-+-+ + +-+ +-+-+ + + + +-+ +-+-+-+ +-+-+
| |   |     | |       |     | |   |         | | |     |             | |
+-+ + +-+-+ + +-+ + +-+-+-+ + + + +-+-+-+-+ + + +-+ +-+-+-+ + + +-+ + +
|   |   | |     | |     |   |   | |     | |   |   | | |     | | |     |
+ + + +-+ +-+ + +-+-+-+-+ +-+-+-+ + +-+ + + +-+-+ + + + +-+-+-+-+ +-+-+
| | | |   |   | |       |     |       | |     | |       |       |   | |
+ +-+ +-+ +-+-+-+-+ +-+ +-+ +-+ +-+-+-+-+ +-+-+ + +-+ + +-+-+-+ +-+ + +
| |   | |   | |       | |     |         | |         | | | |         | |
+ +-+-+ + +-+ +-+ + + + + +-+-+ +-+ + +-+ +-+-+ +-+ +-+-+ +-+ +-+ +-+ +
|     |           | | |   |     |   |     |     |       | |   | |     |
+-+ +-+-+ +-+ + +-+-+ +-+ + +-+-+ +-+-+ +-+ +-+-+-+-+ +-+ + +-+ + +-+-+
| |     |   | |   |     | | |         | |   | |       |       | |     |
+ + +-+-+ +-+ + +-+-+-+ + +-+-+ +-+-+ +-+-+ + +-+-+-+ +-+ +-+ + +-+-+-+
|     | | |   |   | | | |   |     | |   | | |   |     |     | | | |   |
+ + +-+ +-+ +-+ +-+ + +-+-+-+-+-+ + +-+-+ + + + + + + +-+-+ +-+ + +-+ +
| |       | |   |       |     |   |           | | | | |     | |     | |
+-+-+ +-+-+ +-+-+ +-+-+-+ +-+-+ +-+-+ +-+-+-+ + + +-+-+-+-+ + + +-+-+ +
|         |             |     |   |     |   | | | |   | |         |   |
+-+ +-+ + +-+-+ +-+-+ +-+ +-+ + +-+-+-+-+ +-+ +-+-+ +-+ + +-+ +-+ + +-+
|   |   |   |   |         | | |   | |     | |     |     |   |   |     |
+ +-+-+-+-+-+-+ +-+-+-+-+-+ + +-+-+ +-+-+ + +-+-+-+ +-+ + +-+-+-+ + + +
|     |   |     |     |   |   |       |     | |   |   |         | | | |
+ +-+ + +-+-+-+ +-+-+ +-+ +-+-+-+ +-+-+ +-+-+ +-+ +-+ +-+ + +-+ + +-+ +
|   | |   | | |   |   | |           | |     |   |   |   | | |   |   | |
+ +-+-+ +-+ + + +-+-+ + +-+ +-+-+-+ + + +-+-+-+ + + + + +-+ +-+ + +-+ +
|     |   |   |     |             |             | |   |   | |   | |   |
+ +-+-+-+ + +-+ +-+-+-+ +-+ +-+-+-+ +-+ +-+ +-+-+-+-+ + +-+-+ +-+-+-+-+
|   |     |         |   | | |     |   |   | |     |   |   |   |     | |
+-+-+-+ + +-+ + +-+-+-+-+ + + +-+ +-+ +-+-+ + +-+ +-+-+-+-+ +-+ +-+ + +
|     | |     |   |   |       | | |     |     | | |   |   |       |   |
+-+ + +-+-+ + +-+ + +-+-+ +-+-+ + +-+-+ + +-+-+ + +-+ + +-+-+-+-+ +-+ +
| | | |   | |   |           |   |   | | |   | |     | | |   | | |   | |
+ + + +-+ + +-+-+ + +-+ +-+-+-+ +-+-+ +-+-+-+ +-+-+ + + + +-+ + +-+ + +
|   |       |     |   |       |         |     | | |         |     | | |
+-+-+-+ +-+ +-+-+ +-+ +-+-+-+ + +-+-+ +-+-+ + + + + +-+-+-+-+-+ + + + +
| | |   |     |   | |   |   | |   | | |   | |   |           |   |   | |
+ + + +-+ + + + + + + + +-+ + + +-+ + +-+ +-+ +-+-+ +-+ +-+-+ + +-+ +-+
|       | | | | | |   | |     |   |       | |         |   | | |   |   |
+ + +-+-+-+ +-+-+ +-+-+ +-+ +-+-+ + +-+-+ + + + +-+ + +-+-+ +-+ + + +-+
| |     |   | |     | | |   |   | | | |   | | | |   |       |   | |   |
+ +-+ +-+-+-+ +-+-+ + + + +-+ +-+-+ + + +-+ +-+-+-+-+ + +-+-+-+ +-+ +-+
|   |     |   |     |   | |           |   |         | | |     |   | | |
+ + +-+-+ +-+ +-+ +-+-+ + + +-+-+-+-+ +-+-+-+ + +-+ +-+-+ +-+-+-+-+ + +
| |     |   |       |   |         |   |     | |   | | |     | |   | | |
+ +-+-+ + + + +-+ +-+-+ + +-+ +-+-+ +-+-+-+ +-+ +-+-+ + +-+-+ +-+ + + +
| |   | | | |   | | |   |   | | |                     | |     |     | |
+ + +-+ +-+ +-+-+-+ + +-+ +-+ + + +-+ + +-+-+ +-+-+-+ + +-+-+ +-+-+ + +
| |       |   |         |   |   | |   |     | |                       |
+-+-+-+-+-+-+-+-+-+-+-+-+-+-+-+-+-+-+-+-+-+-+-+-+-+-+-+-+-+-+-+-+-+-+-+