+-+-+-+-+-+-+-+-+
| |             |
+ +-+ +-+ +-+-+ +
|   | |   | |   |
+-+ +-+ +-+ + +-+
| |     |     | |
+ +-+-+-+ +-+-+ +
|     |   |     |
+ +-+-+ +-+-+ + +
| |     |     | |
+ + +-+-+ +-+-+ +
| |   |   | |   |
+ +-+ + +-+ + +-+
|   |   | |   | |
+ +-+-+-+ + +-+ +
|               |
+-+-+-+-+-+-+-+-+