+-+-+-+-+-+
| |       |
+ + +-+-+ +
|   |   | |
+-+-+ +-+ +
|   |     |
+ + + +-+-+
| |   |   |
+ +-+-+ + +
|       | |
+-+-+-+-+-+