+-+-+-+-+-+
|         |
+-+-+-+-+ +
|       | |
+ +-+-+ + +
| |.|.|   |
+ +-+-+-+-+
|   |.|.|.|
+-+-+-+-+-+
|.|.|.|.|.|
+-+-+-+-+-+
|.|.|.|.|.|
+-+-+-+-+-+
|.|.|.|.|.|
+-+-+-+-+-+
|.|.|.|.|.|
+-+-+-+-+-+
|.|.|.|.|.|
+-+-+-+-+-+
|.|.|.|.|.|
+-+-+-+-+-+
|.|.|.|.|.|
+-+-+-+-+-+
|.|.|.|.|.|
+-+-+-+-+-+
|.|.|.|.|.|
+-+-+-+-+-+
|.|.|.|.|.|
+-+-+-+-+-+
|.|.|.|.|.|
+-+-+-+-+-+
|.|.|.|.|.|
+-+-+-+-+-+
|.|.|.|.|.|
+-+-+-+-+-+
|.|.|.|.|.|
+-+-+-+-+-+
|.|.|.|.|.|
+-+-+-+-+-+
|.|.|.|.|.|
+-+-+-+-+-+
|.|.|.|.|.|
+-+-+-+-+-+
|.|.|.|.|.|
+-+-+-+-+-+
|.|.|.|.|.|
+-+-+-+-+-+
|.|.|.|.|.|
+-+-+-+-+-+
|.|.|.|.|.|
+-+-+-+-+-+
|.|.|.|.|.|
+-+-+-+-+-+
|.|.|.|.|.|
+-+-+-+-+-+
|.|.|.|.|.|
+-+-+-+-+-+
|.|.|.|.|.|
+-+-+-+-+-+
|.|.|.|.|.|
+-+-+-+-+-+