+-+-+-+-+-+-+-+-+-+-+-+-+-+-+-+-+-+-+-+-+-+-+-+-+-+-+-+-+-+-+-+-+-+-+-+-+-+-+-+-+-+-+-+-+-+-+-+-+-+-+
| |                 | |   |       |           |       |                   |         |       |       |
+ +-+ + +-+-+-+-+-+ + + + + + +-+-+ + +-+-+-+ +-+ + +-+ +-+-+-+-+-+ + +-+ + +-+ +-+ +-+-+ + +-+-+ + +
|   | | |     |     | | |   | |     |   |   | |   | |     |       | | | | | |   | | |     | |     | |
+-+ +-+ + +-+ + +-+-+ + +-+-+ + +-+-+-+ + + + + +-+-+ +-+-+ +-+-+ +-+ + + + + +-+ + + +-+-+ + +-+-+ +
| |   | |   |   |     |     |     |     | | | | |     |     |   |     | | | | |     |   |   |   | | |
+ +-+ + +-+-+-+ + +-+ +-+-+ +-+-+-+ +-+-+ + + + + +-+-+ +-+-+ + +-+-+-+ + + + +-+ +-+-+ + +-+-+ + + +
| |   |       |   |   |     | |     |     | | |   |   | |     | |       | | |   | |     |     | | | |
+ + +-+-+ +-+ +-+-+-+-+ +-+-+ + +-+-+-+-+-+ + +-+ + +-+ + +-+-+ +-+-+-+ + + +-+ + + +-+-+-+-+ + + + +
|   |   | | | |         |     |   |         |   | |   |   | |   |     | | |   | | |         |   |   |
+ +-+ + + + + + +-+-+-+-+ +-+ +-+ + + +-+-+-+-+ + +-+ +-+-+ + + + +-+ + + +-+-+ + +-+ +-+-+ +-+ +-+-+
| |   | |   |     |     |   |   | | |         | |     |     | | |   | |   |     |   |   |   |   |   |
+ + +-+ +-+ +-+-+ + +-+ + +-+-+ + + +-+-+-+ + + +-+-+ +-+ + + +-+-+ + +-+ + +-+-+-+ +-+-+ +-+ +-+ + +
| | | |   | |   |   |   | |     | |     |   | |     |   | | |       |   | |       |     |   | |   | |
+ + + +-+ +-+ + +-+-+ +-+ + +-+-+ +-+-+ + +-+ +-+-+ +-+ +-+ +-+-+-+-+-+ + +-+-+-+ +-+-+ +-+ +-+ +-+ +
|   |     |   | |       | |     |     | | |     |   |   |     |   |   | |     |   |   | |   |   |   |
+-+-+ +-+-+ +-+ +-+-+-+ +-+ +-+ +-+-+ +-+ +-+-+ + +-+ +-+ +-+-+ + + + + +-+-+ + +-+ +-+ + +-+ +-+ +-+
| |   |     |       | |   | |   |   |   |     | |   |   |       |   | |   | | | |   |   | |   | |   |
+ + +-+ +-+-+-+-+-+ + +-+ +-+ + + + +-+ + +-+ +-+-+ +-+ + +-+-+-+-+-+ +-+ + + + + + + +-+ + +-+ +-+ +
|   |     |       | |     |   |   | |   |   |     | |   | |     |     |   | | | | |   |   | |   |   |
+ +-+-+ + + +-+-+ + +-+ +-+ +-+-+ +-+ +-+-+ +-+-+ + + +-+ +-+-+ + + +-+ +-+ + + + +-+-+-+ + + + + +-+
|     | |   | |   |   |     |     |   |   |   | |   | |   |     | | |   | |   | |       |     | |   |
+-+-+ +-+-+ + + +-+-+ +-+-+-+-+-+-+ +-+ + +-+ + +-+-+ + +-+ + +-+ + + +-+ + +-+ +-+-+-+ + +-+-+-+-+ +
|     |   |   |   |     |   |       |   |   | | |     |   | | |   | | |     |   |     | | | |       |
+ +-+-+ + +-+ +-+ +-+-+ + + + +-+-+-+ +-+-+ + + + +-+-+-+ + +-+ +-+ + +-+ +-+ +-+ +-+-+ + + + +-+-+ +
| |     | | | | | |   | | | | |       |   | | | | |     | | |   | | |   | |   | |       |   | |     |
+ + +-+-+ + + + + + + + + + + + +-+-+-+ + + + + + +-+ + + + + +-+ + +-+ + + +-+ + +-+-+-+-+-+ +-+-+-+
| | |   | | | | |   | |   |   | |     | | | | | |   | |     |   |   | | |   | |   |         |       |
+ + + +-+ + + + +-+-+ +-+-+-+-+ + +-+ +-+ + + + +-+ + +-+-+-+ + +-+ + + +-+-+ + +-+ +-+ +-+ +-+-+-+ +
| | |     |     |   |       | |     |   |   | |   | | |     | |   |   |   |     |   |   | |   |     |
+ + + +-+-+-+-+-+ + + +-+-+ + + +-+-+-+ + +-+ +-+ + +-+ +-+ +-+-+ +-+ +-+ +-+-+ +-+-+ +-+ +-+ + +-+ +
|   | |           | |   |   |   | |   | |   |   |       |         | | | |     |   |   |   |   | |   |
+-+-+ +-+-+ +-+-+-+ +-+ + +-+ +-+ + + + +-+-+-+ + +-+-+-+-+-+-+-+-+ + + +-+-+ +-+ + +-+ + + +-+ + +-+
|   |       | |   |   | | | |     | |   |     | | |       |       |       | |   |   |   | |   | |   |
+-+ +-+-+-+-+ + + +-+ +-+ + + +-+-+ +-+ + + +-+ +-+ +-+-+ + +-+-+ +-+-+-+ + +-+ +-+-+-+ + +-+ + +-+ +
|   |   |       | |   |   |   |     |   | |     |   |   |   |   |     |       | |     | |   |   | | |
+ + +-+ + +-+-+-+ + +-+ +-+ +-+ +-+-+ +-+ +-+-+-+ +-+ +-+-+-+-+ +-+-+ +-+-+-+-+ + +-+ + +-+-+-+-+ + +
| |     |       |   |   |   | | |     | |         |             |   |       |   | |   |     |     | |
+ +-+-+ +-+-+-+ +-+-+-+ + +-+ + +-+-+ + +-+-+-+-+-+-+-+-+ +-+-+ + + +-+-+-+ + +-+ + +-+-+-+ + +-+ + +
| |     |     | |       |     |     | |       |           |   | | |       | |     | |   |   |   |   |
+ +-+-+ +-+-+ + + + +-+-+-+-+ +-+-+ + +-+ +-+ +-+ +-+-+-+-+ + + + + +-+-+ + + +-+-+ + + + +-+-+ +-+-+
|     |       | | | |     |       | |     | |   |   |       |   | |   |   | |     |   | |       |   |
+-+-+ +-+-+-+-+ +-+ + +-+ + +-+-+-+ +-+-+-+ +-+ +-+ + +-+-+-+-+-+ +-+ +-+-+ +-+-+ +-+-+ +-+-+-+ + + +
|   |     |     |   | | | |   |     |               |   |     |   |   |   | |   | |   |       | | | |
+ + +-+-+ + +-+-+ +-+ + + +-+-+ +-+ +-+-+ +-+-+-+-+-+-+ + +-+ + +-+ + + + + +-+ + +-+ +-+-+-+ + +-+ +
| |       | |     |   | |     | |   |   | |       |   |   |   | | | | | | |   |     |   |   | |     |
+ +-+-+-+ + +-+ +-+ +-+ +-+-+ + +-+-+ + +-+ +-+-+ + + +-+-+ +-+ + + + + + +-+ +-+-+ +-+ + + + +-+-+ +
| |     | |   |   | |   |     | |     |   |   | | | |     |   |   | | | |     |   |     | | |   |   |
+ +-+ + + +-+ +-+ + + +-+ +-+-+ + +-+-+-+ +-+ + + + +-+ +-+-+ +-+-+ + + +-+-+-+ + +-+-+-+ + +-+ +-+ +
|   | |   | |     | | |   |     | |     |   |   | | | |       |   | | |     |   |   |     |   |   | |
+-+ + +-+-+ +-+-+-+ + + +-+ +-+ + + +-+ +-+ +-+ + + + +-+-+-+-+ + + + +-+-+ + +-+-+ + +-+-+-+ +-+ + +
|   |     |         |       |   |   | | | |   | | |       |     | | | |   |   |   | | |     |   | | |
+ +-+-+-+ + +-+ +-+-+-+-+-+-+ +-+-+-+ + + +-+ + + +-+-+-+ + + +-+ + + + +-+-+-+ + + + +-+ +-+-+ + + +
| |       |   | |       |   |   |     | |   |   |       | | | | | | | |         | |   |   |     | | |
+ + +-+-+ +-+ + + +-+-+ + +-+-+ + + + + + + +-+-+-+-+-+ + + + + + + + +-+-+-+ +-+-+-+-+ +-+ +-+-+ +-+
| | |   |     | |   |   | |     | | | |   | |     |   | | | | | |   | |       |       |     |       |
+ + + + +-+ +-+-+-+ + +-+ + +-+-+-+ +-+-+-+ + +-+ +-+ + + +-+ + +-+-+ + +-+-+-+ +-+-+ + +-+-+ +-+-+ +
| | | | |   |   |   | |   |       |   |     |   | |   | |   | |       | |       | |   | |   |   |   |
+ +-+ + +-+-+ + + +-+ + + +-+-+-+ + + + +-+-+-+ + + + + +-+ + + +-+-+-+ + +-+-+-+ + +-+ + + +-+ + +-+
|     |       |     | | |   |   | | | |     |   |   | |   |   |   |     |   |     |     | |     |   |
+ +-+-+-+-+ +-+-+-+-+ + + +-+ + + +-+ +-+-+ + +-+-+-+ +-+ +-+-+-+ +-+-+ +-+ + + + +-+-+-+ +-+-+-+-+ +
| | |     | |   |   | | |     |   |   |     | |     |   |   |         |   | | | | |     | |     |   |
+ + + +-+ + + +-+ + + + +-+-+-+-+-+ +-+ +-+-+ + +-+ +-+-+-+ + +-+-+-+ + + + +-+ + + + +-+ + +-+-+ + +
|   |   | |   |   |   | |     |       |     | |   |       | | |     |   | |     | | |       |   | | |
+-+ +-+ + +-+ + +-+-+-+ + + + +-+-+-+ +-+-+ + +-+ +-+-+ + + +-+ +-+ +-+ +-+-+-+-+ + +-+-+-+-+ + + + +
| | |   |   | | |       | | |   |         | |   | |   | | | |   | | |   |   |     | | |       |   | |
+ + + +-+-+ + + +-+ +-+-+ + +-+ + +-+-+-+ + +-+ + + + + + + + +-+ + +-+-+ + + +-+-+ + + +-+-+-+-+-+ +
| | |     | | |   | |     | | |   |   |   |   |     | | | | | |   |       | | |       |   |         |
+ + +-+-+ + +-+ + + + +-+-+ + +-+-+ + + +-+-+ + +-+-+ + + + + +-+ +-+-+-+-+ + +-+-+-+ +-+ + +-+-+-+-+
|   | |   |   | | | |   |   |       |   | |   | |   | | | | |   | |     |   |     |     | |         |
+ +-+ + +-+-+ +-+ + + +-+ +-+-+-+-+-+ +-+ + +-+-+ + +-+ +-+ +-+ + + +-+ + +-+-+-+ + +-+-+ +-+-+-+-+ +
|     |   | |   | | | |   |         |   | |     | |   |   |   | |   |   |     |   |   |   |       | |
+-+-+ +-+ + +-+ + + +-+ +-+ +-+-+-+ +-+ + +-+-+ + +-+ +-+ +-+ + +-+-+ + +-+-+ + +-+-+-+ +-+ +-+-+ + +
| |   |   |     | |     |       |   |   |     | | | | |     | |       |     | | |     | |   |   | | |
+ + +-+ +-+ +-+-+ +-+-+ + +-+-+-+ +-+ +-+ +-+ + + + + + + +-+ +-+-+-+-+-+-+ + + + +-+ + + +-+ + + + +
|   | | |   |   |   |   |   |     |   | | |   |   | |   | |   |     |     | | | |   |   |     | | | |
+ +-+ + +-+ + + +-+ +-+-+-+ + +-+-+-+ + + + + +-+-+ +-+-+ + + +-+-+ + +-+ + + + + + +-+-+ +-+-+ + + +
| |   |   |   |   | |     | |       | |   | | |     |   | | |       |   |   |   | | |     | |   | | |
+ + + +-+ +-+-+-+ + + +-+ + +-+-+-+ + +-+ + + +-+ + + +-+ + +-+ +-+-+-+ +-+-+-+-+-+ + +-+-+ + +-+-+ +
| | |   |       | |   |   |   |   | |   | | |     |   |   |   | |     | |           |     | |     | |
+ +-+ + +-+-+-+ + +-+ + + +-+ + + + +-+ + + +-+ +-+-+-+ +-+-+ + + +-+ + +-+-+-+-+ +-+-+-+ + +-+-+ + +
| |   | |       |   | | | |     | |   | | | | | |       |     | |   |   |         |   |   |     |   |
+ + +-+ + +-+-+-+-+ +-+ +-+ +-+-+ +-+ + + + + + + +-+-+-+ +-+-+-+-+ +-+-+ +-+-+-+-+ + + +-+-+ +-+-+-+
|   | | |     |     |   |   |   | |   | | | |   |   |   | |         |       |   |   | | |   |       |
+-+-+ + +-+-+ +-+ +-+ + + +-+ + +-+ +-+ +-+ +-+-+-+ + + + + +-+-+-+-+ +-+-+ + + +-+ + + + + + +-+-+ +
|   |   |   |   |     | | | | |     |       |       | |   | |       | | |   | | |   | |   | | |   | |
+ + + +-+ + +-+ + +-+-+ + + + +-+-+-+-+-+-+-+ +-+-+-+ +-+-+ + +-+ +-+ + + +-+ + + +-+ +-+-+ + +-+ + +
| | | |   |   | | |   | | | | |               |     |   |   |   | |   | | |   | |   | |     |     | |
+ +-+ +-+ +-+-+ + + + +-+ + + + +-+-+-+-+-+-+-+-+ + +-+ + +-+-+ + + +-+ + + +-+ +-+ + + +-+-+-+-+-+ +
|   |   | |     | | | |   | | |     |             | |   |   |   |       | | | | |   | | |       |   |
+ + +-+ + + + +-+-+ + + +-+ + +-+-+ + + +-+-+-+-+-+ + +-+-+ + +-+-+-+-+-+ + + + + +-+-+ + + +-+ + + +
| | |   | | | |     | |     |     | | | |       |   |   |   | |     |   |   | | |   |   | |   |   | |
+ + + +-+ + +-+ +-+-+ +-+-+ +-+ + + +-+ +-+ +-+-+ +-+-+ + +-+ +-+ + + + +-+ + + + + + +-+-+-+ +-+-+ +
| | |     |   | |   |         | | | |   |   |     |   |   |     | | | |   | | | | | | |     |     | |
+ + +-+-+ +-+ + +-+ +-+-+-+-+-+ + + + +-+ + + +-+-+-+ +-+-+-+-+ + + + +-+ + + + + + + +-+ + +-+-+ + +
| |     | |   |     |           | |   |   | |   |   |   |     |   | | | | |   | | | | |   |       | |
+ + +-+-+ + +-+-+ +-+ +-+-+-+-+ +-+-+-+ + +-+-+ + + + + +-+ + +-+-+ + + + +-+-+ + + + + +-+-+-+-+-+ +
| |       | |   | |   |         |       | |     | |   | |   | |   | | |   |     | |   |   |       | |
+ +-+-+-+-+ + + + + +-+-+-+-+-+-+ +-+ +-+-+ +-+-+ +-+-+ + +-+ + + +-+ + +-+ +-+-+ +-+-+-+ + +-+ +-+ +
|         |   |   |                 |             |       |     |     |     |             |   |     |
+-+-+-+-+-+-+-+-+-+-+-+-+-+-+-+-+-+-+-+-+-+-+-+-+-+-+-+-+-+-+-+-+-+-+-+-+-+-+-+-+-+-+-+-+-+-+-+-+-+-+