+-+-+-+-+-+-+-+-+-+-+-+-+-+-+-+-+-+-+-+-+-+-+-+-+-+-+-+-+-+-+-+-+-+-+-+-+-+-+-+-+-+-+-+-+-+-+-+-+-+-+
|                                                                                                   |
+ + +-+ +-+ + + + +-+-+-+ +-+-+-+ +-+ + +-+-+-+-+ +-+-+-+-+-+ + +-+ +-+-+-+-+ + +-+-+ +-+ + +-+ +-+ +
| |   |   | | | |       |       |   | |         |           | |   |         | |     |   | |   |   | |
+ +-+-+ +-+-+ + + +-+-+ + + + +-+-+ +-+ +-+ +-+ + + +-+-+ + +-+ +-+ +-+ +-+-+-+ +-+ +-+-+ + +-+-+ +-+
|     |     | | |     | | | |     |   |   |   | | |     | |   |   |   |       |   |     | |     |   |
+ +-+-+-+-+ + + + + + +-+-+ +-+-+ + +-+-+-+-+-+-+ +-+ + + + +-+ +-+ + + + + + +-+-+-+-+ + + +-+ +-+-+
|         | | | | | |     |     | |             |   | | | |   |   | | | | | |         | | |   |     |
+ + +-+-+ +-+ + +-+ +-+-+-+-+-+ + + + + +-+-+-+ + +-+-+ + +-+ + + + +-+-+-+-+-+-+ +-+-+ +-+ + +-+ +-+
| |     |   | |   |           | | | | |       | |     | |   | | | |             |     |   | |   |   |
+ +-+-+ +-+ +-+ +-+-+ + + + +-+ + +-+ +-+ +-+ + +-+-+-+-+ +-+-+ + +-+ +-+ +-+ + +-+ + +-+ + + +-+-+ +
|     |   |   |     | | | |   | |   |   |   | |         |     | |   |   |   | |   | |   | | |     | |
+ +-+-+ +-+ + + + +-+ + + +-+ + +-+-+-+-+ +-+ + +-+-+ + + +-+ + + +-+-+ + +-+ + + + + + +-+ + + +-+-+
|     |   | | | |   | | |   | |         |   | |     | | |   | | |     | |   | | | | | |   | | |     |
+ + +-+ + + +-+ + + + + + + + +-+-+-+-+ +-+-+ + +-+ + + +-+-+-+-+-+-+-+-+-+ + +-+-+ +-+ + +-+ +-+ + +
| |   | | |   | | | | | | | |         |     | |   | | |                   | |     |   | |   |   | | |
+ +-+ + +-+ +-+ + +-+-+ + + +-+-+ +-+ +-+ + + +-+ +-+ +-+ +-+-+ +-+ + +-+ + +-+ +-+ +-+ +-+-+ +-+-+-+
|   | |   |   | |     | | |     |   |   | | |   |   |   |     |   | |   | |   |   |   |     |       |
+ +-+ +-+ +-+ +-+ +-+ +-+-+-+ +-+ + + +-+ +-+ +-+ +-+-+-+-+-+ +-+ + + +-+ +-+-+ + + +-+-+-+ + +-+ + +
|   |   |   |   |   |       |   | | |   |   |   |           |   | | |   |     | | |       | |   | | |
+ +-+-+-+ + +-+ + + +-+ +-+-+ +-+ +-+ + + + +-+-+ + + +-+ +-+ + +-+-+ +-+-+ + +-+-+ + +-+-+-+ +-+-+-+
|       | |   | | |   |     |   |   | | | |     | | |   |   | |     |     | |     | |       |       |
+ +-+ + + + + + + +-+ + + + +-+-+-+ +-+-+ + +-+-+ + +-+-+-+-+-+ +-+ + + + + + + +-+-+ + + + +-+ + +-+
|   | | | | | | |   | | | |       |     | |     | |           |   | | | | | | |     | | | |   | |   |
+ + + +-+-+ +-+ +-+-+-+ +-+-+-+ +-+-+ +-+-+ + +-+ +-+ +-+ + + +-+ + + +-+ +-+ + + + +-+ + + + +-+ +-+
| | |     |   |       |       |     |     | |   |   |   | | |   | | |   |   | | | |   | | | |   |   |
+ + + + +-+ + +-+-+ + +-+ +-+-+ + +-+ +-+-+ + +-+-+ + +-+-+ +-+-+-+-+-+-+ + + +-+-+-+-+ +-+-+ +-+-+ +
| | | |   | |     | |   |     | |   |     | |     | |     |             | | |         |     |     | |
+ + +-+ + +-+-+ +-+-+ +-+ +-+ + + +-+-+ +-+ +-+ + +-+ + + +-+-+ + + +-+ + + +-+ + + + + +-+-+ +-+ +-+
| |   | |     |     |   |   | | |     |   |   | |   | | |     | | |   | | |   | | | | |     |   |   |
+ +-+ + + +-+ + +-+-+ + +-+-+ +-+-+-+-+ +-+-+-+ + + +-+ +-+ + + +-+ + +-+ + +-+ +-+ +-+-+-+ + + +-+ +
|   | | |   | |     | |     |         |       | | |   |   | | |   | |   | |   |   |       | | |   | |
+ + +-+-+-+-+ + + + +-+-+-+-+ + + + + + +-+ +-+-+-+-+ +-+ +-+ +-+-+ + + +-+ +-+-+ +-+ + + + +-+-+-+ +
| |         | | | |         | | | | | |   |         |   |   |     | | |   |     |   | | | |       | |
+ +-+ +-+-+ + +-+ +-+ +-+ +-+-+-+ +-+ +-+ + +-+ +-+-+ +-+ +-+-+-+-+-+ +-+ + +-+-+ +-+-+ +-+-+ +-+ +-+
|   |     | |   |   |   |       |   |   | |   |     |   |           |   | |     |     |     |   |   |
+ + + + +-+ + +-+ +-+-+ + + + + + + + +-+-+-+-+ + + + +-+-+-+ +-+ + + + + + +-+ + +-+ + + + + + +-+ +
| | | |   | |   |     | | | | | | | |         | | | |       |   | | | | | |   | |   | | | | | |   | |
+ + + +-+ +-+ + + + + + + +-+ + + +-+ + + + +-+ +-+-+ + +-+-+-+ +-+-+-+ +-+ + + +-+-+ + + +-+-+-+ +-+
| | |   |   | | | | | | |   | | |   | | | |   |     | |       |       |   | | |     | | |       |   |
+ + +-+-+-+-+ +-+ +-+-+ + +-+ + + +-+-+ + + +-+-+ + + +-+ + +-+-+-+ +-+-+ + +-+ +-+ + +-+-+ +-+-+ + +
| |         |   |     | |   | | |     | | |     | | |   | |       |     | |   |   | |     |     | | |
+ + +-+ + + +-+ + + + +-+ +-+ +-+ + +-+ +-+-+ + + +-+ +-+-+-+-+ + +-+ + + + +-+-+ + + + + +-+ +-+ +-+
| |   | | |   | | | |   |   |   | |   |     | | |   |         | |   | | | |     | | | | |   |   |   |
+ +-+ +-+ +-+-+-+-+ + + + + + +-+ +-+-+ +-+-+-+-+ +-+-+-+-+-+ + +-+ +-+-+ + +-+ +-+-+ +-+-+ +-+ +-+-+
|   |   |         | | | | | |   |     |         |           | |   |     | |   |     |     |   |     |
+ + + + + +-+ + +-+ + + +-+-+-+ +-+ +-+ +-+ + +-+-+ + + + +-+ +-+ +-+ +-+-+-+ +-+ +-+ +-+ + +-+-+-+-+
| | | | |   | |   | | |       |   |   |   | |     | | | |   |   |   |       |   |   |   | |         |
+ +-+-+ + +-+ + + + + +-+-+ +-+-+-+-+ +-+ + +-+ +-+ +-+-+ + +-+ + +-+-+-+ +-+-+-+-+ +-+-+-+ +-+ +-+-+
|     | |   | | | | |     |         |   | |   |   |     | |   | |       |         |       |   |     |
+ + + + + +-+ +-+ + +-+-+-+-+-+-+ + +-+ +-+ + +-+ + + + +-+ + +-+ +-+ + +-+-+ + +-+ +-+-+-+ + +-+ +-+
| | | | |   |   | |             | |   |   | |   | | | |   | |   |   | |     | |   |       | |   |   |
+ +-+ +-+-+-+ +-+-+-+-+ + + + + +-+ +-+ +-+ +-+-+ +-+-+-+ +-+ + + +-+-+ + + + +-+ +-+-+ +-+ + +-+ + +
|   |       |         | | | | |   |   |   |     |       |   | | |     | | | |   |     |   | |   | | |
+ + + +-+-+-+ +-+-+ + +-+ +-+-+ +-+ + + +-+-+-+ + + + + + +-+-+ + + +-+-+ +-+-+-+-+-+-+ + +-+ + +-+-+
| | |       |     | |   |     |   | | |       | | | | | |     | | |     |             | |   | |     |
+ + + +-+-+-+-+ + + + + + +-+-+-+ + + +-+-+-+-+-+ +-+-+-+-+-+-+-+ +-+-+ +-+ +-+ +-+ + + +-+-+-+-+-+-+
| | |         | | | | | |       | | |           |               |     |   |   |   | | |             |
+ + + +-+ +-+ +-+-+ + +-+-+ + +-+ +-+-+ +-+ +-+ + +-+ +-+-+-+ + + +-+-+-+ +-+-+ +-+ +-+-+ + + + +-+-+
| | |   |   |     | |     | |   |     |   |   | |   |       | | |       |     |   |     | | | |     |
+ +-+ + +-+-+ + + +-+-+ + + +-+-+-+-+ + + + + + + +-+ +-+-+ + +-+ + + + +-+ +-+-+-+ + +-+-+-+-+ +-+-+
|   | |     | | |     | | |         | | | | | | |   |     | |   | | | |   |       | |         |     |
+ + + + +-+ + +-+-+ +-+-+ +-+-+-+-+-+-+-+-+-+ + + +-+ + +-+-+ +-+ + + + + + + + + + + +-+ +-+-+-+-+ +
| | | |   | |     |     |                   | | |   | |     |   | | | | | | | | | | |   |         | |
+ +-+ + + +-+ + + + +-+ + + +-+ +-+ + +-+ + +-+ +-+-+-+-+-+ +-+-+ +-+-+-+ + +-+ + + + + + + +-+-+ + +
|   | | |   | | | |   | | |   |   | |   | |   |           |     |       | |   | | | | | | |     | | |
+ + + +-+ + + +-+-+-+ + +-+ + +-+-+ + + +-+-+-+ + + + + +-+-+-+-+ +-+-+ + +-+ +-+ + + +-+-+-+ +-+-+-+
| | |   | | |       | |   | |     | | |       | | | | |         |     | |   |   | | |       |       |
+ +-+ +-+-+ +-+-+-+ +-+-+ + +-+-+-+-+ +-+ + +-+-+-+ + +-+-+-+ +-+-+-+ + +-+ +-+ + +-+-+-+-+-+-+ + + +
|   |     |       |     | |         |   | |       | |       |       | |   |   | |             | | | |
+ + + + + +-+ + + +-+-+-+ +-+ + +-+ +-+-+ +-+ +-+ + +-+-+ + + + + +-+-+-+ +-+-+ +-+-+-+-+-+-+-+ + + +
| | | | |   | | |       |   | |   |     |   |   | |     | | | | |       |     |               | | | |
+ +-+ + +-+ + + +-+-+-+-+-+-+ +-+-+ +-+-+ +-+-+ + + +-+ + + + +-+-+ +-+-+ + +-+ +-+ +-+ + + +-+ + +-+
|   | |   | | |             |     |     |     | | |   | | | |     |     | |   |   |   | | |   | |   |
+ + + + + +-+-+ +-+-+-+-+-+-+-+ +-+ +-+-+-+ + +-+-+-+-+ +-+-+ +-+-+-+-+-+-+ +-+-+ + +-+-+ +-+ +-+ + +
| | | | |     |               |   |       | |         |     |             |     | |     |   |   | | |
+ + + +-+-+-+-+ + +-+ +-+-+ + +-+-+-+ + +-+-+ +-+ + + +-+ +-+-+-+ +-+-+ + +-+-+ +-+ +-+-+ +-+-+ + + +
| | |         | |   |     | |       | |     |   | | |   |       |     | |     |   |     |     | | | |
+ + + +-+ +-+ +-+ + + +-+-+-+-+ +-+-+ +-+-+-+ +-+ + + +-+-+ + +-+-+-+-+ +-+-+ +-+-+ +-+ +-+ + +-+-+ +
| | |   |   |   | | |         |     |       |   | | |     | |         |     |     |   |   | |     | |
+ + + +-+ +-+-+ +-+-+ +-+-+ + +-+-+-+ + +-+-+-+ + + +-+ + +-+-+-+ +-+ +-+ + + + + + +-+ +-+-+ +-+ + +
| | |   |     |     |     | |       | |       | | |   | |       |   |   | | | | | |   |     |   | | |
+ + +-+-+ + +-+ +-+ + + + + + +-+ + + +-+ +-+-+-+ +-+ + + +-+ +-+ +-+ + + +-+ +-+ +-+-+-+ + + + + + +
| |     | |   |   | | | | | |   | | |   |       |   | | |   |   |   | | |   |   |       | | | | | | |
+ + +-+-+-+ + + +-+-+ +-+-+-+-+ + +-+-+ +-+-+ +-+ + + +-+-+-+-+-+ +-+ +-+-+ + +-+-+-+-+ +-+-+-+-+ + +
| |       | | |     |         | |     |     |   | | |           |   |     | |         |         | | |
+ +-+ + +-+-+-+ + + +-+-+ +-+ +-+ + +-+ + + + +-+ +-+ +-+-+ + +-+ + +-+-+ + + +-+ +-+-+-+-+-+ + +-+ +
|   | |       | | |     |   |   | |   | | | |   |   |     | |   | |     | | |   |           | |   | |
+ + + + +-+ + + + + + +-+-+-+ +-+ + +-+-+ +-+-+ +-+ + +-+ + + + +-+-+ +-+ +-+ +-+-+ +-+-+-+ + + + + +
| | | |   | | | | | |       |   | |     |     |   | |   | | | |     |   |   |     |       | | | | | |
+ + + + +-+-+-+ +-+ + +-+-+ + + +-+ +-+-+-+ +-+-+ + + +-+-+ + +-+-+ +-+-+ +-+-+ + + +-+-+-+-+-+-+ +-+
| | | |       |   | |     | | |   |       |     | | |     | |     |     |     | | |             |   |
+ +-+ + +-+-+-+ +-+-+ +-+-+-+-+-+-+ +-+-+-+-+-+ + +-+-+-+ +-+ + + +-+-+ +-+ + +-+ +-+ + + + + +-+-+-+
|   | |       |     |             |           | |       |   | | |     |   | |   |   | | | | |       |
+ + + +-+-+ +-+ + + + + + + +-+-+ +-+-+-+-+ + +-+ +-+ + + + +-+ +-+-+ +-+ +-+ + +-+ +-+-+ + +-+ + +-+
| | |     |   | | | | | | |     |         | |   |   | | | |   |     |   |   | |   |     | |   | |   |
+ +-+-+-+ + +-+-+-+-+-+ +-+ +-+-+-+ + +-+ +-+ +-+ + + + +-+-+-+-+ +-+ + +-+-+-+ +-+ +-+-+ + +-+ + + +
|       | |           |   |       | |   |   |   | | | |         |   | |       |   |     | |   | | | |
+ +-+-+-+-+ +-+ +-+ +-+-+-+-+ +-+-+-+-+ + + + +-+ +-+ + +-+ + +-+-+-+ +-+ + + +-+-+ + +-+ + +-+-+-+-+
|         |   |   |         |         | | | |   |   | |   | |       |   | | |     | |   | |         |
+-+-+-+-+-+-+-+-+-+-+-+-+-+-+-+-+-+-+-+-+-+-+-+-+-+-+-+-+-+-+-+-+-+-+-+-+-+-+-+-+-+-+-+-+-+-+-+-+-+-+