+-+-+-+-+-+-+-+-+-+-+-+-+-+-+-+-+-+-+-+-+-+-+-+-+-+-+-+-+-+-+-+-+-+-+-+-+-+-+-+-+-+-+-+-+-+-+-+-+-+-+
| |         |           |   |   |         |       |   |     | |       |       |     |       |       |
+ +-+-+-+ + +-+-+ +-+-+ + + + + +-+ +-+ + + + +-+ + + + +-+ + + + +-+ + +-+-+ + +-+ + +-+ + +-+ +-+-+
|   |   | |       |   |   |   |   |   | | | | | |   | |   |   | | | | |     |   | | |   | |   |     |
+-+ + + + +-+-+ +-+ + + +-+-+-+-+ + +-+ + +-+ + +-+-+ + + +-+-+ + + + + +-+ +-+-+ + +-+ + +-+ + +-+ +
|   | | |     | |   | | |   |     | |   |   | |       | |   |   | | | | |   |         | | | | |   | |
+ +-+ + +-+-+ +-+ +-+ +-+ + +-+-+ +-+ +-+-+ + +-+-+ +-+-+-+ + +-+ + + + + +-+-+-+-+-+ + + + + +-+-+ +
|     |   |   |   | |   | | |   |     |     |     |   |   |   |   |   | |         |   | | | |     | |
+-+-+-+-+ + +-+ +-+ +-+ + + + + +-+-+-+ +-+-+-+-+ +-+ + + +-+-+ +-+ +-+ +-+-+-+-+ + +-+-+ + +-+-+ + +
|   |     |           |   | | |   |         |     | | | |       | | | |   | |     |       |     |   |
+ + + +-+-+-+-+ +-+-+-+-+-+ + +-+ +-+-+-+-+ + +-+-+ + + +-+-+-+-+ + + +-+ + + +-+-+-+-+-+-+ +-+ +-+ +
| | | |       | |         | | |   |       |   |     | |   |     | | |   |   |   |       |   | | |   |
+-+ + + +-+-+ + + +-+-+-+ + + + +-+ +-+-+ +-+-+-+-+ + +-+ + +-+ + + + +-+-+ +-+ + +-+-+ +-+ + + + +-+
|   | | |   | | |       | |   | |   |   | |       | |     |   | | | |       |   | |   |   |   | |   |
+ +-+ + + + + +-+-+-+ + + +-+-+ + +-+ + + + +-+-+ + +-+-+-+ + + + + +-+ +-+-+ + + + +-+-+ +-+ + +-+ +
|     | | | |       | | |     | |     | | |   |   |     | | | |   |   | | |   | | |     |   | |   | |
+ +-+-+ + +-+-+-+-+ +-+ +-+-+ + +-+-+ +-+ + +-+ +-+-+ + + + + +-+-+-+ + + + +-+ + + +-+ +-+ + +-+ + +
|   |   |         |     |   | | |   | |   | |   |   | |   | | |     | | | | |   | |   |   | |   |   |
+-+ + +-+ +-+-+-+ +-+-+-+ + + + + + + + +-+ + +-+ + + +-+ + + + +-+ + + + + +-+-+ +-+-+-+ + +-+ +-+-+
| |   | |   | |   |       | | | | | | |     |   | |   |   | | |   | | |   |               | | | |   |
+ +-+-+ +-+ + + +-+ +-+ +-+-+ + + + + +-+-+-+-+ + + +-+-+-+ + + +-+ + +-+-+-+-+-+-+-+-+-+ + + + +-+ +
|   |   |   | |     |   |     |   |       |   | | | |   |   | | |   |             |     | | | |   | |
+ + +-+ + +-+ +-+-+-+ +-+ +-+-+ +-+-+-+-+-+ + + + +-+ + + +-+ + + +-+-+-+-+-+-+-+ + +-+ +-+ + +-+ + +
| |     |     |     | |   | |   | |       | |   | |   |   | |   | |     |         | |   |   |   | | |
+ +-+-+ +-+-+ + +-+ + + +-+ + +-+ + +-+-+ + +-+-+ + +-+-+-+ +-+-+ + +-+ + +-+-+-+-+ + +-+ +-+ +-+ + +
|   |       | |   | |   |         | |   |   |     | |   |     |   |   |   |     |   |   |   |   | | |
+ + +-+-+-+-+ +-+ + +-+-+-+-+-+-+-+ + + +-+-+ +-+ + + + +-+-+ + +-+-+ +-+-+-+ + + +-+-+ +-+ +-+ + + +
| |       |   |   |         |       | |     |   | | | |   |   |     |     |   | | |   |   |   | | | |
+ +-+-+-+ + +-+ +-+-+-+-+-+ + +-+-+-+ +-+-+ +-+ + + + +-+ + +-+-+ + +-+-+ + +-+ + + +-+-+ +-+ + + + +
|   |     | |   | |   |   |   |   |     |       | | |   | |   |   |     | |   |   |           | |   |
+-+-+ +-+ + +-+ + + + + + +-+-+ +-+ +-+ +-+-+-+-+-+ +-+ + +-+ + +-+-+-+-+ + + +-+-+-+ +-+-+-+-+ +-+ +
|     | | |   | |   |   |       |   | |   |         |   |   | |   |       | |       |   |     | |   |
+ +-+-+ + +-+ + + +-+-+-+-+-+ +-+ +-+ +-+ + +-+-+-+-+ +-+-+ + +-+ + +-+-+-+ +-+-+-+ +-+-+ +-+ + + +-+
| |     |   | | | |   |     |           | |         | |   |     |   |             |       |   |   | |
+ + + +-+-+ + + + + + + +-+-+-+-+-+-+ +-+ +-+-+-+-+ + +-+ +-+-+ +-+-+ +-+-+-+-+-+-+-+-+ +-+ +-+ +-+ +
| | |     | |   |   |   |   |   |   | |   |       | |   |     |     |   |             | |   |   |   |
+ +-+-+-+ + +-+-+-+-+ +-+ + + + + +-+ + + + +-+-+ + +-+ +-+-+ +-+-+ +-+ + +-+-+-+-+-+ +-+ +-+ +-+ + +
| |     |   |     |   |   |   | |   | | |   |   | |   |   |   |     |   | |         |     | |   | | |
+ + +-+ + +-+ +-+ +-+-+ +-+-+-+ + + + + +-+-+ + +-+-+ + + + +-+ +-+-+ +-+ + +-+ +-+-+-+-+-+ +-+ +-+ +
| | |   | |   |   |     |     | | |   |     | | |   | | | |   |   |   | | | |   |             | |   |
+ + + +-+ + +-+ +-+ +-+-+ +-+ + +-+-+-+-+-+ + + + + + +-+ +-+ +-+ + +-+ + +-+ + + +-+ +-+-+-+ + + + +
| | | | | | | |     |       | | |         |   |   | |   | |   |   |     |   | | | | |     |   |   | |
+ + + + + + + +-+-+-+ +-+-+-+ + + +-+-+-+ + +-+-+-+ +-+ + + +-+ +-+-+-+ +-+ + + + + +-+-+ +-+ +-+-+ +
| | | |     |   |       |   |     |       |   |       |   |     |       |   | | | | |   |   |   |   |
+ + + +-+-+-+ +-+ +-+-+-+ + + +-+-+-+ +-+-+-+-+ +-+-+ +-+-+ +-+-+-+-+-+ + +-+ +-+ + + + +-+ +-+ + +-+
|   |     |       |       | | |     | |         |     |   | |         | | |   |   |   |   | |   | | |
+ +-+-+-+ + +-+-+ + +-+-+-+ +-+ +-+ + +-+ +-+-+-+ +-+-+ + + + +-+-+-+ + + + +-+ +-+-+-+ + + +-+-+ + +
| |     | | |   | | |     |       | | |   |     | |     | | | |       | | | |   |     | | |       | |
+ + + +-+ +-+ + +-+ + + +-+-+-+-+-+ + + +-+-+ +-+ +-+ + +-+ + +-+ +-+-+-+ + + +-+-+ + +-+ +-+-+-+-+ +
| | |   | |   | |   | |     |       | | |   |         | |   |   |         | | |     |           |   |
+ + +-+ + + +-+ + +-+-+-+-+ + +-+-+-+ + + + + +-+-+-+-+-+ +-+-+ + +-+-+-+-+ + +-+ +-+-+-+-+-+-+ +-+ +
| |   | | |   | | |         | |       |   | |     |     | |     | |   | |   |     |         | |     |
+ + +-+ + +-+ + + + +-+-+-+-+ +-+ +-+-+-+-+ +-+-+ + +-+ + + + +-+-+ + + + + + +-+-+-+-+ +-+ + +-+-+ +
| | |   | |   |     |   |   |   | |         |   | |   |   | |       | | | |   |       | |     |     |
+ +-+ +-+ + +-+-+-+-+ + + + +-+ + +-+ +-+-+-+-+ + +-+ +-+-+ +-+-+-+-+ + + +-+-+ +-+-+ + +-+-+-+ +-+-+
|   |   |   |   |   | |   | |   |     |   |     | | |   | |         | | | |   |     | |   |     |   |
+-+ + + +-+-+ + + + + +-+-+ + +-+-+-+-+ + + + +-+ + +-+ + +-+ +-+-+-+ + + +-+ +-+-+ + +-+ + +-+-+-+ +
| | | |     | |   |   |     |   |       | | |   |   | | |     |   |   |           | |   | | |       |
+ + + + +-+-+ +-+-+-+-+ +-+-+-+ +-+ +-+-+ + +-+ +-+ + + +-+ +-+ + + +-+-+-+-+-+-+-+ +-+ + + +-+ +-+ +
|   | | |     |   |     |     |   |   |   |   |   | | |   | |   | | |               | | | |   | | | |
+ +-+-+ + +-+-+-+ + +-+-+-+ + +-+ +-+ + +-+-+ +-+ + + +-+ +-+ +-+ + + +-+-+-+-+-+-+-+ + + +-+ + + + +
| |     |     |   |         |     |   |     | | | | |   |     | | | | |       |     | | |       |   |
+ + +-+ +-+-+ + + +-+-+-+-+ +-+-+-+ +-+-+ + + + + + + +-+-+-+-+ + + + +-+ +-+ +-+ + + + +-+-+-+-+-+-+
| |   |     | | |   |   |   |   |   |   | |   | |     |     |     |     |   |   | |   |   |     |   |
+ +-+ +-+-+ + + +-+ + + + +-+ + +-+-+ + +-+ +-+ +-+-+-+ + +-+ +-+-+-+-+ +-+ +-+ + +-+-+-+ + +-+ + + +
| |   |     | |   | | |   |   | |     |   |     |       |     |       |     |   |       |   |   | | |
+ + +-+ +-+-+ + + + + +-+-+ +-+ + +-+-+-+ +-+-+-+ +-+-+-+-+-+-+-+ + + +-+-+-+ +-+-+-+-+ +-+-+ +-+ + +
|   |   |   | | | | |     | | |   |     |   |   |   |   |       | | | |     |           |   | |   | |
+ +-+-+-+ + + + + +-+-+-+ + + +-+-+ +-+ +-+ + + +-+ + +-+ +-+ + + + + + +-+-+-+-+-+-+-+ + +-+ + +-+ +
| |     | | | | |         |     |   |   | |   | |   |       | | | | | | |             | | |   | |   |
+ + +-+ + + + + +-+-+-+-+-+-+-+ + +-+ +-+ +-+-+ + +-+ +-+-+-+ + +-+ + + + +-+-+-+-+ + + + + +-+ + + +
| |   | | |   |   |   |   |     |   |       | | | |       |   |     | | | |   |     | | | |   | | | |
+-+-+ + + +-+-+-+ +-+ + + + +-+-+ + +-+-+-+ + + + + +-+-+ + +-+-+-+-+ + + + +-+ +-+-+-+ + +-+ + + + +
|     |   |     | |   | |   |     |       |   |   | |   | | |   |     |     |   |       |   |   | | |
+ +-+-+-+-+ +-+ + + +-+ +-+-+ +-+-+-+-+-+ + +-+-+-+-+ + +-+ +-+ + +-+-+-+-+-+ +-+ +-+-+-+ + +-+-+ +-+
|     | |   |   | | |   |   |   |   |   | | |         | |   |   | |     |   | |   |       |     |   |
+ +-+ + + +-+ +-+ + + +-+ + +-+ + + + + + +-+ +-+ +-+-+ + +-+ +-+ + +-+ + + + + +-+-+ +-+-+-+-+ +-+ +
|   | | | | |       |     | |   | |   | |   | | | |   |   |     |   | |   | |       | | |       |   |
+ +-+ + + + +-+-+-+-+-+-+-+ +-+ + +-+-+ +-+ + + + +-+ +-+-+-+ + +-+-+ +-+-+ +-+-+-+ + + + +-+-+-+ + +
| |   |           |       |   | |   | |   |     |   |       | |     |       |     |   |   |       | |
+ + +-+-+-+-+-+-+-+ + +-+-+-+ + +-+ + +-+ +-+-+-+-+ + +-+ + +-+ + +-+ +-+-+-+ +-+ +-+ +-+-+ +-+-+-+ +
| |               | |   |     | | | |             | |   | | |   | |   |       |   |   |     |   |   |
+ +-+-+ +-+-+-+-+ + +-+ + +-+-+ + + +-+-+-+-+-+-+ + +-+-+ + + +-+ + +-+ + +-+-+ +-+-+-+ +-+-+-+ + +-+
| |   |   |     |   |   | |     | | |   |       | |   |   |   |   | |   |   |   |     |   |   | | | |
+ + + +-+-+ +-+ + +-+ +-+ + +-+-+ + + + + +-+-+ + +-+ + +-+ +-+-+ + + +-+-+ + +-+ +-+ +-+ + + + + + +
| | |       | | | |   |   |       |   | | |   |   |   |   | |   | | |     | |     | |     | |   | | |
+ + +-+-+-+-+ + +-+ + + +-+ +-+-+-+ +-+ +-+ + + +-+ +-+-+ +-+ + +-+ +-+-+ + +-+-+-+ +-+-+-+ +-+ + + +
| | |     |         | | | | |     |   |     | | |       |     |     |     | |       |     |   | | | |
+ + + +-+ +-+-+ +-+-+-+ + + + +-+ +-+ +-+-+ + + +-+-+-+ +-+ +-+-+-+-+-+-+ + +-+-+-+ + + + +-+ +-+ + +
| |     |     | |     | | | | | |   | |   | | |       |   | |           | |       |   | |   | |   | |
+ +-+-+ +-+-+ + + +-+ + + + + + +-+ +-+ + +-+ +-+-+-+ +-+ + +-+ +-+ +-+ +-+ +-+-+ + +-+ +-+ + + +-+ +
| |   | |   | | | | |   |   | |         |     |   |   |   |   | |   | |   |     | | | |   |   |     |
+ + + + + + + +-+ + +-+-+-+-+ +-+-+-+-+-+-+-+-+ + + +-+ +-+-+ + + +-+ +-+ +-+-+-+ + + +-+ +-+ +-+-+ +
| | | |   | |   |   |       |       |     | |   | |     |   | | | | |   | |       |   |   |       | |
+-+ + + +-+-+-+ +-+ +-+ +-+ +-+-+-+ +-+ + + + + +-+-+-+-+ +-+ +-+ + + + + + +-+-+-+-+-+ +-+-+-+-+-+ +
|   | | |   |   |   |   | |     |   |   |   | |           |   |   |   | |   |           |       |   |
+ +-+ +-+ + + + + +-+ +-+ +-+-+ + +-+ +-+-+ + +-+-+ +-+-+-+ +-+ +-+ +-+ +-+-+ +-+-+-+-+-+ +-+-+ + +-+
| |       |   | | |   |   |   | | | |     | |   | |       |   | | | |   |     |   |       |   | |   |
+ +-+-+-+-+-+-+-+ +-+ + +-+ + + + + + +-+ +-+-+ + +-+-+-+ +-+ + + + + +-+ +-+ + + + +-+-+-+-+ + +-+ +
|                     |     |     |     |               |       |   |       |   |             |     |
+-+-+-+-+-+-+-+-+-+-+-+-+-+-+-+-+-+-+-+-+-+-+-+-+-+-+-+-+-+-+-+-+-+-+-+-+-+-+-+-+-+-+-+-+-+-+-+-+-+-+