+-+-+-+-+-+-+-+-+-+-+-+-+-+-+-+-+-+-+-+-+-+
| |   |   |             | | |   |     |   |
+ + + + +-+ + +-+-+ + + + + +-+ + + + +-+ +
|   |   | | | |   | | | | |     | | |     |
+-+-+ +-+ +-+ + +-+ +-+ + + + +-+ +-+-+-+ +
| |       |   |     | | |   | |       | | |
+ +-+-+-+ +-+ +-+ +-+ +-+-+ +-+ +-+-+ + +-+
|   |       | |   | | | | |   |   |       |
+-+ +-+ +-+ + + + + + + + + +-+ +-+ + +-+-+
|       | | | | |     |         | | |   | |
+ + +-+-+ + +-+-+-+-+ +-+-+ + +-+ + +-+-+ +
| | |   |       |       |   | | |       | |
+ + + +-+ + +-+-+ +-+ +-+ + +-+ +-+-+-+ + +
| | | |   |         | |   |   |           |
+-+-+ + + +-+-+-+-+ +-+ + +-+ + +-+ +-+ + +
| | |   | |   |   |   | |   | |   | |   | |
+ + + +-+ + +-+-+ + +-+ +-+-+-+-+-+-+ +-+ +
|   | |     |     |           |   |   |   |
+-+ +-+-+ +-+ +-+ + +-+ +-+-+-+-+ +-+ + +-+
| |   |   |     | | |     |       | | | | |
+ + +-+-+-+-+-+-+ + +-+-+-+-+ + + + + +-+ +
| | |     | | |       |   |   | | |   | | |
+ + +-+ +-+ + + +-+-+-+ +-+-+-+ + +-+ + + +
|     |         | |             | | | |   |
+-+-+ +-+ + +-+-+ + +-+-+ +-+ +-+ + + + +-+
|   |     | |   | |   | |   |   |   |     |
+ +-+-+ +-+ + + + + +-+ +-+ +-+-+-+ + + +-+
| |     |     |     |       |     | | | | |
+ +-+ +-+-+-+-+-+ +-+-+ +-+-+-+ + + +-+ + +
| |   |   | |   | | |     |     | |   | | |
+ + +-+ +-+ +-+ + + + + + +-+ + + +-+ + + +
| |     |   |   | |   | | | | | | | | |   |
+ +-+ +-+ + +-+ + +-+ +-+-+ +-+-+ + + +-+ +
|   |     | | |   | |         | | |   |   |
+-+ + +-+ +-+ + +-+ + + + + +-+ + + +-+-+-+
|   | |   |       |   | | | |     |     | |
+ + +-+-+ +-+ +-+ +-+ + + +-+ +-+-+ +-+-+ +
| |     | | |   |   | | | | | |           |
+-+ +-+ +-+ + +-+ + +-+-+ + + +-+ +-+-+ + +
| | |         |   | |           |   |   | |
+ + +-+ + +-+-+-+-+ +-+-+ +-+ +-+ +-+-+ +-+
|   |   |       |       | |     |   |     |
+-+-+-+-+-+-+-+-+-+-+-+-+-+-+-+-+-+-+-+-+-+