+-+-+-+-+-+-+-+-+-+-+-+-+-+-+-+-+-+-+-+-+-+-+-+-+-+-+-+-+-+-+-+-+-+-+-+-+
|   | |       | | |             |   |   |       |     | |     |         |
+ +-+ +-+-+ +-+ + + + +-+ +-+ + + +-+ + +-+-+ +-+-+ +-+ + + +-+ + + + +-+
|   | |       | |   |   |   | | |     |     | | |   |     | |   | | | | |
+-+ + + + +-+-+ +-+ + +-+ + +-+-+ + +-+-+-+ + + +-+ +-+ +-+-+ +-+-+-+-+ +
|   |   | | |   | | | | | | |   | | |   | | |     |     |   |   | |     |
+ + +-+-+ + + +-+ +-+-+ +-+ + + + +-+ +-+ +-+-+ +-+ +-+-+ +-+ +-+ + +-+ +
| |               |           |     |         |       |       |     |   |
+ + + + +-+-+ +-+ +-+-+-+ +-+-+-+-+-+ +-+ + +-+ +-+-+-+ +-+ + + +-+-+-+-+
| | | | | |   |     | | | | |   |       | |     |   | |   | | |     |   |
+-+-+-+-+ +-+ + +-+-+ + + + + +-+ +-+-+ +-+-+-+-+ +-+ + + +-+-+ +-+ + +-+
|   |   |     | |   |       |     |   |     | |         |   |     | |   |
+ +-+ +-+ + +-+-+ +-+-+ +-+-+ +-+-+ + + +-+ + +-+ + +-+ +-+ + + +-+ + +-+
|         |       | |       |   |   |     |     | |   | | |   | |       |
+-+-+-+-+-+ +-+-+-+ +-+-+ + +-+-+ +-+ +-+-+ + +-+-+ + +-+ +-+-+ +-+-+ + +
| |   | |   |   | | | |   |     | | | | |   |   |   |       |   |     | |
+ + +-+ + +-+-+ + + + + +-+ +-+ +-+ +-+ + + + + + +-+-+-+ +-+ + +-+ +-+-+
|   |       |           | | | | | |   |   | | |         |   | | | | |   |
+-+ +-+ + + + + +-+ +-+-+ +-+ + + + + +-+-+ +-+ +-+-+-+-+-+-+-+ + +-+ +-+
| |     | |   | |         |       | | |     |   | |     | |   |     | | |
+ + +-+ +-+ + +-+-+ +-+-+ +-+ +-+-+ +-+ +-+-+ + + + +-+-+ + +-+-+ + + + +
|   | | | | | |       |   | | | | | |     | | | |       |       | |     |
+-+-+ +-+ + + + +-+-+ +-+ + +-+ + + + +-+ + +-+ +-+-+-+ + +-+-+ +-+-+ + +
|     |     | |     | |   |     |       |     |     |     |   |   |   | |
+ +-+ +-+-+ +-+-+ +-+-+ + + +-+ + +-+-+-+ + +-+-+-+-+-+-+ +-+ +-+ +-+-+ +
| | |       | | | | | | | |   | | |   |   | |   |     | |       |       |
+ + +-+-+-+-+ + + + + +-+-+-+-+ +-+ + +-+ +-+ + + + +-+ + +-+ +-+ + + +-+
|   |   |   |       | |   | |       |   | |   | | |   |   |     | | |   |
+ + +-+ + +-+-+ + + + + +-+ +-+-+-+ +-+-+ + +-+-+-+ +-+-+-+-+-+-+ +-+-+-+
| | |     | | | | |     |   |   |     |   |       |   | |     |     |   |
+-+-+ + +-+ + +-+-+ +-+-+-+ + + +-+ + +-+ +-+ +-+-+ +-+ + + +-+ +-+-+-+ +
|     |   |   |   | | | | |   |     |   |                 | |   |       |
+ +-+ + +-+-+ + + + + + + +-+-+-+ +-+-+-+-+-+ +-+-+ + + + +-+ + + +-+-+-+
|   | |         |     |         |   |   | | | |   | | | | |   |     | | |
+-+ + +-+ + +-+-+ +-+-+-+ +-+-+ +-+ + +-+ + + + + +-+ +-+-+ +-+-+-+-+ + +
| | | | | | |     | |   |   |     |       | | | |   |     | | |       | |
+ + +-+ +-+-+ +-+-+ + + +-+-+-+-+ + +-+ + + + +-+ +-+-+ +-+-+ +-+ + +-+ +
|   |       |   |     | | |     |     | |     | |         | |   | | |   |
+-+ +-+ +-+-+ +-+ +-+ + + +-+ + + + +-+-+ + + + +-+-+-+ + + + +-+-+ + +-+
|   | |       |   |   |       |   |     | | | |   |     | | |           |
+-+-+ +-+ + + +-+-+-+-+-+-+ +-+ +-+-+-+-+-+-+ + + + + +-+-+ +-+ + + +-+ +
|   |     | | |   |     | |   | | |   | | | | | |   |   | |     | | | | |
+-+ +-+ +-+-+-+-+ + +-+-+ + + + + + +-+ + + + +-+-+ +-+-+ + + +-+-+-+ + +
|                     | |   | |       | |     | |   |   |   | |   |   | |
+-+ +-+ + +-+-+-+-+ +-+ + +-+ +-+-+ +-+ + +-+-+ +-+-+ +-+-+ +-+-+ + + +-+
|   |   |   |     | |     | |   |       |     |   |   |     |   |   |   |
+ + + +-+ +-+ +-+-+ +-+-+-+ +-+-+-+-+-+-+-+ + + +-+ +-+-+ + + +-+ +-+ +-+
| | |   | |       |   |     | |   |   |     |   |   |     |       |     |
+ +-+-+-+-+-+-+-+ + + +-+ +-+ + +-+-+ +-+ +-+ + + +-+-+-+ + +-+ +-+ + + +
|   | | |   |   |   | | | |   |         | | | | |     | | |   | |   | | |
+ + + + + +-+ +-+ +-+ + + + +-+-+-+ +-+-+-+ + +-+ + +-+ + +-+ +-+-+-+ +-+
| | | |     | | |   | |         |         |       |     |   | |   | |   |
+ +-+ + +-+-+ + +-+-+ +-+ + +-+-+-+-+-+ +-+ + + +-+-+-+ +-+-+-+ +-+ + + +
| | |         | |     |   |   | | |   |   | | |   |   | |     |   |   | |
+-+ +-+ +-+ + + + +-+ + + + +-+ + +-+ +-+ +-+ + +-+ + +-+-+ +-+ + +-+ + +
| | |     | | |     |   | | | |   |     | |   |   | |   |   |   | |   | |
+ + + +-+-+-+ + + +-+-+-+-+ + +-+ + +-+ + + +-+ +-+ + +-+ +-+-+-+ + +-+ +
|   | | |       |   |   |       | | |         | |   |         |     | | |
+-+ + + + +-+-+ +-+-+-+ +-+ +-+-+ +-+-+ +-+-+ +-+-+ +-+-+ +-+-+ + +-+ +-+
|   | |   | | |     |                     | |       |   |       |   | | |
+ +-+-+-+ + + +-+ +-+ + +-+-+ +-+-+ + + + + +-+-+ + +-+ +-+ +-+ +-+-+ + +
|         | |       | | | | |     | | | | | |     | |       |   |   | | |
+-+-+ + + + + + +-+-+-+-+ + + +-+-+-+ +-+ + + +-+ +-+-+-+-+-+-+ + +-+ + +
| |   | | |   |             |   | |     |   | | | |       |   |         |
+ + +-+-+ +-+ +-+ +-+-+-+ +-+-+-+ +-+ + + +-+-+ + +-+-+ + + +-+ + +-+ +-+
|     |   | | |       | | |   |   |   | | |   |   |     | |   | |   |   |
+-+ + +-+-+ + + + +-+-+ + + +-+ +-+-+ + +-+ +-+ +-+ + +-+ +-+ + + + +-+-+
|   | | | |   | |   |     |       |   | |       | | | |       | | | |   |
+ +-+ + + + + +-+-+ +-+-+-+-+-+-+ + + + + +-+ +-+ + +-+ +-+ + +-+-+-+ +-+
| |   | |   |   | | | |           | | | | |           |   | |     |     |
+-+ +-+ + +-+ +-+ +-+ + + +-+-+-+ +-+ + + + + +-+ + +-+-+-+-+ + + + +-+ +
|       | |             |     |     | | | | | |   |       |   | |     | |
+-+-+-+-+-+-+-+-+-+-+-+-+-+-+-+-+-+-+-+-+-+-+-+-+-+-+-+-+-+-+-+-+-+-+-+-+