+-+-+-+-+-+-+-+-+-+-+-+-+-+-+-+-+-+-+-+-+-+-+-+-+-+-+-+-+-+
|                                                         |
+ +-+ +-+ + + + + + + + +-+-+-+ + +-+-+-+-+-+-+ + + + + +-+
|   |   | | | | | | | |       | |             | | | | |   |
+ +-+ +-+-+-+ +-+ +-+ +-+ +-+-+ + +-+-+-+-+ +-+-+ + + +-+ +
|   |       |   |   |   |     | |         |     | | |   | |
+ + + + +-+ + +-+-+-+-+-+ + + + +-+-+-+ + +-+ +-+ + + +-+-+
| | | |   | |           | | | |       | |   |   | | |     |
+ +-+-+-+-+ + + + + + + +-+-+ +-+-+-+ +-+ +-+-+ + +-+ +-+ +
|         | | | | | | |     |       |   |     | |   |   | |
+ + + +-+ +-+-+ + + +-+ +-+-+-+-+-+-+-+-+-+-+ + +-+ +-+ + +
| | |   |     | | |   |                     | |   |   | | |
+ +-+-+ + + +-+ + +-+-+-+ + + +-+-+-+ + + +-+-+-+-+ + + + +
|     | | |   | |       | | |       | | |         | | | | |
+ + + + + +-+ + + + +-+-+ +-+ + +-+ + +-+-+ +-+ + +-+-+ +-+
| | | | |   | | | |     |   | |   | |     |   | |     |   |
+ + +-+-+ +-+-+-+-+ +-+ + +-+ + +-+-+-+ +-+-+-+-+ + +-+-+-+
| |     |         |   | |   | |       |         | |       |
+ +-+ + + + +-+-+-+ +-+ +-+-+-+-+-+ +-+ + +-+-+ +-+-+-+ +-+
|   | | | |       |   |           |   | |     |       |   |
+ + +-+-+ +-+-+ + + +-+ + +-+-+ +-+ + +-+ +-+ + +-+ + +-+-+
| |     |     | | |   | |     |   | |   |   | |   | |     |
+ +-+-+-+-+-+-+ + + + +-+ + + +-+ +-+-+ + + +-+-+-+-+ +-+-+
|             | | | |   | | |   |     | | |         |     |
+ + +-+-+ +-+-+-+-+-+ +-+ +-+ +-+-+ + + +-+-+ +-+ +-+-+ + +
| |     |           |   |   |     | | |     |   |     | | |
+ + + + + +-+-+-+ +-+ + + + +-+ + + + +-+ + +-+-+-+-+ +-+-+
| | | | |       |   | | | |   | | | |   | |         |     |
+ + + + +-+ + + +-+ + +-+ +-+ +-+-+ + + +-+ +-+-+ +-+ +-+-+
| | | |   | | |   | |   |   |     | | |   |     |   |     |
+ +-+ + + +-+ +-+ + +-+ +-+ +-+ + + + + +-+ +-+-+-+ + + +-+
|   | | |   |   | |   |   |   | | | | |   |       | | |   |
+ +-+-+-+-+-+ + + + +-+ + + + + + +-+-+-+-+-+ + +-+ +-+-+ +
|           | | | |   | | | | | |           | |   |     | |
+ + +-+ +-+-+ + +-+ +-+-+ + +-+-+ + +-+ +-+-+ +-+ +-+ +-+-+
| |   |     | |   |     | |     | |   |     |   |   |     |
+ + + + + + +-+-+-+ +-+-+ +-+ +-+ +-+-+ +-+ +-+-+-+-+-+-+ +
| | | | | |       |     |   |   |     |   |             | |
+ + +-+ +-+ + +-+-+ + +-+ +-+ +-+ +-+ + +-+ +-+ +-+ +-+ + +
| |   |   | |     | |   |   |   |   | |   |   |   |   | | |
+ +-+-+-+ +-+ + +-+ + + + + +-+ +-+-+ + +-+-+ + + +-+ + + +
|       |   | |   | | | | |   |     | |     | | |   | | | |
+ + +-+ + + + +-+ +-+-+ +-+-+-+ +-+-+-+ + + + +-+-+-+ +-+ +
| |   | | | |   |     |       |       | | | |       |   | |
+ + +-+ +-+ +-+ +-+-+ +-+-+-+-+-+ +-+ + +-+ + + + + + +-+-+
| |   |   |   |     |           |   | |   | | | | | |     |
+ + + +-+ +-+-+ + + + +-+ + +-+-+-+-+ + +-+-+ + +-+ +-+ +-+
| | |   |     | | | |   | |         | |     | |   |   |   |
+ + + +-+-+-+ + +-+ + +-+ +-+ +-+-+ +-+-+-+-+ + + + +-+ +-+
| | |       | |   | |   |   |     |         | | | |   |   |
+ + +-+ + +-+ + + + + + +-+-+ +-+-+ + + +-+-+-+ + + +-+ + +
| |   | |   | | | | | |     |     | | |       | | |   | | |
+ + +-+ +-+ +-+ +-+-+ +-+-+-+-+-+ + + + +-+ +-+ + + + +-+-+
| |   |   |   |     |           | | | |   |   | | | |     |
+ +-+ +-+ + +-+-+ +-+-+ + + +-+ + +-+ +-+ + +-+ + +-+ +-+ +
|   |   | |     |     | | |   | |   |   | |   | |   |   | |
+ +-+ + + + + +-+ + +-+ + + + +-+ +-+ + +-+ +-+ +-+ + + +-+
|   | | | | |   | |   | | | |   |   | |   |   |   | | |   |
+-+-+-+-+-+-+-+-+-+-+-+-+-+-+-+-+-+-+-+-+-+-+-+-+-+-+-+-+-+