+-+-+-+-+-+
|         |
+ +-+-+ + +
|     | | |
+ +-+ + + +
|   | | | |
+ + + +-+-+
| | |     |
+ + + + + +
| | | | | |
+-+-+-+-+-+