+-+-+-+-+-+-+-+-+-+-+-+-+-+
| |   |           |.|.|.|.|
+ + + + +-+-+-+-+ +-+-+-+-+
|   |   |     | |       |.|
+-+-+-+-+-+ + + +-+-+-+ +-+
|     |     | |   |     |.|
+ + + +-+ +-+ + + + +-+-+-+
| | |     |     | |   |.|.|
+ + +-+-+-+-+-+-+ +-+ +-+-+
| |             |   | |.|.|
+ +-+-+-+-+-+-+ +-+ + +-+-+
|   |         | |   | |   |
+-+ + +-+-+ +-+ + +-+ + +-+
|   | |     |   |   | |   |
+ +-+-+ +-+ + +-+-+-+ +-+ +
| |     |   |   |   |     |
+ + + + +-+-+-+ + + +-+-+ +
| | | | |     |   |   |   |
+ +-+ +-+ + +-+-+-+ +-+ +-+
|   |     |       | |   | |
+-+ + +-+-+-+-+ + + + +-+ +
| | |         | | |   |   |
+ + +-+-+ +-+-+ + +-+-+-+ +
| | |     |   | | |     | |
+ + +-+-+-+ + + + +-+ + + +
|           |   |     |   |
+-+-+-+-+-+-+-+-+-+-+-+-+-+