+-+-+-+-+-+
|         |
+-+-+-+-+ +
|       | |
+ +-+-+ + +
| |   |   |
+ +-+ +-+-+
|     |   |
+-+-+ +-+ +
|   |     |
+ + +-+-+ +
| |       |
+ +-+-+-+-+
| |.|.|.|.|
+ +-+-+-+-+
| |.|.|.|.|
+ +-+-+-+-+
|   |.|.|.|
+-+ +-+-+-+
|   |.|.|.|
+ +-+-+-+-+
| |.|.|.|.|
+ +-+-+-+-+
|     |   |
+-+-+ + + +
|.|.| | | |
+-+-+ + + +
|   |   | |
+ +-+-+-+ +
|   |.|   |
+ + +-+ +-+
| | |.|   |
+-+ +-+-+ +
|   |   | |
+ +-+ + + +
|   | |   |
+-+ + +-+-+
|.|   |.|.|
+-+-+-+-+-+
|.|.|.|.|.|
+-+-+-+-+-+
|.|.|.|.|.|
+-+-+-+-+-+
|.|.|.|.|.|
+-+-+-+-+-+
|.|.|.|.|.|
+-+-+-+-+-+
|.|.|.|.|.|
+-+-+-+-+-+
|.|.|.|.|.|
+-+-+-+-+-+
|.|.|.|.|.|
+-+-+-+-+-+
|.|.|.|.|.|
+-+-+-+-+-+
|.|.|.|.|.|
+-+-+-+-+-+
|.|.|.|.|.|
+-+-+-+-+-+
|.|.|.|.|.|
+-+-+-+-+-+