+-+-+-+-+-+-+-+-+-+-+-+-+-+-+-+-+-+-+-+-+-+-+-+-+-+-+-+-+-+-+-+-+-+-+-+-+-+-+-+-+-+-+-+-+-+-+-+-+-+
|     |     |     |     |     |   | | |   |   |   | | |   | |     |   |   |     | |   | | |       |
+ +-+-+-+-+ + +-+-+-+-+ + + +-+ +-+ + +-+ +-+ + +-+ + + +-+ +-+ +-+-+ + +-+-+-+ + +-+ + + + + +-+ +
|     |             |     |               |         | | | |           |     |     | | |     |   | |
+ +-+ +-+-+ +-+ + +-+-+ + +-+-+-+-+-+-+ +-+-+-+ +-+-+ + + +-+-+-+ +-+ +-+-+ + +-+ + + + +-+ +-+-+-+
| | | |     |   | | |   |           | | |   |     |     | |     | |         | |   | | | |   | | | |
+-+ + +-+ +-+ +-+-+ + + +-+-+ + + +-+ +-+ +-+-+ +-+-+ + + +-+-+ + + +-+ +-+-+-+ + + + + +-+-+ + + +
|   |       | |       |     | | | |                   |         | | |   | |   | |     |     |     |
+-+ + +-+-+ + + +-+-+-+-+-+ +-+ +-+ + +-+-+-+-+-+-+ +-+-+-+-+ +-+-+ +-+ + + +-+ +-+ +-+-+ +-+-+ + +
|       |   |   |   | | | | | | | | |   |   |   |   | |   | |     | |     |       |   | |   | | | |
+-+-+-+-+-+-+ +-+ + + + + +-+ + + +-+-+-+ +-+-+ +-+-+ + +-+ +-+ +-+-+ +-+ +-+-+-+ + +-+ + + + + +-+
|   |   |     |   | |       | | | |   | |   |           |           |   |       | | | |   | |     |
+ + +-+ +-+-+ + +-+ + + +-+-+ +-+ + +-+ + +-+ +-+-+ +-+-+ +-+-+ +-+ + + +-+ +-+-+ + + +-+-+ + + +-+
| |           |   |   |     |       |     |       | | |   | |   |     | |       | |       |   |   |
+-+-+-+ +-+-+ +-+ + + +-+ +-+-+-+-+ + +-+-+-+-+ +-+-+ + +-+ + + +-+-+-+ +-+ +-+-+ +-+-+ + +-+ + +-+
|     |     |     | | |       |     |     | |     |         | | |   | | |     |     | | |   | | | |
+-+ +-+-+ +-+ +-+-+-+-+ + +-+-+-+-+ + +-+-+ + +-+ + + + +-+-+-+-+ +-+ + + +-+-+-+ +-+ + + +-+ +-+ +
|   | | |   | |   | |   | |   |   |     | |     | | | |   |         | | |   |   | |     |   |   | |
+ +-+ + + +-+-+-+ + + +-+ + +-+-+ +-+-+ + +-+-+-+ + +-+-+-+ +-+ +-+-+ + +-+-+ + +-+ + +-+-+ + +-+ +
|         |   |     |   |   |   |   |           | | |         | |       |   | |     | |   |   |   |
+ + + +-+-+ + + +-+ +-+-+-+ + +-+ + +-+ + +-+ +-+ + + +-+ +-+ +-+ +-+ +-+ +-+ +-+ +-+-+-+ + + + + +
| | |       | |   | |     |       |     | | | | |   |   |   |   | |           |   |     | | | | | |
+ +-+ +-+ +-+-+ +-+-+-+-+ + +-+-+-+-+ + +-+ + + +-+ + + + +-+-+-+-+-+-+ + + +-+-+-+ + +-+ +-+ + + +
| | | |             | | | |     |   | | | | |         | |   | | |     | | |   |     | |         | |
+ + +-+-+-+ +-+ + +-+ + + + +-+ + +-+-+-+ + + + +-+ + +-+ + + + + + +-+ +-+-+-+ + +-+-+-+-+-+-+-+ +
| | |     | | | | |   |   | |     |     |     | |   |   | |     | |     | |     |   | | |   |   | |
+-+ + +-+-+ + +-+ + +-+ + +-+-+ +-+ +-+-+ +-+ +-+-+-+-+-+-+-+ + + +-+-+ + + +-+-+ +-+ + + + +-+ +-+
|   |   |   |   |       | | | | |   |       | |     | |       | | |       |     | |       | |   | |
+-+ + + +-+ +-+ +-+ +-+-+ + + + + +-+-+-+-+-+-+ +-+ + + +-+-+-+ +-+-+-+-+-+-+ +-+ + +-+-+-+ + + + +
| |   |     | |         | |     | |   |       |   | |   | |   | |     |     |   |     |   | | |   |
+ +-+ +-+ +-+ + +-+-+-+-+-+ +-+-+ + + + + +-+-+ +-+-+-+-+ + +-+-+ +-+ +-+ +-+ +-+ + + + + +-+-+ +-+
|     |   | |   |   |   |           | | |   | |   |   |       |     |           | | | | |     |   |
+-+ +-+-+ + +-+-+ + + + +-+ +-+-+ + +-+-+-+ + + +-+ +-+-+-+ +-+-+ +-+ +-+ + +-+-+ + +-+-+ + + + + +
|   |       | |   | | |         | |   | |   |   |           | |     | |   |   |   | | | | | |   | |
+ +-+-+-+ + + +-+ +-+ + +-+-+-+-+ + + + + +-+ + + +-+ + +-+ + + +-+-+-+ +-+-+ +-+ +-+ + + +-+ + +-+
| |   |   |     | |   | | |       | |   | | | |     | | | | |       |     | | | |   |   |   | | | |
+-+-+ + + +-+-+-+ +-+ + + +-+-+-+-+-+-+-+ + +-+-+-+-+-+ + +-+ +-+ +-+-+ + + +-+ + + + +-+-+-+ +-+ +
|     | |     |   |   | |           |     |       |   |       |       | | |   | | | | |           |
+-+-+ +-+ + + +-+ + +-+ + +-+-+-+-+ + +-+ +-+-+ + + +-+ +-+ + +-+-+ +-+-+ + +-+ +-+-+ + + + +-+ +-+
| | |   | | |   | | | | | |   |       |   |   | |     |   | |   | | |                 | | | |   | |
+ + + +-+ +-+-+-+ +-+ +-+-+-+ +-+-+-+ +-+ + + +-+ +-+-+ +-+ +-+-+ + +-+-+ + +-+-+-+-+ + +-+ + + + +
| |   |   |   |           |       |   |   | |       | | |         |   | | | |     |   | |   | | | |
+ + + + + + +-+ + +-+ +-+-+ +-+ + + +-+-+ + +-+-+ + + +-+-+ + + +-+-+-+ +-+-+ + +-+ +-+ +-+ + + + +
| | |   |       |   | |       | | |   | |     |   | |       | |     |   | |   |   |   |   | | | | |
+ +-+-+ +-+-+-+ + + +-+ +-+ +-+-+-+ + + + +-+-+-+ +-+ + +-+-+-+ +-+ + +-+ +-+ +-+-+-+-+ +-+-+ +-+ +
|     |   |     | | | | | |   |   | | |   | |   | | | | |   |   | | |   | |             | | |     |
+ +-+ + +-+ +-+-+ + + +-+ + + +-+ +-+-+-+-+ +-+ + + + +-+ + +-+ + +-+-+ + + + + +-+ +-+ + + +-+-+ +
| | |   | |   |   | | | |   |   |     | | |   | |       | |   |   | | |     | |   |   | |   |     |
+ + +-+-+ +-+-+ + + + + +-+ +-+-+-+-+ + + +-+ + +-+ +-+-+-+ + +-+ + + +-+-+-+ + +-+-+ + + +-+-+-+-+
|   |     | | | | | |   |   |     |             |     |     | | | | |     | | | |   | | |         |
+ + +-+-+ + + +-+-+ +-+ +-+ +-+-+ +-+ +-+-+-+-+ + +-+-+ +-+-+ + + + + +-+ + + +-+-+ +-+ +-+ +-+ +-+
| |       |     |   |                   |   |     | |   | | |   | | | |   |     |   |     | | | | |
+ + + + +-+-+ + +-+-+-+-+-+ +-+-+-+ +-+ +-+ + + +-+ +-+ + + +-+ +-+ + +-+-+-+-+ +-+ +-+-+ + + +-+ +
| | | | | |   | |   |   |     |       |     | |   | |     |     |   |         |     |   |         |
+-+ +-+-+ + +-+ +-+ +-+ + +-+ +-+-+ +-+-+-+-+-+ + + +-+-+ +-+ +-+ +-+-+ +-+ +-+ +-+ + + +-+-+-+-+-+
|           |   | |   | | |     |     | |     | |     |     |   |         |       | | |   |       |
+ +-+-+-+-+-+-+ + + +-+ +-+ + +-+-+-+ + + +-+-+-+ + +-+ +-+ +-+-+-+-+-+ +-+-+-+-+ + + +-+-+-+-+-+ +
| | |     |         | |   | |   |   | |     |   | |       | |     | |     | |   | |               |
+ + +-+ +-+ +-+-+-+ + +-+ + +-+-+ +-+-+-+ +-+-+ +-+ +-+ +-+ +-+ +-+ +-+-+-+ + + + + +-+ +-+-+ +-+ +
|     |   | |     | | |   | |     |     |   | |       | |     |   |   | | | | |   |   |   |     | |
+ + + + + + + +-+-+ + +-+ +-+ + +-+ + +-+-+ + +-+-+ +-+-+ + + + +-+ + + + + + +-+-+-+ + +-+-+ + + +
| | | | | |     | |   |   | | | |   |   |   |         | | | | |     |       | |   |   | | | | | | |
+-+-+-+ + + + +-+ +-+ +-+ + + +-+-+ +-+ + +-+ +-+-+-+-+ +-+ + +-+-+ +-+-+ + + + +-+ +-+ + + +-+-+-+
| |     |   | | |   |       |   | | |   |   |             | | |         | |     |   |       |   | |
+ +-+ +-+ +-+ + +-+ + + +-+ +-+ + +-+ +-+-+ +-+ + +-+-+-+ +-+ +-+ + + +-+ + +-+ +-+-+-+ +-+ + + + +
| | | |   | | |   |   |   |   |               | |   |       |   | | | |   |   | |         |   |   |
+ + + + +-+ + +-+ +-+-+ + +-+-+-+ +-+-+ +-+ + + +-+-+-+ +-+ +-+-+ +-+-+-+-+ +-+ +-+ +-+-+ +-+-+-+ +
|   | |   |     | |   | | |   |       | |   | |     | | |       | | | | |   |   | | |     |       |
+ +-+ +-+-+ +-+ + +-+ +-+-+ +-+-+ + +-+-+-+-+ +-+-+-+ + +-+ +-+ +-+ + + + +-+ +-+ +-+-+-+ +-+-+-+ +
|         | |   |   |         | | |     | |   | | | |     | |   |   |   |   | |     |     | |   | |
+ +-+ +-+-+-+-+-+ + +-+ +-+ +-+ + +-+-+ + + +-+ + + +-+ +-+-+-+ + + +-+ +-+ +-+ +-+ +-+-+-+ +-+ + +
|   | |     |     | | | |         |     |   |   |         |   |   |   |       | | |   |         | |
+-+ + +-+ +-+ +-+ +-+ + +-+-+ +-+ +-+ + + +-+-+ + +-+-+ +-+ +-+-+-+ +-+ +-+-+ + + +-+ +-+-+-+-+ + +
|   |   |       |       | |   | |   | | | | |     |   | |         |   | |         |   |   | |   | |
+-+ +-+-+-+ +-+-+ +-+ +-+ + +-+ + +-+-+ + + + +-+-+ + +-+ +-+ +-+ +-+-+-+-+-+-+-+-+ + + +-+ + +-+ +
| |     |   | |     | | |   | | |   | | | | | |   | |   | |   |       |     |   |   |   |   |   | |
+ + +-+ +-+-+ +-+ + +-+ + + + + + +-+ +-+-+ + + +-+-+ + + + + +-+-+-+ +-+ +-+ +-+-+-+ + + + +-+ +-+
| |   | | | |   | |   |   |     |     |   |   | |     |   | |     |   |         | |   |   | |     |
+ +-+ + + + +-+ +-+-+-+ + +-+-+ +-+-+-+-+ +-+ + + + +-+ +-+-+ + +-+-+-+-+-+-+-+ + + +-+ +-+-+ +-+-+
| |   | | |           | | | | | |     |   |     | | |     |   | |   |   |           |     |       |
+ + + + + +-+ +-+-+ +-+-+-+ + + +-+-+ +-+ +-+ + + +-+-+-+-+-+-+-+ +-+ + +-+ + +-+ + +-+ +-+-+ +-+ +
|   | | | |   |     |       |           |   | |           |           | |   | |   |   |     | |   |
+-+ + +-+ +-+ +-+-+-+-+ + +-+ +-+-+ +-+-+ + +-+ +-+ +-+-+-+-+ +-+ + +-+ + + +-+-+-+ + +-+ +-+ +-+-+
|   |                   |   |   |   |     | |   |       |     | | |   |   | | |     |   | |       |
+-+-+-+-+-+-+ +-+ + +-+ +-+-+ + + + + + + +-+-+-+-+ +-+-+ +-+-+ +-+ +-+-+-+ + +-+-+-+-+-+-+-+-+ + +
|           | |   | |         | | | | | |   | |   |         | | |     | |     |   |   | | |     | |
+-+-+ +-+ + +-+-+ +-+ + +-+-+ + +-+-+ + +-+-+ + +-+-+ +-+ +-+ + + +-+-+ + +-+ + +-+-+ + + + +-+-+ +
| |   |   |   | | |   | |   | |     | |               | |   |       | |   |   |           |     | |
+ + + +-+ +-+ + + + +-+ +-+ + +-+-+ + + + +-+-+ + + +-+ +-+-+-+ + + + +-+ +-+-+ +-+-+-+ + +-+ + + +
|   | | |   |     | | |     |   |     | |     | | | | | |     | | | |   |       |       |     | | |
+-+-+ + +-+-+-+-+ +-+ + +-+ + +-+ + +-+-+-+-+ + +-+-+ + +-+ +-+-+-+ + + + +-+-+-+ +-+ +-+ +-+ + +-+
|         | | |   | |     | |   | |     |     | |         | |     | | | |   |       |   |   | |   |
+-+-+ + + + + +-+-+ + + +-+ +-+-+ +-+-+ +-+-+-+ +-+-+ +-+ + + + + + + + + +-+-+ +-+ + + +-+-+-+ + +
|     | | |           | |     |   | | | |     |     | |     | | | | | |   | | |   | | | |   |   | |
+ +-+ + +-+-+ +-+ +-+-+ +-+ +-+-+-+ + + +-+-+ +-+-+ + +-+-+-+-+ +-+-+ +-+-+ + +-+-+ + + +-+ +-+ + +
|   | | |     | |     |   |   | |     |   |   |             | | |             |   | | |     |   | |
+-+ + +-+-+-+ + +-+ + + +-+-+-+ +-+ +-+-+-+-+ + +-+ + +-+ +-+ + +-+ + +-+-+ +-+ + + +-+ +-+ + + + +
|   |   |         | | |                     |     | | |           | | |       | |     | |   | | | |
+-+-+-+-+-+-+-+-+-+-+-+-+-+-+-+-+-+-+-+-+-+-+-+-+-+-+-+-+-+-+-+-+-+-+-+-+-+-+-+-+-+-+-+-+-+-+-+-+-+