+-+-+-+-+-+-+-+
|     |     | |
+-+-+ + +-+ + +
| |   | |   | |
+ + +-+ + +-+ +
| | |   |     |
+ + +-+ +-+-+ +
| |   | |     |
+ +-+ + + +-+-+
|   |   |     |
+ +-+-+-+-+-+ +
|     |   |   |
+ +-+ + + + +-+
|   |   |     |
+-+-+-+-+-+-+-+