+-+-+-+-+-+
|   |   | |
+-+ + + + +
|     | | |
+ +-+ +-+ +
| |       |
+-+-+ + +-+
|     |   |
+ + + + + +
| | | | | |
+-+-+-+-+-+