+-+-+-+-+-+-+-+-+-+-+-+-+-+-+-+-+-+-+-+-+-+-+-+-+-+-+-+-+-+-+-+-+-+-+-+-+-+-+-+-+-+-+-+-+-+-+-+-+-+-+
|                                                                                                   |
+ + +-+ + + +-+-+ + +-+-+ + + +-+-+ + + + +-+ +-+-+ +-+ + +-+-+ + + +-+-+ +-+ +-+ + +-+ +-+-+ + +-+ +
| |   | | |     | |     | | |     | | | |   |     |   | |     | | |     |   |   | |   |     | |   | |
+ +-+-+ +-+-+-+ +-+-+ +-+ +-+-+-+-+-+-+-+ + +-+ + +-+ +-+ +-+ +-+ + + + + +-+ +-+-+ +-+-+-+-+ +-+-+ +
|     |       |     |   |               | |   | |   |   |   |   | | | | |   |     |         |     | |
+ + +-+ + + +-+ + + +-+-+ +-+-+ +-+-+-+-+ +-+-+ + + + +-+-+ + +-+-+ + + +-+ +-+-+ + +-+ + + +-+-+ +-+
| |   | | |   | | |     |     |         |     | | | |     | |     | | |   |     | |   | | |     |   |
+ +-+ +-+-+ +-+ + + + +-+-+ + + + +-+ + +-+ +-+ +-+-+ +-+ + + + + + + +-+ +-+-+-+-+ +-+-+ +-+ +-+-+ +
|   |     |   | | | |     | | | |   | |   |   |     |   | | | | | | |   |         |     |   |     | |
+ +-+-+-+ + +-+ +-+ + +-+-+-+ + +-+ + + + + + + +-+ +-+ +-+ +-+-+ +-+-+ +-+-+-+-+-+ + +-+ + + + +-+ +
|       | |   |   | |       | |   | | | | | | |   |   |   |     |     |           | |   | | | |   | |
+ +-+-+ +-+ + +-+ +-+-+ + +-+-+ + +-+ +-+ + + +-+-+ + + + + +-+-+-+ + +-+-+ +-+ + +-+-+-+ +-+ + + +-+
|     |   | |   |     | |     | |   |   | | |     | | | | |       | |     |   | |       |   | | |   |
+ +-+-+-+ +-+-+ +-+-+ +-+-+ +-+ + + +-+-+-+-+ + + + +-+ +-+ + + +-+-+ + + + +-+ +-+-+-+-+-+ +-+-+ +-+
|       |     |     |     |   | | |         | | | |   |   | | |     | | | |   |           |     |   |
+ + +-+-+ +-+ +-+-+ +-+ +-+-+ +-+-+ + + + + + + +-+-+ + + + + + +-+-+ + +-+ +-+-+ +-+ + +-+ + + +-+-+
| |     |   |     |   |     |     | | | | | | |     | | | | | |     | |   |     |   | |   | | |     |
+ +-+ +-+ +-+ +-+-+-+ + + +-+-+-+ +-+ + +-+ +-+ +-+-+-+-+ + +-+-+-+-+ + + + +-+ +-+-+-+-+ + + +-+ +-+
|   |   |   |       | | |       |   | |   |   |         | |         | | | |   |         | | |   |   |
+ + +-+ +-+ + +-+ + +-+-+ + + +-+-+ +-+ +-+ +-+-+-+-+-+ +-+-+ + +-+ +-+-+ + +-+ + + +-+ + + + + +-+-+
| |   |   | |   | |     | | |     |   |   |           |     | |   |     | |   | | |   | | | | |     |
+ + + +-+-+ +-+ +-+ +-+-+ +-+ +-+ + + +-+-+ + + +-+ + +-+-+-+-+-+-+ +-+ +-+ + +-+ + + + +-+-+-+-+ + +
| | |     |   |   |     |   |   | | |     | | |   | |             |   |   | |   | | | |         | | |
+ + +-+ + +-+-+-+ +-+ + + + + + + + +-+ +-+-+ +-+-+-+-+-+ + +-+ + + +-+ + + + +-+ + +-+ + + + +-+-+-+
| |   | |       |   | | | | | | | |   |     |           | |   | | |   | | | |   | |   | | | |       |
+ + + +-+ +-+ + +-+-+-+ +-+-+-+-+ +-+ + +-+ + +-+ +-+-+-+ + +-+-+ +-+-+ + +-+-+-+-+ +-+ +-+ +-+-+-+-+
| | |   |   | |       |         |   | |   | |   |       | |     |     | |         |   |   |         |
+ +-+-+-+ + +-+-+ +-+-+-+ + + +-+ + + +-+-+ + +-+-+-+ +-+-+-+-+-+ +-+-+ +-+ + +-+-+-+ +-+ +-+ +-+-+-+
|       | |     |       | | |   | | |     | |       |           |     |   | |       |   |   |       |
+ + +-+ + +-+-+ + +-+ + +-+-+-+-+-+ +-+ +-+ +-+ +-+ + +-+-+-+-+-+ +-+-+-+ +-+ +-+ + +-+-+ + +-+-+ +-+
| |   | |     | |   | |           |   |   |   |   | |           |       |   |   | |     | |     |   |
+ + +-+-+-+-+-+-+-+-+-+-+-+-+-+-+-+-+ + +-+-+ +-+ +-+ + +-+-+ + + +-+-+ +-+-+ + + +-+ + + + + +-+ +-+
| |                                 | |     |   |   | |     | | |     |     | | |   | | | | |   |   |
+ + + + + +-+-+-+ +-+ +-+-+-+ +-+-+-+-+-+-+ +-+ +-+-+-+ + + +-+ +-+ +-+ +-+-+ + +-+-+-+-+ + +-+-+-+ +
| | | | |       |   |       |             |   |       | | |   |   |   |     | |         | |       | |
+ + +-+ +-+ +-+ + +-+-+ +-+ +-+ + +-+-+ +-+ +-+-+-+-+-+-+-+ + +-+ +-+ + + + + + +-+-+ +-+ +-+-+ +-+ +
| |   |   |   | |     |   |   | |     |   |               | |   |   | | | | | |     |   |     |   | |
+ +-+-+-+-+ +-+ +-+-+-+ +-+-+ + +-+-+ + +-+-+-+ +-+-+ +-+-+-+ + +-+ + + + + + +-+ + +-+ +-+ + + + +-+
|         |   |       |     | |     | |       |     |       | |   | | | | | |   | |   |   | | | |   |
+ + +-+-+ +-+-+-+-+-+ +-+-+-+ + +-+ + +-+-+-+-+-+ +-+ +-+ + + +-+ + +-+ +-+-+-+ +-+-+ +-+-+ +-+-+ +-+
| |     |           |       | |   | |           |   |   | | |   | |   |       |     |     |     |   |
+ + + + + + + +-+-+ + + + + +-+ + + +-+ +-+ + +-+ +-+ + + + +-+-+ +-+ + +-+ +-+-+ + + + + +-+-+ + +-+
| | | | | | |     | | | | |   | | |   |   | |   |   | | | |     |   | |   |     | | | | |     | |   |
+ + +-+-+-+ +-+ + + +-+-+ +-+-+-+ +-+ + + +-+-+-+-+-+ +-+-+-+ +-+ + +-+ +-+-+ +-+ + +-+ + +-+ +-+ +-+
| |       |   | | |     |       |   | | |           |       |   | |   |     |   | |   | |   |   |   |
+ + + +-+-+ + + + +-+-+ +-+-+-+-+-+ + +-+-+-+ +-+ +-+ + +-+ + + +-+ +-+-+-+-+ + + +-+-+-+-+-+ + +-+-+
| | |     | | | |     |           | |       |   |   | |   | | |   |         | | |           | |     |
+ + +-+ + +-+ +-+-+-+-+-+-+ + +-+ +-+ + +-+-+-+ + +-+ +-+-+ + + +-+ +-+ + +-+-+ + + +-+-+-+ + +-+-+ +
| |   | |   |             | |   |   | |       | |   |     | | |   |   | |     | | |       | |     | |
+ + + +-+ + + +-+ + + + + +-+ + +-+-+-+ + +-+-+ +-+ +-+-+-+-+-+-+ + +-+-+-+-+ +-+-+-+-+-+-+-+-+ + + +
| | |   | | |   | | | | |   | |       | |     |   |             | |         |                 | | | |
+ +-+ + +-+ + +-+ + +-+ + + + + + + +-+-+-+-+-+ + +-+ +-+-+ + +-+-+-+-+-+-+ +-+ +-+-+-+-+-+-+-+-+ +-+
|   | |   | |   | |   | | | | | | |           | |   |     | |             |   |                 |   |
+ + +-+-+-+-+-+-+ + +-+ +-+ +-+ +-+ + +-+ + + + +-+ + +-+-+-+-+-+ + +-+-+ +-+-+-+-+-+-+ + + +-+ +-+-+
| |             | |   |   |   |   | |   | | | |   | |           | |     |             | | |   |     |
+ + + +-+-+-+-+-+-+-+ + +-+-+-+-+ +-+-+-+ +-+ +-+-+-+-+ + + +-+-+-+-+ + +-+-+-+ +-+-+ + +-+ +-+ +-+-+
| | |               | |         |       |   |         | | |         | |       |     | |   |   |     |
+ + + +-+ +-+ + +-+ + +-+ +-+-+-+-+ + +-+ + + +-+ +-+ +-+ +-+-+-+-+-+ +-+ +-+-+-+ + + + + + +-+ +-+ +
| | |   |   | |   | |   |         | |   | | |   |   |   |           |   |       | | | | | |   |   | |
+ + +-+ +-+ + +-+-+-+-+ + + + + +-+-+-+ +-+ +-+ + + +-+ + + + +-+ +-+-+-+-+-+ + + + +-+-+-+ + + +-+ +
| |   |   | |         | | | | |       |   |   | | |   | | | |   |           | | | |       | | |   | |
+ + + +-+-+ +-+ +-+ + + + +-+-+-+-+ + + +-+-+-+-+-+ +-+ +-+ + + + +-+-+-+ +-+ + + + + + +-+ +-+-+-+-+
| | |     |   |   | | | |         | | |           |   |   | | | |       |   | | | | | |   |         |
+ + +-+ +-+-+-+ + +-+ +-+ + +-+ + +-+ +-+ + +-+ +-+ +-+ +-+ +-+-+ + + + + + +-+ +-+ + + + + +-+-+-+-+
| |   |       | |   |   | |   | |   |   | |   |   |   |   |     | | | | | |   |   | | | | |         |
+ + +-+ +-+ + + + + + + +-+ + +-+-+ + + +-+ +-+ +-+ + +-+ + +-+-+ + + +-+ + + + + +-+ +-+-+ + +-+ + +
| |   |   | | | | | | |   | |     | | |   |   |   | |   | |     | | |   | | | | |   |     | |   | | |
+ +-+-+-+-+-+ +-+-+-+-+ +-+-+-+ + +-+ + +-+-+ + + + + + +-+ +-+-+-+ +-+ +-+-+ +-+ + + +-+ +-+-+-+ + +
|           |         |       | |   | |     | | | | | |   |       |   |     |   | | |   |       | | |
+ +-+ + +-+-+-+ +-+-+ + + +-+-+ + + + +-+ +-+-+ + + + + +-+ +-+ + + + +-+ + + +-+-+ + + + +-+ +-+ + +
|   | |       |     | | |     | | | |   |     | | | | |   |   | | | |   | | |     | | | |   |   | | |
+ +-+-+-+ + +-+-+-+-+-+ + + + +-+ +-+ +-+ +-+-+-+ +-+-+-+-+-+ + +-+-+ +-+ + + + + +-+ + +-+ + + + +-+
|       | |           | | | |   |   |   |       |           | |     |   | | | | |   | |   | | | |   |
+ +-+-+-+-+-+-+-+-+ +-+ + +-+-+ + +-+ +-+ +-+ +-+-+ + +-+-+ + +-+-+-+-+-+-+ +-+-+ +-+ + +-+-+-+-+-+-+
|                 |   | |     | |   |   |   |     | |     | |             |     |   | |             |
+ +-+ +-+ + + +-+-+-+ +-+-+-+ +-+ +-+ + + +-+ +-+ +-+ +-+ +-+ + + + + +-+-+-+ +-+ + +-+-+-+-+-+ + +-+
|   |   | | |       |       |   |   | | |   |   |   |   |   | | | | |       |   | |           | |   |
+ +-+-+-+-+ +-+ + + + + + +-+-+-+-+ + +-+-+ +-+-+ +-+ +-+-+-+ +-+-+ + +-+ +-+-+-+ + + +-+ + + + +-+-+
|         |   | | | | | |         | |     |     |   |       |     | |   |       | | |   | | | |     |
+ +-+ + + +-+ + + + +-+ + +-+-+ +-+-+-+-+-+ +-+-+ +-+ + +-+ +-+ +-+-+-+-+ + +-+-+ + + +-+-+ + +-+-+ +
|   | | |   | | | |   | |     |           |     |   | |   |   |         | |     | | |     | |     | |
+ + + +-+-+ + +-+ + + + + +-+ + +-+ + +-+-+-+ + +-+ + +-+-+-+-+-+-+ +-+ +-+-+-+-+ + + + +-+-+-+ +-+-+
| | |     | |   | | | | |   | |   | |       | |   | |             |   |         | | | |       |     |
+ + + + +-+ + +-+-+ +-+-+ +-+-+ +-+-+-+-+-+-+-+-+ + +-+ +-+-+-+ + + + +-+ + + +-+ + +-+ + + + +-+ + +
| | | |   | |     |     |     |                 | |   |       | | | |   | | |   | |   | | | |   | | |
+ + + +-+-+-+-+ + +-+ +-+ +-+ +-+ +-+-+ + + + +-+ +-+-+-+ +-+-+ + +-+-+ +-+-+ + + + +-+ +-+-+ + +-+ +
| | |         | |   |   |   |   |     | | | |   |       |     | |     |     | | | |   |     | |   | |
+ + +-+-+ +-+-+ + +-+ + +-+-+-+-+ + + + +-+-+ +-+-+ +-+ +-+ +-+ + + + + + + + +-+ + + +-+ +-+ +-+ + +
| |     |     | |   | |         | | | |     |     |   |   |   | | | | | | | |   | | |   |   |   | | |
+ + +-+ + + + + +-+-+-+-+-+ +-+ +-+-+-+ + +-+ +-+-+-+ + +-+ + + + +-+ + +-+-+ + + + + + + +-+ + + + +
| |   | | | | |           |   |       | |   |       | |   | | | |   | |     | | | | | | |   | | | | |
+ + + +-+-+-+ + +-+ + +-+ + +-+ + + + + +-+ + + +-+-+ + +-+-+-+ +-+ +-+ +-+-+-+ +-+ +-+-+-+ + +-+-+-+
| | |       | |   | |   | |   | | | | |   | | |     | |       |   |   |       |   |       | |       |
+ + +-+-+ + +-+-+ +-+-+ + +-+-+ +-+ +-+ + +-+ +-+-+-+ + +-+ + + +-+ +-+ + +-+ + +-+-+-+-+-+-+-+-+ +-+
| |     | |     |     | |     |   |   | |   |       | |   | | |   |   | |   | |                 |   |
+ +-+ + + +-+-+ + +-+-+-+-+-+ +-+-+ +-+-+-+-+-+-+ + + +-+ + +-+ + +-+ +-+ +-+ + + +-+-+-+ +-+-+-+ +-+
|   | | |     | |           |     |             | | |   | |   | |   |   |   | | |       |       |   |
+ + +-+-+ +-+ + + +-+-+ +-+ + + +-+-+ + +-+ +-+ + +-+-+-+ +-+ +-+-+-+-+ +-+ + + +-+ +-+-+ +-+-+ + +-+
| |     |   | | |     |   | | |     | |   |   | |       |   |         |   | | |   |     |     | |   |
+-+-+-+-+-+-+-+-+-+-+-+-+-+-+-+-+-+-+-+-+-+-+-+-+-+-+-+-+-+-+-+-+-+-+-+-+-+-+-+-+-+-+-+-+-+-+-+-+-+-+