+-+-+-+-+-+-+-+-+-+-+-+-+-+-+
| |   |           |       | |
+ +-+ + + +-+-+-+ +-+ +-+ + +
|   |   | |     |   | | | | |
+-+ + +-+ + + + +-+ + + + + +
|   | |   | | |   |   | |   |
+ +-+ + +-+ + +-+ +-+-+ +-+ +
|   | | |   |   |   |   | | |
+-+ +-+ + +-+-+ +-+ + + + + +
| |     |     |   | | |   | |
+ +-+-+-+-+-+-+ + + + + +-+ +
|             | | | | | |   |
+ +-+-+-+ +-+ +-+ + + +-+ +-+
| |     | | | |   |   |   | |
+ +-+-+ + + + + +-+-+-+ +-+ +
|       | | | |     |   |   |
+-+-+-+ + + + +-+-+ + +-+-+ +
|   |   | |       | |       |
+ +-+ +-+ + +-+-+ + +-+-+-+ +
| |   |   | |   |   |       |
+ + +-+ +-+ + + +-+-+ +-+-+-+
|     |   | | |       |     |
+ +-+-+-+ +-+ +-+-+-+-+ + +-+
|   |     |   |     |   |   |
+-+ + +-+ + +-+ +-+ +-+-+-+ +
|   | |   |     | | |     | |
+ +-+ +-+-+-+-+-+ + + +-+ + +
|   |                 |     |
+-+-+-+-+-+-+-+-+-+-+-+-+-+-+