+-+-+-+-+-+-+-+-+-+-+-+-+-+
|                         |
+ + +-+ + +-+-+-+ +-+-+-+ +
| |   | |       |       | |
+ +-+-+-+-+-+-+-+ + + + + +
|               | | | | | |
+ +-+ +-+ + +-+ + +-+ +-+ +
|   |   | |   | |   |   | |
+ + +-+-+-+ +-+ + +-+-+-+ +
| |       |   | |       | |
+ + + +-+-+-+-+ +-+-+-+-+-+
| | |         |           |
+ + + +-+-+ + + +-+ +-+-+-+
| | |     | | |   |       |
+ +-+-+-+-+-+-+-+-+-+-+-+-+
| |.|.|.|.|.|.|.|.|.|.|.|.|
+-+-+-+-+-+-+-+-+-+-+-+-+-+
|.|.|.|.|.|.|.|.|.|.|.|.|.|
+-+-+-+-+-+-+-+-+-+-+-+-+-+
|.|.|.|.|.|.|.|.|.|.|.|.|.|
+-+-+-+-+-+-+-+-+-+-+-+-+-+
|.|.|.|.|.|.|.|.|.|.|.|.|.|
+-+-+-+-+-+-+-+-+-+-+-+-+-+
|.|.|.|.|.|.|.|.|.|.|.|.|.|
+-+-+-+-+-+-+-+-+-+-+-+-+-+
|.|.|.|.|.|.|.|.|.|.|.|.|.|
+-+-+-+-+-+-+-+-+-+-+-+-+-+