+-+-+-+-+-+-+-+-+-+-+-+-+-+-+-+-+-+-+-+-+-+-+-+-+-+-+-+-+-+-+
| |     |     | |           |   |     |   |     |         | |
+ + +-+ +-+ + + + + +-+-+-+-+ + + +-+ + + + + + +-+-+ +-+ + +
| | | |     | | | | |         |   |   | |   | |     |   | | |
+ + + +-+-+-+ + + + + +-+-+-+ +-+-+ + + +-+-+ +-+-+ + + + + +
|   | |       |   |   | |   | |   | | |     | |     | | |   |
+-+-+ + +-+-+-+-+-+ +-+ + + +-+ + + +-+-+-+ + +-+ +-+-+ +-+ +
| |   | |         |     | |     | |         |   | |     | | |
+ + + + +-+-+ + + +-+-+ + +-+-+-+ + +-+-+-+ +-+ + +-+ +-+ + +
|   | |     | | | |   | |     |   | |     |   | |     |   | |
+ +-+ +-+-+ +-+ + + + +-+ +-+ + +-+ + +-+ +-+-+ +-+-+-+ + + +
| | |     |   | |   |   | |   |   | | | |     | |   |   |   |
+ + +-+-+ +-+ + +-+-+-+ +-+ +-+-+ + + + +-+-+ + + + + +-+-+-+
| |   |   |   | |     |     |     | | |     | | | | |   |   |
+ +-+ + +-+ +-+ +-+-+ +-+-+-+ +-+-+-+ + + +-+ + + +-+-+ + + +
|     | |   |   |   |       |       | | |   |   |   |   | | |
+-+-+ + + +-+-+ + + + +-+-+ +-+-+-+ + +-+-+ +-+-+-+ + +-+-+ +
|   | |   |     | | | | |   |     |   |             |   |   |
+ + + +-+-+-+ +-+ + + + + +-+-+ +-+-+-+ +-+-+-+-+-+ +-+ + + +
| | | |       |   |   | | |     |   |       |   |   |   | | |
+ + + +-+-+ +-+ + +-+-+ + +-+ +-+ + + +-+-+ + + +-+ + +-+ + +
| |   |     |   |   |   |   |     | | |   |   |   | |     | |
+ +-+-+ + +-+-+ +-+ + + +-+ +-+-+-+ + + + +-+-+-+ +-+-+-+-+ +
| |     | |   |   | | |             | | | |     |       |   |
+ + +-+-+-+ + +-+ + +-+-+-+-+-+-+-+ + + + + +-+-+-+-+ + + +-+
| | |       | |   |       | |     | |   | |         | | | | |
+ + + +-+-+-+ + +-+-+-+-+ + + +-+ + +-+-+ +-+-+-+ + + +-+ + +
| |         | |         | | | |   |     |       | | |     | |
+ + +-+-+-+ + +-+-+-+-+-+ + + + +-+-+-+ +-+-+-+ + + +-+-+-+ +
| | |     | |         |   |   | |   |   |     | | | |       |
+ +-+ +-+ + +-+-+-+-+ + +-+ +-+ + + + +-+ + +-+ + +-+ +-+ + +
|   | | | |     |     |   |   |   | |     | |   | |     | | |
+-+ + + + +-+-+ + +-+-+ + +-+-+ +-+ +-+-+-+ + +-+ + +-+-+ + +
| |   | |   |   | |     |     |   |       | |   | | | |   | |
+ +-+-+ +-+ +-+-+ + +-+-+-+-+ +-+ +-+-+-+ + +-+ + + + + +-+-+
|   |   |   |     |         |   |     | | |   | | |   |     |
+ + + +-+ +-+ +-+-+-+-+ +-+-+-+ +-+-+ + + +-+ + + +-+ +-+-+ +
| |   |   |     |     | |     |     |   |     | | |   | |   |
+ +-+-+ +-+ +-+ + + +-+ + +-+ + +-+ +-+ +-+-+-+ + + +-+ + + +
|   |   |   |   | | |   | |   |   |   |     |   | | |   | | |
+-+ + +-+-+-+ +-+ +-+ +-+ + +-+-+ +-+ +-+-+ + +-+ + + + + +-+
|   |       | |   |   |   | |   |   |   |   | | |   | | |   |
+ +-+-+-+-+ + + + + +-+ +-+ + +-+ +-+-+ +-+-+ + + +-+-+ +-+ +
|         |   | | | | |   | |     |   | |     |         | | |
+ +-+-+ +-+-+-+ + + + +-+ + +-+-+-+ + + + +-+-+-+-+-+-+ + + +
| |   |     |   | |     | |         |   |             |   | |
+ + + +-+ + + +-+ + +-+-+ +-+-+-+-+-+-+ +-+-+-+-+-+-+ +-+-+ +
|   | |   | |   |   |     |         |   |   |       |       |
+-+-+-+ +-+ +-+ +-+-+ +-+-+ +-+-+ +-+ +-+ +-+ +-+-+ +-+-+-+ +
|       |     | |   |   |   |   |         |   |   |       | |
+ +-+ +-+-+-+-+ +-+ +-+ +-+-+ + +-+-+-+ +-+ +-+ + +-+ +-+-+ +
|   | |       |   |   |       | |     | |   | | |     |     |
+ + + + +-+-+ +-+ + + +-+-+-+-+ + +-+ +-+ +-+ + +-+-+ + +-+-+
| | | |   |   |   | |         | | | |         | |     | |   |
+ + +-+-+ + +-+ +-+-+-+ +-+-+-+ + + +-+-+-+-+-+ + +-+-+ + + +
| |     | | |   |       |   |   | |     |   |   | |   | | | |
+ +-+-+ + + + +-+ +-+-+ + + + + + + +-+-+ + + +-+-+ + + +-+ +
| |   |   |   |   |   | | |   | | |   |   |   |     |   |   |
+ +-+ +-+-+-+-+-+ + + + + +-+-+-+ +-+ + +-+-+-+ +-+-+-+-+ + +
|                 | |   |             |                   | |
+-+-+-+-+-+-+-+-+-+-+-+-+-+-+-+-+-+-+-+-+-+-+-+-+-+-+-+-+-+-+