+-+-+-+-+-+-+-+-+-+-+-+-+-+-+-+-+-+-+-+-+-+-+-+-+-+-+-+-+-+-+-+-+-+-+-+
|     |             |       | |           |   | |             |       |
+-+-+ + + +-+-+-+-+-+ + +-+ + + +-+-+ +-+ + + + + +-+-+-+ +-+-+ + +-+ +
|   | | |   |   |     |   | |   |   | |     |   | |     | |     | |   |
+ + + +-+ + + + + +-+-+-+ + + +-+ + + +-+-+-+-+-+ +-+-+ + + +-+-+ + +-+
| | |   | |   |         | | | | | |   |   |   |         | | | |   |   |
+ +-+-+ +-+-+-+-+-+-+-+-+ + + + + +-+-+ + + + + +-+-+-+ + + + + +-+-+-+
| |   |                   | |   |       |   |     |   | | |   |       |
+ + + +-+-+-+-+-+-+-+-+-+-+ +-+-+-+-+-+-+-+-+-+ +-+ + +-+ +-+ +-+-+-+ +
|   |   |     |     |     |                   | |   |       | |     | |
+ +-+ + +-+ + + +-+ + +-+ +-+-+-+-+-+-+-+-+-+ + + +-+ +-+-+ + + +-+ + +
| |   |     |   | |   | |   |   |           | | | |   |   | | |   | | |
+ + +-+-+-+-+-+-+ +-+-+ +-+ + + +-+-+-+ + + + +-+ +-+-+ + + + + + +-+ +
| | |           |         | | |       | | | |   |       | | | | | |   |
+-+ +-+-+-+-+ +-+ + +-+-+-+ + +-+-+-+ +-+ +-+-+ +-+-+-+ + +-+ +-+ + +-+
|   |   |   |   | | |       | |           |   |       | |       | |   |
+ +-+ + + + + + + + + +-+-+-+ +-+-+-+-+ +-+ + +-+-+-+ +-+-+-+-+ + +-+ +
| |   | | | | |   |   |     |   |     | |   | |     | |     |   | |   |
+ + +-+ + + +-+ +-+-+-+ +-+ + + + +-+ +-+ +-+ + +-+ + + +-+ + +-+ + + +
|   | |   |   | |     |   | | |     |   |   |   | | |   | | |     | | |
+ +-+ +-+-+-+ + + +-+ +-+ + +-+-+-+ +-+ +-+ +-+-+ + +-+-+ + +-+-+ + +-+
|   |   |     | | | |   | |       | |     | |     |     |   |     |   |
+-+ +-+ + +-+-+ + + +-+ + +-+-+-+ +-+ +-+-+ + +-+ + +-+ + +-+-+-+-+-+ +
| |     | |   |   |   |   |     |   |     | | |   | |   | |   |     | |
+ +-+-+ + +-+ +-+-+ + +-+-+ + + +-+ + +-+ + + + + + +-+-+ + + + +-+ + +
|     | |   |     | | |     | | |   | |   | | | | |     |   | |   |   |
+ + +-+ +-+ +-+-+ + + + +-+-+ +-+ +-+-+ +-+ +-+ + +-+-+ +-+-+ + + +-+-+
| |     |   |     | |   |   |   | |   |   |     | |   |     | | |     |
+-+-+-+-+ +-+ +-+ + +-+-+ +-+-+ + + + +-+ +-+-+-+ + + +-+-+ + +-+ +-+ +
|       | | |   | | |     |     | | |   |     |   | |     | |   |   | |
+ +-+-+ + + + + +-+ +-+ + + +-+-+ + +-+ +-+ + + +-+ +-+-+ + +-+ +-+-+ +
| |   |   |   |     |   | |       |   |     | | |   |         | |     |
+ + + +-+-+-+-+ +-+-+ +-+ +-+-+-+-+ + +-+-+-+ + + +-+ +-+-+-+ + + +-+ +
|   |   |     | |   | |   | |   |   | |   |   | |   | |   |   |   | | |
+-+-+ + + +-+ + + + + + +-+ + + + +-+ + + +-+-+ +-+ +-+ + +-+ +-+-+ + +
|   | |   |   | | | | | |     |     |   |         |     |   | |       |
+ + +-+ +-+ +-+ + + + + +-+-+-+-+-+-+-+ +-+-+-+-+-+ +-+-+-+ +-+ +-+-+-+
| |   |   |   |   |   |       |       | | |       |   |   |   | |     |
+ +-+ + +-+-+ +-+-+-+-+-+-+-+ + +-+-+ + + + +-+-+ +-+-+ + +-+ + +-+-+ +
|   | | |   | |   |         | |   |   | | | |   | |     | |   |     | |
+ + + +-+ + + + + + +-+-+-+ + +-+ + +-+ + + + + + + +-+-+ + + +-+-+ + +
| | |     | |   | | |     | |     | |   | | | |   |     |   |     |   |
+ + +-+-+-+ +-+-+ + + +-+ +-+-+-+-+ + +-+ + +-+ +-+-+ + +-+-+-+ +-+-+ +
| |   |   | |   | |     | |   |     |     |   |     | |   |   | |     |
+ +-+ + + + + + + +-+-+-+ + + + +-+-+-+ +-+-+ +-+-+ +-+-+ + + + + +-+-+
| | |   | |   | |       |   | |   |   | |   | | |   |     | |   | |   |
+ + +-+-+ +-+-+ +-+-+-+ +-+-+ +-+ + +-+ + + + + + +-+ +-+-+ +-+-+ + + +
|   |   | |   | |       |       | |     | |   | |     |   | |   | | | |
+-+ + + + + + + + +-+-+-+ + +-+-+ + +-+-+ +-+-+ +-+-+-+ +-+ +-+ + +-+ +
|   | | | | |   | |       | |   | |   |   |       |         |   |   | |
+ +-+ + + + +-+-+ + +-+-+ +-+ + + +-+-+ +-+-+ + +-+ +-+-+-+ + +-+-+ + +
|   | | | |       |     |     | | |     |   | | |   |     | |     |   |
+-+-+ + + +-+ +-+-+-+-+-+-+ +-+ + + +-+-+ + + +-+ +-+ +-+ + +-+-+ +-+ +
|     |   |   |       |   |   | | | |     | |   |   |   | |         | |
+ + +-+-+-+-+-+ +-+-+ + + +-+-+ + + +-+-+ + +-+ +-+ +-+ + +-+-+-+-+-+ +
| | |         | |   |   |     |   | |   | |   |   |   | |   |       | |
+ +-+ +-+-+-+ + +-+ +-+-+-+-+ + +-+ + + + +-+ + + +-+ + +-+ + +-+-+ + +
| |   |     | |   |         | | |     | |   |   | |   |   | | |     | |
+ + +-+-+-+ + +-+ +-+-+ + +-+ + +-+-+-+ + + +-+ +-+ +-+-+ + + + +-+-+ +
| | |       |   |       | |   |     |   | |   | |   |     |   |   |   |
+ + +-+ +-+ +-+ +-+-+-+-+ + +-+-+-+ + + +-+-+ +-+ +-+ +-+-+-+-+-+ + +-+
| |   |   |   |       |   |     | |   | |   |       | |   |       | | |
+ +-+ + + +-+-+-+-+ +-+ +-+-+-+ + +-+ +-+ + +-+-+-+ + +-+ + +-+-+ + + +
|   | | | |         |   |     | | |   |   |       | |     | |     |   |
+ +-+ + + + +-+-+-+-+ +-+ +-+ + + + +-+ +-+-+-+-+ +-+-+-+ + + +-+-+-+ +
| |   | | |       |   |     | | |   |   |     |   |     | | |   |   | |
+ + +-+ + +-+-+-+ + +-+-+-+-+ + + +-+ +-+-+ + + +-+ +-+ + + +-+-+ + + +
| |   | |   |     |     |   | | |   | |   | | |   | | |   | |   | | | |
+ +-+ +-+ + + +-+-+-+-+ + + + + +-+-+ + + + + +-+ + + +-+-+ + + + + + +
|         | |             |   |         |   |   |         |   |   |   |
+-+-+-+-+-+-+-+-+-+-+-+-+-+-+-+-+-+-+-+-+-+-+-+-+-+-+-+-+-+-+-+-+-+-+-+