+-+-+-+-+-+-+-+-+-+-+-+-+-+-+-+-+-+-+-+-+-+-+-+-+-+-+-+-+-+-+-+-+-+-+-+-+-+-+-+-+-+-+-+-+-+-+-+-+-+-+
|                                                                                                   |
+-+ + +-+ + + +-+ + + + +-+ + + +-+ + +-+-+ + +-+ +-+ +-+-+ +-+ + + +-+ +-+ + + + +-+ +-+ + +-+ +-+ +
|   | |   | | |   | | |   | | | |   | |     |   | |       |   | | | |   |   | | |   | |   |   |   | |
+ + +-+ +-+ +-+ +-+ + + +-+-+-+ + + + +-+-+-+-+ +-+-+ + + +-+ + +-+ + +-+-+ +-+-+ + + + +-+-+ + +-+ +
| |   |   | |     | | |   |     | | |       |       | | |   | | |   |     | |     | | |     | |   | |
+ + +-+ + + +-+-+-+ + +-+-+ + + + + +-+ +-+ +-+ +-+-+ + +-+ + + +-+ + +-+-+ +-+ +-+-+ + + + +-+ + +-+
| | |   | |     |   |   |   | | | |   |   | |       | | |   | | |   | |       |     | | | |   | |   |
+ + + + +-+ + +-+ + + + + + + +-+ + + + + +-+ + +-+ + + + + +-+ +-+ + + + +-+ +-+ + + + +-+ +-+ + + +
| | | | |   |   | | | | | | |   | | | | |   | |   | | | | | |     | | | | |     | | | | |   |   | | |
+ + + + + +-+ + + +-+ +-+ +-+ + + + + + + + + +-+ + +-+-+ + + + + + + +-+-+-+ + + + + + + + + +-+ + +
| | | | |   | | |   | |   |   | | | | | | | |   | |     | | | | | | | |       | | | | | | | |   | | |
+ + + + + +-+-+-+-+-+-+ + + + +-+ + + + + + + + +-+ + +-+ + + + + + +-+ + +-+ + + + + + +-+ + + + + +
| | | | | |             | | |   | | | | | | | |   | |   | | | | | | |   |   | | | | | | |   | | | | |
+-+ + + +-+ + + + + +-+-+ + +-+-+ +-+ + + + + + +-+-+-+ +-+ +-+-+ + +-+ + +-+-+ +-+ + +-+-+ + + + + +
|   | | |   | | | |     | |   |     | | | | | |     |   |       | | |   | |     |   | |     | | | | |
+ + + +-+-+-+ + +-+ + + + + + + +-+ +-+ +-+ + +-+-+-+ +-+-+ + +-+ +-+ + +-+ + +-+-+ + + +-+ + + + +-+
| | |   |     |   | | | | | | | |   |   |   |       |     | |   |   | |   | | |     | | |   | | |   |
+ + + + + +-+ +-+ +-+-+ +-+ + +-+-+ + + +-+ +-+-+ + + + + + + + + + + + + + + + +-+ +-+-+ + + +-+ + +
| | | | |   | |     |   |   | |     | |   |   |   | | | | | | | | | | | | | | |   |   |   | |   | | |
+-+ +-+-+ +-+ + + + +-+ + + +-+ + + + + + + +-+-+ + +-+ + +-+-+ + + + + + + + + + + +-+ + +-+ + +-+ +
|   |       | | | | |   | | |   | | | | | | |     | |   |     | | | | | | | | | | |   | | |   | |   |
+-+ +-+ + + +-+ +-+-+ +-+-+ + +-+ +-+ + + +-+ + +-+-+-+-+ + + + + + +-+-+ + + + +-+-+-+ + + + + + + +
|     | | | |     |     |   |   | |   | |   | |         | | | | | |     | | | |   |     | | | | | | |
+ + + + + + + + +-+ + + + +-+-+-+ + + +-+ +-+ +-+-+ + + + +-+ +-+ + +-+ + + +-+ + + + +-+ + + + + + +
| | | | | | | | |   | | |       | | | |   |       | | | |   |   | | |   | |   | | | | |   | | | | | |
+ + +-+ + + + + + +-+ +-+ + + + +-+ +-+ + + + + +-+-+ + + + + +-+ +-+-+ + +-+-+-+ +-+-+ + +-+ +-+ + +
| | |   | | | | | |   |   | | | |   |   | | | |   |   | | | |   |     | |       |     | |   |   | | |
+-+ +-+ + + + + + +-+ +-+ + + + +-+ + + + +-+ + +-+-+ +-+ +-+ +-+ + +-+-+-+ + + +-+ + + + + +-+ + + +
|     | | | | | | |     | | | | |   | | |   | |     | |     | |   |       | | |   | | | | |   | | | |
+ + + + + + + + +-+-+ + + +-+ + +-+ + + + + + + +-+-+-+ + + + + +-+ +-+-+-+ + + + + + + + +-+ +-+ + +
| | | | | | | |     | | |   | |   | | | | | | |   |     | | | | |         | | | | | | | | |     | | |
+ + +-+ + + + +-+ +-+-+ +-+-+ +-+ + + + + +-+ + +-+-+ +-+ + + + +-+-+ +-+-+ + + + + + +-+ + + +-+-+ +
| |   | | | |   |   |       |   | | | | |   | |     | |   | | |   |       | | | | | | |   | | |     |
+ + +-+ + + + + + + + +-+ +-+ + + +-+ + +-+ + +-+ + +-+-+ +-+-+-+ + +-+ + + + + +-+ + + + + +-+-+ + +
| | |   | | | | | | |   |   | | |   | |   | |   | | |           | | |   | | | | |   | | | |     | | |
+ + + +-+ + + + + +-+-+ + + + +-+ + + + +-+ +-+ +-+ +-+ + +-+ + + + +-+ + +-+ +-+-+-+ + + + + + + + +
| | | |   | | | |     | | | |   | | | | |   |     |   | |   | | | |   | | |         | | | | | | | | |
+ + + + +-+ + + +-+-+ +-+ + + + + + + +-+ +-+ + + +-+ + + + + + + + + + +-+ + + + + +-+ +-+ + +-+ +-+
| | | |   | | |     |   | | | | | | |   | |   | |   | | | | | | | | | | |   | | | |   | |   |   |   |
+ + +-+-+-+ +-+-+ + +-+ +-+-+-+-+ + + + +-+ + +-+-+ +-+ + +-+-+ + +-+ +-+ + +-+-+-+ + + + + + + + + +
| |   |       |   | |         |   | | | |   |     |   | |   |   |   |   | |       | | | | | | | | | |
+ + + + + + + + + + + + + + + + + +-+ + + + + +-+-+ +-+ + +-+ +-+ + + + + +-+ + + +-+ + +-+ + +-+-+-+
| | | | | | | | | | | | | | | | |   | | | | |   |     | |   |   | | | | |   | | | |   | |   |       |
+ + +-+ + +-+-+ +-+ + + + + + + + +-+-+ + + +-+-+-+ +-+ +-+ + + + + +-+ +-+ + +-+-+ + + + + + +-+ + +
| |   | | |       | | | | | | | |   |   | |       | |     | | | | |   |   | | |     | | | | | |   | |
+ +-+-+-+-+ + + +-+-+ +-+-+-+ +-+-+ +-+ +-+-+-+-+ +-+ + + + + +-+ + + + + + +-+-+ + + + + + + + + + +
| |         | |     |   |         | |   |         |   | | | | |   | | | | |     | | | | | | | | | | |
+ +-+-+-+ + +-+ + + +-+ + + + +-+ + + +-+-+ + + + + + +-+ +-+ + + + +-+ +-+ + + + + +-+ + + + +-+ + +
|   |     |   | | |   | | | |   | | | |     | | | | |   | |   | | | |   |   | | | |   | | | | |   | |
+-+ +-+-+-+ + + + + + + +-+ +-+ + +-+ + + + + +-+ + +-+ +-+-+ +-+-+ + + +-+-+-+ + + +-+-+ + +-+ +-+ +
|         | | | | | | |   | |   |   | | | | | |   | |   |         | | | |       | |     | |   |   | |
+ +-+ +-+-+ + + + +-+-+ + +-+-+ + +-+ + + + +-+-+ +-+-+-+-+ +-+ + + +-+-+ +-+ + + +-+ + + + +-+ + + +
|   |     | | | | |     | |     |   | | | | |       |         | | | |     |   | |   | | | |   | | | |
+-+ + + +-+ +-+-+ + +-+ + + +-+ +-+ + + +-+-+-+ + +-+ + + + +-+ + + + + + + +-+ +-+ + + + +-+ + + +-+
|   | |   | |     |   | | | |   |   | | |       |   | | | |   | | | | | | | |   |   | | | |   | |   |
+ + + + + + +-+-+ + + + +-+ + + + + + + + + + + +-+ +-+-+ + + + + +-+ +-+ +-+-+ + +-+ + +-+ + +-+ +-+
| | | | | |     | | | |   | | | | | | | | | | |   |     | | | | |   |   |     | | |   |   | | |     |
+-+ +-+ + + + +-+ + + + +-+ +-+ + + +-+ +-+ + + +-+-+ + +-+ + + + +-+-+-+ +-+ + + + + + +-+ + + +-+ +
|     | | | | |   | | | |     | | |   |   | | | |     | |   | | | |       |   | | | | | |   | |   | |
+ + + +-+ + + +-+ +-+-+ + +-+-+-+ + +-+ +-+-+ + +-+-+-+ + +-+ + + +-+-+ +-+ + + +-+ +-+-+ + +-+-+ +-+
| | | |   | | |   |     |       | |   |   |   | |       | |   | | |     |   | |   |     | | |       |
+ + + +-+ + + + +-+ + +-+-+ + + + +-+ + +-+ + +-+-+ + +-+-+ +-+ + + + + + + +-+-+ + + + + + + + +-+ +
| | | |   | | |   | | |     | | |   | |   | |   |   | |       | | | | | | | |     | | | | | | | |   |
+ + +-+ + + +-+ +-+ +-+-+ +-+-+ + + + +-+-+-+ + +-+ + +-+-+ + + + +-+ + + +-+-+ +-+-+-+-+ + +-+-+ + +
| |   | | |   | |       |     | | | |   |     | |   | |     | | | |   | | |         |     | |     | |
+ +-+ + +-+-+-+ + +-+ + + + +-+-+-+ + + +-+ +-+-+ +-+ + +-+-+ +-+ + + + + + + + + + + + + + + + + + +
| |   |       | | |   | | |       | | |   |   |     | | |     |   | | | | | | | | | | | | | | | | | |
+ +-+ + + + + +-+-+ +-+ + + +-+ + + + +-+-+-+ + + +-+ + +-+-+-+ + + + +-+ + +-+-+-+-+ + +-+ + + + + +
|   | | | | | |       | | | |   | | | |       | | |   |   |     | | | |   | |         |   | | | | | |
+-+ + +-+ + + +-+ + + +-+ +-+ + + + + +-+ + + + + +-+ + + + + + + + + + +-+-+ +-+ +-+-+-+ + + +-+-+ +
|   |   | | | |   | | |     | | | | | |   | | | |   | | | | | | | | | |   |     |     |   | |   |   |
+ +-+-+ + + +-+ + +-+-+-+-+ + + + + + + + + + + + +-+ +-+-+-+ +-+-+ + +-+ +-+-+ + + + +-+ + + + + + +
|     | | | |   |   |       | | | | | | | | | | |   |   |     |     | |     |   | | | |   | | | | | |
+ +-+-+-+ + + + + + +-+ + +-+-+-+ +-+ + + +-+ + +-+ +-+ + +-+-+ +-+ + + +-+ + + +-+ + +-+ + + + +-+ +
|     |   | | | | |   | |   |     |   | | |   |   | |   | |       | | |   | | | |   | |   | | |   | |
+ +-+ + + + + + + + + +-+ + +-+ + + +-+ + +-+ + + + + + + + +-+ + +-+ +-+ + + + + + + +-+ +-+ + + +-+
|   | | | | | | | | | |   |   | | |   | |   | | | | | | | | |   |   | |   | | | | | | |     | | |   |
+ + + + + + + +-+-+ +-+-+ + +-+-+-+ +-+-+ +-+ + + + + +-+-+-+-+-+ +-+-+-+-+ + +-+-+-+ + + +-+ + + + +
| | | | | | |     |     | |       | |       | | | | |       |     |         | |       | | |   | | | |
+-+ + + +-+-+ + + +-+-+ +-+-+ + +-+ + + +-+-+ +-+-+-+ + + +-+ + +-+ + + +-+ + +-+ + + + + +-+-+ + + +
|   | | |     | |     |   |   | |   | | |         |   | |   | |   | | | |   | |   | | | | |     | | |
+ + + + + + +-+-+ + + + + + + + +-+ +-+ + + + +-+-+ + +-+ +-+ + + + + +-+-+-+ +-+ + + + + + + +-+ + +
| | | | | |     | | | | | | | | |   |   | | |   |   |   |   | | | | |     |   |   | | | | | | |   | |
+ + + + + +-+ +-+ +-+ +-+ + + + + + +-+-+ + + + + + + + + + + + +-+ + + +-+ + + +-+-+-+-+ +-+ + + + +
| | | | |   | |   |   |   | | | | |   |   | | | | | | | | | | | |   | |   | | |   |       |   | | | |
+ + + + + + + +-+ +-+ + + + + +-+ +-+ + + +-+ + + +-+ +-+ +-+ + + +-+ + + + + + +-+ +-+ + + +-+ + + +
| | | | | | | |   |   | | | |   |   | | | |   | |   |   |   | | |   | | | | | |   |   | | | |   | | |
+ + + + + +-+-+ +-+-+ + + + +-+ +-+ + + + + + +-+ +-+ + + + + +-+ + +-+ +-+-+ + + + + + +-+ + +-+-+ +
| | | | | |     |     | | | |     | | | | | |   |   | | | | |   | |   |     | | | | | | |   | |     |
+ + + + + + +-+-+ + +-+ +-+ + + + +-+-+-+ + + + +-+ + + +-+ + + +-+ + +-+ + +-+ +-+ +-+-+ + + +-+-+ +
| | | | | | |     | |   |   | | | |       | | | |   | | |   | | |   |   | | |   |     |   | | |     |
+ + +-+-+ + +-+ + + +-+ + + + + + + + + + +-+-+ + + + + +-+-+ + +-+ + +-+-+ +-+ +-+ + + + +-+ +-+ + +
| | |     |   | | |   | | | | | | | | | |     | | | | |     | |   | | |     |   |   | | | |     | | |
+-+ +-+ + +-+ + + + + + + + + + +-+ +-+-+ +-+ +-+ + +-+ +-+-+ + + +-+-+-+-+ +-+ + + +-+-+-+ + + + + +
|   |   | |   | | | | | | | | |   |     | |     | |   |   |   | |       |   |   | |       | | | | | |
+ + +-+ + +-+ + + +-+-+-+ + +-+ + +-+ + + + + + + +-+ + +-+ +-+ + +-+ +-+-+ + + + +-+-+ + + + + + +-+
| | |   |   | | |     |   | |   |   | | | | | | |   | |   |   | |   |     | | | |     | | | | | |   |
+ + + + +-+ +-+-+ +-+ + + + + + +-+ +-+ + + + + + + +-+-+-+ +-+ + + + + + +-+ + +-+ + + + + + +-+ + +
| | | |   |     | |   | | | | |   |   | | | | | | |       | |   | | | | | |   |   | | | | | |   | | |
+-+-+-+-+-+-+-+-+-+-+-+-+-+-+-+-+-+-+-+-+-+-+-+-+-+-+-+-+-+-+-+-+-+-+-+-+-+-+-+-+-+-+-+-+-+-+-+-+-+-+