+-+-+-+-+-+-+-+-+-+-+-+-+-+-+-+-+-+-+-+-+-+-+-+-+-+-+-+-+-+-+-+-+-+-+-+-+-+-+-+-+-+-+-+-+-+-+-+-+-+-+
|     | |       |   |         |     |       |               |       |       |     |     |         | |
+-+-+ + + +-+ + + + + +-+-+-+ + +-+ + +-+-+ + + +-+-+-+-+-+ +-+ +-+-+ +-+ + + +-+ + + +-+ +-+ +-+ + +
|   | | | |   |   |   |     |   | |   |   | | |       |     |   |     | | | |   |   |   | | | | | | |
+ +-+ + + + +-+ +-+-+-+-+-+ +-+-+ +-+-+-+ + + +-+-+-+ + +-+-+ +-+ +-+-+ + + +-+ +-+-+-+ + + + + + + +
| |   |   | |   |   |     |         |     | |     |   |   |     |   |   | |   | |     |     | |   | |
+ + +-+-+ + + +-+ + + +-+ +-+ +-+-+ + +-+ + +-+-+-+ +-+-+ + +-+ +-+ + + + +-+ + +-+-+ +-+-+-+ + +-+ +
| | |   | | |   | | |   |   |   |   | |   |         |   | | |     | | | | |   |       |   |   |     |
+ + + + +-+ +-+-+ + +-+ +-+ + + + +-+ + +-+-+-+-+-+-+ +-+ +-+ +-+-+ + +-+ +-+-+-+-+-+ + + + +-+-+-+-+
| |   |   | |     |     | | | | | |   | |           |   |   |     | | |   |         | | | |         |
+ +-+-+-+ + + +-+-+-+-+-+ + +-+ + +-+ + + +-+ +-+-+ + + +-+ +-+-+ + + + +-+ +-+-+ + + +-+ +-+-+-+-+ +
|         | | |         | | |   |     | |   |     | | |   | |   |   | |   |   |   | | |           | |
+ +-+-+-+-+ + +-+ +-+-+ + + + +-+-+-+-+ +-+-+-+-+ + +-+ + + + + + +-+ +-+ +-+ + +-+-+ + +-+-+-+ +-+ +
|   |   |   | |   |       | |   | |     |       | |   | | |   | |       |     | |   |   |   |   |   |
+-+ + + +-+ + + +-+-+ +-+-+ +-+ + + +-+-+ +-+-+ + +-+ + + +-+-+ +-+ +-+-+-+-+ + + + +-+-+ + + +-+ +-+
| |   |   | | |     | |   | |   | | |     |       |   | |     |   | |   |   | | | |     | |     |   |
+ +-+-+-+ + + + +-+ + + + + + +-+ + +-+ +-+-+-+-+-+-+ +-+-+ + +-+ +-+ + + + +-+ + + +-+-+ +-+-+ +-+ +
|       | |   |   | | | | | |   | |     |           |       | | | |   | | |     | |     | |   | |   |
+ +-+-+ + + +-+-+-+ + + + + +-+ + +-+-+ + +-+-+-+-+ +-+-+-+-+ + + + +-+ + +-+-+ + +-+-+ + + + +-+ +-+
| |     | | |     | | | | |   | |     | |     |   |     |   | | |   | | |   |   |   | |   | |   |   |
+-+ +-+-+ + + +-+ + +-+ + +-+ + +-+ +-+ +-+-+ + +-+-+-+ + +-+ + +-+-+ + + + +-+-+-+ + +-+-+ +-+ +-+ +
|   |   | |   |   |   | |   | |   |       | | | |   |   | |     |       | |       | |     |   |     |
+ +-+ + + +-+-+ +-+-+ + + +-+ +-+ +-+-+-+ + + + + + + +-+ + +-+-+ +-+-+-+-+-+-+ + + + + +-+-+ +-+-+-+
|     | | |   |     | | |   |   |       |   |   | |   | |   | |   |     |     | |   | |     |       |
+ +-+-+ + + + +-+-+ + + +-+ +-+ +-+-+-+ +-+ +-+ + +-+-+ + +-+ + +-+-+ + + +-+ + +-+-+ +-+ + +-+-+-+ +
|   | |   | |       |     |   |   |   |   | |   |   |   |   | | |     |   |   |   |     | |   |     |
+-+ + +-+-+-+-+ +-+-+-+-+ +-+ +-+ + + +-+ +-+ +-+-+ + +-+-+ + + +-+ +-+-+-+ +-+-+ +-+-+ + +-+ + +-+-+
| | | |       |   |     | |   |   | |   |     |     |     |   | |   |   |   |   |     | | |   |     |
+ + + + +-+ + +-+ + +-+ + + + + +-+ +-+ +-+-+-+ +-+-+ +-+ +-+ + + +-+ +-+ +-+ + +-+-+ +-+ +-+-+-+-+ +
|   |   |   | | | | | | | | | |   |   |       | |     |     | |   |       |   |     |   | |   |     |
+ +-+-+-+ +-+ + + + + + +-+ + +-+ +-+ +-+-+-+ + +-+-+-+ +-+ + +-+-+ +-+-+-+ + +-+-+-+-+ + + + + +-+ +
|         | | | | | | | |   |   |     |       |   |   |   | | |   | |     | | |   |   | | | |   |   |
+-+-+-+-+-+ + + + + + + + +-+-+ +-+-+-+ +-+-+-+ + + + + + +-+ +-+ + + +-+ +-+ + + + + + + + +-+-+ +-+
|     |   |   | |   |   |     | |       |     | | | | | |         | | |   |   | |   |     | |   |   |
+-+ +-+ + + +-+ +-+-+ +-+ +-+ + + +-+-+-+ +-+ + + + + + +-+-+-+-+ + + + +-+ +-+ +-+-+-+ +-+ + + +-+ +
|   |   |   |         | |   | | | |   | |   | | |   | |     |   | | | |   |     |     | |   | |   | |
+ +-+ +-+-+-+-+ +-+-+-+ +-+ + + + + + + +-+ + + +-+-+ +-+-+-+ + + + + +-+ +-+-+ + +-+ +-+ +-+ +-+ + +
|   | |       |     |       | | |   | | |   |   |   |         | | |   | |     | |   |     |   |   | |
+-+ + + +-+-+ +-+-+ +-+ +-+-+ + +-+-+ + + +-+-+-+ +-+-+-+-+-+-+ + +-+-+ +-+-+ +-+-+ +-+-+-+ +-+-+ + +
|   |   |   |     |   | |   | |   |   | |   |   |       |       |           |   |   |       |   | | |
+ +-+-+-+ +-+-+-+ +-+ + + + + +-+ + +-+ +-+ + + + + +-+ + +-+-+ +-+-+-+-+-+ +-+ + +-+-+-+ +-+ + +-+ +
|     | |     |   |   | | |   |   | |   |   | |   | |   | |   | |         |   | | |     |   | |     |
+ + + + + +-+ + +-+ +-+-+ +-+ +-+-+ + + + +-+-+-+-+ + +-+ + + + + +-+-+-+ + +-+ + + +-+ + + + +-+-+-+
| | | |   |   | |         |   |   | | | |           |   | | |   | |   |   | |   | | |   | | |     | |
+-+ + +-+ + + + +-+-+-+-+-+ +-+ + + + + +-+-+ +-+-+-+-+-+ + +-+-+ + + + +-+-+ +-+ + + +-+-+ +-+-+ + +
|   |   | | | |     |       |   |   | |       |           | |   | | | |     |   | | | |         | | |
+ +-+-+ +-+ + +-+-+ +-+ +-+-+ +-+-+-+ +-+-+-+-+ +-+-+-+-+-+ +-+ + +-+ +-+-+ +-+ + + + +-+ +-+-+ + + +
|   | |     |     |   | |     |     |   |       |     |   | |   |         |   |   | |   | | |   |   |
+ + + +-+-+-+-+-+ +-+ +-+ +-+-+ +-+ +-+ + +-+-+-+ +-+-+ + + + + +-+-+ +-+-+ +-+-+-+ +-+ + + + +-+-+ +
| | |       |       |   | |     | |   | | |     |   |   |     |   |   |   |         |     |     | | |
+ + + + +-+-+ +-+-+-+-+ + + +-+-+ +-+ +-+ + +-+-+ + + +-+-+-+-+-+-+ +-+ + +-+-+-+ + + +-+-+-+-+ + + +
| | | |         |     | | | |         |   | |     |     |       |     | | |     | | | |     |     | |
+ + + +-+-+-+-+-+ +-+ + + + +-+ +-+-+-+ +-+ + +-+-+-+-+-+ +-+-+ + +-+-+ + + +-+ +-+ +-+ +-+ + +-+-+ +
| | |   |         | |   | |   | |   |     |   |       |   |   |   |     |   |       |   |   | |     |
+ + +-+ + +-+-+-+-+ +-+-+ + + + + + +-+ + +-+ + +-+-+-+ +-+ + +-+-+ +-+-+-+-+ +-+-+-+ +-+ +-+-+ +-+-+
| |   | |           |     | | |   |   | |   |   |       |   |   | |   |       |   |   |   |     |   |
+ +-+ + +-+-+-+-+-+ + +-+ + + +-+-+-+ +-+-+ +-+ + +-+-+-+ +-+ + + +-+ +-+-+-+-+ + + +-+ + + +-+-+ + +
|   | |   | |   |   | |   | | |     |     | |   | |   |   |   | |   | |         | | |   | | |     | |
+-+ + +-+ + + + + +-+-+ +-+-+ + +-+ +-+-+ + +-+-+ + +-+ +-+ +-+ + +-+ + +-+-+-+-+ + + +-+-+ + +-+-+ +
|   | |   |   | |   |   |   | |   |     | |   |   | |   |   |   |   |   |     | |   |   |   |   |   |
+-+-+ + +-+ +-+ +-+ + +-+ + + +-+ + +-+ + +-+ + +-+ + +-+ +-+ +-+-+ +-+-+ +-+ + +-+-+-+ + +-+ + +-+ +
|     | | |   | |   | |   | |   | |   | |   | |   |   |   |   |           |   |       |   |   |   | |
+ +-+-+ + + +-+ + +-+ + + + +-+ +-+-+ + +-+ + +-+ +-+-+ +-+ +-+ +-+-+-+-+-+ +-+-+-+-+ +-+-+-+-+-+ + +
| |   | |   |   |     | | |     |     |   | |   |       | | |     |       | |       |             | |
+ +-+ + +-+-+ +-+-+-+-+ + +-+-+-+ +-+ +-+-+ +-+ +-+-+-+-+ + +-+-+ + + +-+ + + +-+-+ + +-+-+-+-+-+-+ +
|   | |     |       |   |   |     | | |   | |     |     | |     | | | |   | |   | |   |   |     |   |
+ + + +-+-+ + + + +-+ +-+-+ + +-+-+ + + + + + +-+ + +-+ + +-+-+ + +-+ + +-+ +-+ + +-+-+-+ + + +-+ +-+
| | |     | | | | |       | |   |     | | | |   |   | | |   | |   |   |   |     |     |   | |     | |
+ + +-+-+ + + + + + +-+-+-+ + + + +-+-+ + + +-+ +-+-+ + + + + +-+-+ +-+ +-+-+-+-+ +-+ + + + +-+-+-+ +
| |   |   | | | | |   |     | | |     | | | |   |     | | |   |     |   |         | | | | |     |   |
+ +-+ + +-+ +-+ + +-+ + +-+-+-+ +-+-+-+ + + + +-+ + +-+ + +-+ +-+-+ +-+-+ +-+-+-+ + + + +-+-+-+ + + +
|   | |       | | |   |   |   |         |     | | | |   |   |     |       |     | |   | |     |   | |
+-+ + +-+-+-+ + +-+ +-+-+ + + +-+-+ +-+-+-+-+-+ + + + +-+-+ +-+-+ + +-+-+-+ + +-+ + +-+ + +-+ +-+-+ +
| | |     |     |   | |   | |     |   |   |     | | |       | |   |   |   | | |   | |   | | |       |
+ + +-+-+ +-+-+-+ +-+ + +-+ +-+-+ +-+-+ + + + +-+ + +-+-+-+-+ + +-+-+ + + + + + +-+ + + + + +-+-+-+-+
| | |   |       |     |   |     | |     | | |   | |   |   |     |       |   | | |   | | | |     |   |
+ + + +-+-+-+-+ + +-+-+ + +-+-+ + + +-+-+ + +-+ + + +-+ + + +-+-+-+-+-+-+-+-+-+ + +-+ +-+ +-+ +-+ + +
|   |         |   |   | |   |   |   | |   | |   | | |   |   |             |     |   |   |   | |   | |
+ +-+-+-+ +-+ +-+-+ + + + +-+ +-+-+-+ + +-+ + +-+ + + +-+-+-+-+ +-+-+-+-+ + +-+-+-+ +-+ +-+ + + +-+ +
| |   |   | |   |   | | |   |   |     |   | |     |   |   |     |       | | |           | | |     | |
+ + + + +-+ +-+ + +-+ +-+-+ +-+ + + +-+-+ + +-+-+-+-+-+ +-+ + +-+-+ +-+ + + + +-+-+-+-+ + + +-+-+ + +
| | |   |   |   |   |     |   | | | |     |     |     |     | |   | |   |   | |   |       |     | | |
+ + +-+-+ +-+ +-+-+ +-+-+ + + + + + + +-+-+-+-+ + +-+ + +-+-+ + + +-+ +-+ +-+-+ + +-+-+-+-+-+-+ +-+ +
|   |   |     |   | |   |   | |   | |   |       | |   | |     | |   |     |   | |     |       |     |
+-+-+-+ + +-+-+ + + + +-+ +-+-+-+-+ +-+ + +-+-+-+ + +-+ + +-+-+ +-+ + +-+-+ + + +-+-+ + +-+-+ +-+-+ +
|     | | |     | | |     |           | |         |   | |   |     | |   |   |   |   |   |   |     | |
+ +-+ + + + +-+-+ + +-+-+-+ +-+-+-+-+-+ +-+-+-+-+-+-+ + +-+ + +-+-+ + +-+ +-+-+-+-+ +-+-+-+ +-+ + + +
|   | | | |   |   |       |     |     | |       |   | |   | |   |   | |   |             |   | | | | |
+-+ + + + + + + +-+-+-+-+ +-+-+ + +-+ + + +-+-+ + + + +-+ + +-+ + +-+-+ +-+-+-+-+ +-+-+ + + + + +-+ +
|   |   | | | |         |     | |   |   |   | |   |     | |   | |     | |       |   | |   |   |     |
+ +-+-+ + + + +-+-+-+-+ +-+ +-+ +-+ +-+-+-+ + +-+-+-+-+ + +-+ + +-+-+ + + +-+-+ +-+ + +-+-+-+ +-+-+-+
|     | | | |   |     |   |       |   |   |   |     |   | |   | |     |   | |   |   | |   |   |     |
+-+-+ + + +-+ + + +-+-+-+ +-+-+-+-+-+ + + +-+ + +-+ +-+ +-+ + + + +-+ +-+-+ + +-+ +-+ + + + +-+-+-+ +
|   | | |   | | |       |     | |     | | |   |   |   |     | | |   |   | |   |   |     |         | |
+ + + + +-+ +-+ +-+-+ + +-+-+ + + +-+-+ + + +-+-+ +-+ +-+-+-+-+ +-+ +-+ + + +-+-+ +-+-+-+-+-+-+-+ + +
| |   | |   |   |     | |       |   |   | |     |   | |     |   |   |     |     | |   |     |     | |
+ +-+-+ + +-+ +-+ +-+-+ + +-+-+-+-+ + +-+ +-+-+-+ +-+ + +-+ + +-+ +-+-+-+-+-+-+ + + + + +-+ +-+ +-+ +
| |   | | |   |   |   | | | |       |   |         |   |   | | |   |   |       | |   |     |   | |   |
+ + + +-+ + +-+ + + + +-+ + + +-+-+-+-+ +-+-+-+-+-+ +-+-+ + + + +-+ + + +-+-+ + +-+-+-+-+-+-+ + + + +
|   |       |   |   |       |                     |       |   |     |       |                 |   | |
+-+-+-+-+-+-+-+-+-+-+-+-+-+-+-+-+-+-+-+-+-+-+-+-+-+-+-+-+-+-+-+-+-+-+-+-+-+-+-+-+-+-+-+-+-+-+-+-+-+-+