+-+-+-+-+-+-+-+-+-+-+-+-+-+-+-+-+-+-+-+-+-+-+-+-+-+-+-+-+-+-+-+-+-+-+
|                                                                   |
+ +-+ + + +-+-+ +-+ + +-+ + +-+ + + +-+ +-+-+ +-+ + + + + +-+ +-+ +-+
|   | | |     |   | |   | |   | | |   |     |   | | | | |   |   |   |
+ + +-+ +-+ +-+ +-+-+-+ + +-+-+-+ + +-+ +-+ +-+ + + + + + +-+ + +-+-+
| |   |   |   |       | |       | |   |   |   | | | | | |   | |     |
+ +-+-+-+-+-+-+-+-+-+-+-+-+-+ + + + +-+ +-+ + +-+ + + +-+ +-+ +-+ + +
|                           | | | |   |   | |   | | |   |   |   | | |
+ +-+-+ + +-+ + +-+ +-+ +-+ + +-+-+ +-+ +-+-+-+ +-+ +-+-+ +-+ +-+ +-+
|     | |   | |   |   |   | |     |   |       |   |     |   |   |   |
+ +-+-+-+-+-+-+ + +-+ + +-+-+-+ +-+ + +-+-+ + + +-+ +-+-+-+ + +-+-+-+
|             | |   | |       |   | |     | | |   |       | |       |
+ +-+ + + +-+ + + +-+-+-+-+ +-+-+ + + +-+-+-+-+ + +-+ + + + +-+ + + +
|   | | |   | | |         |     | | |         | |   | | | |   | | | |
+ + + +-+-+-+-+-+ + + + +-+-+-+-+ + +-+-+ + + + +-+ + + +-+ +-+-+-+ +
| | |           | | | |         | |     | | | |   | | |   |       | |
+ +-+ +-+-+-+-+-+ +-+ + +-+-+-+ +-+ + +-+ +-+ +-+ +-+ +-+ + +-+ +-+-+
|   |           |   | |       |   | |   |   |   |   |   | |   |     |
+ +-+ + + + +-+ + + +-+-+-+ +-+ + + +-+-+ +-+ +-+-+ + + +-+ +-+ + + +
|   | | | |   | | |       |   | | |     |   |     | | |   |   | | | |
+ + +-+ + +-+-+ +-+-+ + + +-+-+-+ + +-+ + +-+ + + + + + + +-+-+-+-+-+
| |   | |     |     | | |       | |   | |   | | | | | | |           |
+ + +-+ + + +-+-+ + +-+ + +-+ +-+ + + + + + + + +-+-+-+ +-+-+-+ +-+-+
| |   | | |     | |   | |   |   | | | | | | | |       |       |     |
+ + + + + +-+-+-+ +-+-+ +-+-+-+-+-+ + + +-+ + + +-+-+-+-+ + +-+ +-+ +
| | | | |       |     |           | | |   | | |         | |   |   | |
+ +-+ +-+ +-+-+-+-+-+ +-+ +-+ + +-+ + + +-+-+-+-+ + +-+-+ + + + +-+ +
|   |   |           |   |   | |   | | |         | |     | | | |   | |
+ +-+-+ + + + +-+-+-+-+-+ +-+ + +-+-+ +-+ +-+ +-+-+ + +-+-+-+-+-+-+-+
|     | | | |           |   | |     |   |   |     | |               |
+ + + +-+ +-+-+-+ + +-+-+ +-+ +-+-+ + +-+-+ +-+ +-+ + +-+ +-+ +-+-+-+
| | |   |       | |     |   |     | |     |   |   | |   |   |       |
+ + +-+-+ +-+ +-+-+ +-+-+-+ + + + +-+-+-+ + + +-+-+-+-+ + +-+ + +-+-+
| |     |   |     |       | | | |       | | |         | |   | |     |
+ + + + + +-+-+-+ +-+-+-+ + +-+ + +-+ +-+-+ + +-+-+-+ + + + + + + +-+
| | | | |       |       | |   | |   |     | |       | | | | | | |   |
+ +-+-+ +-+ +-+-+-+ +-+ +-+ +-+-+-+-+-+ +-+-+ + +-+ +-+-+-+-+ +-+ +-+
|     |   |       |   |   |           |     | |   |         |   |   |
+ +-+ + + + +-+ + +-+ + +-+ + +-+-+ +-+ + + +-+ +-+-+ +-+ +-+ + + + +
|   | | | |   | |   | |   | |     |   | | |   |     |   |   | | | | |
+ + + + +-+-+-+ + +-+-+ +-+-+ + + +-+ + +-+-+-+-+-+-+ + +-+ + + +-+-+
| | | |       | |     |     | | |   | |             | |   | | |     |
+ +-+-+-+-+ + + + + + +-+ +-+ + + + + +-+ +-+-+-+-+ + +-+-+-+-+ + +-+
|         | | | | | |   |   | | | | |   |         | |         | |   |
+ + + +-+ +-+-+-+-+-+ +-+ +-+-+-+-+-+-+-+-+-+-+ +-+ +-+-+ +-+ + +-+-+
| | |   |           |   |                     |   |     |   | |     |
+ +-+-+ +-+-+ +-+ +-+ + + +-+ +-+-+ + +-+ + +-+ +-+ +-+ + +-+-+-+ +-+
|     |     |   |   | | |   |     | |   | |   |   |   | |       |   |
+ +-+ +-+ +-+ +-+ + +-+ + + + + +-+ + +-+ +-+ +-+ +-+ +-+-+-+-+ + + +
|   |   |   |   | |   | | | | |   | |   |   |   |   |         | | | |
+ + + + + +-+ +-+ + + + +-+-+ +-+ + +-+-+-+-+-+ +-+-+ +-+-+-+-+-+-+-+
| | | | |   |   | | | |     |   | |           |     |               |
+ +-+-+-+-+-+-+ + +-+ +-+ +-+-+-+ + + + +-+ + + +-+-+-+-+-+ +-+ +-+-+
|             | |   |   |       | | | |   | | |           |   |     |
+ +-+-+ + +-+-+ + +-+ +-+ +-+-+-+ +-+ +-+ +-+ +-+-+-+ +-+-+ + + + +-+
|     | |     | |   |   |       |   |   |   |       |     | | | |   |
+ + +-+ +-+-+ +-+ + + +-+-+-+ +-+-+ +-+ + + + + + + +-+-+-+-+-+ + + +
| |   |     |   | | |       |     |   | | | | | | |           | | | |
+ + + +-+ + + + + +-+ + +-+-+ +-+-+-+ + + + +-+-+ + +-+-+-+ + + +-+ +
| | |   | | | | |   | |     |       | | | |     | |       | | |   | |
+ +-+ + + +-+ + +-+ +-+ +-+-+ +-+-+-+ + + +-+ +-+-+ +-+-+-+-+ + + +-+
|   | | |   | |   |   |     |       | | |   |     |         | | |   |
+ + +-+-+-+ +-+ +-+ +-+ +-+ + +-+-+-+ +-+ +-+ +-+ + + + +-+ +-+ +-+-+
| |       |   |   |   |   | |       |   |   |   | | | |   |   |     |
+ +-+ +-+ +-+ +-+-+-+ +-+ +-+ + + + + + + +-+-+ +-+ +-+-+ + + +-+-+-+
|   |   |   |       |   |   | | | | | | |     |   |     | | |       |
+ +-+ + +-+-+ + +-+ +-+ + +-+-+ + +-+ +-+-+-+ + +-+-+-+-+ +-+ + + +-+
|   | |     | |   |   | |     | |   |       | |         |   | | |   |
+-+-+-+-+-+-+-+-+-+-+-+-+-+-+-+-+-+-+-+-+-+-+-+-+-+-+-+-+-+-+-+-+-+-+