+-+-+-+-+-+-+-+-+-+-+-+-+-+-+-+-+-+-+-+-+-+-+-+-+-+-+-+-+-+-+-+-+-+-+-+-+-+-+-+-+-+-+-+-+-+-+-+-+-+-+
| |     |     |   |             |   |     |   |     |       |     |       |   |         |     |     |
+ +-+ + + +-+ + +-+ +-+-+-+-+ + + + +-+-+ + + + + + + +-+ + + + + + +-+-+ + +-+ +-+-+ + +-+-+ + + + +
| |   |   |   |   |       |   |   |     |   |   | | |   | | | | | | |   | | |   | |   |     |   | | |
+ + +-+-+-+ +-+-+ +-+-+-+ + +-+-+-+-+-+ +-+ +-+-+ + +-+-+ + +-+ + + + + + + + +-+ + +-+-+-+ +-+ + + +
| |   | |   |   |         |     |     |   |     | |       |   | |   | |   |       | |     |   | | | |
+ +-+ + + +-+ + +-+-+-+ +-+-+-+ +-+-+ +-+ +-+-+ + +-+-+-+-+-+ + +-+-+ +-+-+-+-+-+-+ + + +-+-+ + + + +
|   | |   |   | |     |   |   |     |   |     | |       |   |   |     |         |   | | |     | | | |
+-+ + +-+ + +-+ + +-+ +-+-+ + +-+-+ + +-+-+-+ +-+ +-+-+ + +-+-+-+ +-+-+ +-+-+-+ + +-+ +-+ +-+-+ + +-+
| | |   | | |   |   |       |       |       |   | |     |     | | |   |   |   | | |       |   | |   |
+ + +-+ + + + +-+-+ +-+-+-+ +-+-+-+-+ +-+-+ +-+ +-+ +-+-+ + + + + + +-+ + +-+ + + +-+ +-+-+ + +-+-+ +
| |     |   | |     |   | | |     |   |   |       | |     | |   | |     |   | | |   |       |   |   |
+ +-+-+-+-+-+ +-+ + + + + + + +-+ +-+-+ + +-+-+-+ + + +-+-+ +-+ + + +-+-+-+ + + +-+ +-+-+-+-+-+ + +-+
|   |   |   |   | | | | |   |   | |   | |   |   |   | |     | | | |   |     | |     |   |     | |   |
+ + + + + +-+-+ + +-+ + +-+-+-+ + + + + +-+ + + +-+-+-+ +-+-+ + + +-+-+ +-+-+ +-+-+-+ +-+ + +-+ + + +
| |   |   |     |     |     |   | | | |   |   | |     |     |   |       |             |   |     | | |
+ +-+-+-+ + +-+-+ +-+-+-+-+ + +-+ + + + +-+-+-+ + +-+ + +-+ +-+ +-+-+-+-+-+ + +-+-+-+ + +-+-+-+-+-+ +
|     |   |     |   |     |   | | | |   |     |     | |   |   |             | |   |   | |           |
+-+-+ +-+-+-+-+ +-+ +-+ + +-+-+ + + +-+-+ +-+ +-+-+-+ +-+ +-+ +-+-+-+-+-+-+-+ + + +-+-+ +-+-+ +-+-+ +
|     |         | |     |   |   |     |   | | |       | |   | |   |   |   |   | |       |   | |   | |
+ +-+-+ +-+-+-+-+ +-+-+-+-+ + +-+-+ +-+ +-+ + + +-+-+-+ + +-+ + + + + + + +-+-+ +-+-+-+-+ + + + + + +
|       |         |       |   |   | |   |   | |       |   |   | |   |   | |     |   |     |   | |   |
+ +-+-+-+ + +-+-+-+ +-+ +-+ +-+ + +-+ +-+ + + +-+-+-+ + +-+ + + +-+-+-+-+ + +-+-+ + + + +-+-+-+ +-+-+
| | |   | |           |     |   |     |   | |   |     |   | | |   |     | |       | | |   |   |     |
+ + + + + +-+-+-+-+-+-+-+-+-+ +-+-+-+-+ + +-+-+ + +-+-+-+ + + +-+ + +-+ + +-+-+-+-+ + +-+ + +-+-+-+ +
| |   | | |     | |         |   | |     |   |   |     | | | |   |   |   |     |   | | |   | |       |
+ + +-+ + + +-+ + + +-+-+-+ + + + + +-+-+-+ + +-+-+-+ + + + +-+-+-+-+ +-+-+ +-+ + + + + +-+ + +-+-+-+
| |   |     | |   | |   |   | | | | |   |   | |       | | |       |   |     |   |   | | |           |
+ +-+-+-+-+-+ + +-+ + + + +-+-+ + + + + + + + +-+ +-+-+ + +-+-+-+ + +-+ +-+-+ +-+-+-+ + +-+-+-+-+-+ +
|           | | |   | | |       |   | | | | |   |     |   |       | | |     | | |   | |       |   | |
+-+-+-+-+-+ + + + +-+-+ +-+-+-+-+-+-+ + + + +-+ + +-+ +-+ + +-+-+ + + +-+-+ + + + + + +-+-+-+ + +-+ +
|       | | |   | |     |             | | | |   |   |   | |     | |       | | |   |   |     | |     |
+ + +-+ + + +-+-+ + + +-+ +-+-+ +-+-+-+ + +-+ +-+-+-+-+ +-+-+ + +-+-+-+-+ + + +-+-+-+-+ +-+ + +-+-+ +
| | | | | |     | | | |       | |     |   |   |         |   | |       |   |   |       |   | |     | |
+ + + + + +-+-+ + +-+ + +-+-+-+ +-+ +-+-+ + +-+ + + +-+-+ + +-+-+ +-+ + +-+-+-+ +-+-+ +-+ + +-+-+ +-+
| | |   |     | |   | | |       |   |     |   | | | |     |     |   | |   |     |   |     |     |   |
+ + +-+ +-+ + + +-+ + + + +-+-+-+ +-+ +-+-+-+ +-+ +-+ +-+-+-+-+ +-+ + +-+ +-+ +-+ + +-+-+-+-+-+ +-+ +
| |   |   | | | |   |   | |   |       |       |   |   |       | |   |   |     |   |     |     |     |
+-+-+ +-+ + +-+ + +-+-+-+ + +-+ +-+-+-+ +-+-+-+ + + +-+ +-+-+ + +-+ + + +-+-+-+ +-+-+ +-+ + +-+-+-+ +
|     |     |   | |     | |     |     | |   |   | |   | |     |   | | | |     | |   | |   |     |   |
+ +-+-+-+-+-+ +-+ + +-+ + + +-+-+ +-+ + + + +-+ + +-+ + + +-+-+-+ +-+ + +-+-+ + + +-+ + +-+-+-+ + +-+
|     |   |   |   |   |   |   |     | |   |   | |   | | | |     | |   |       | |   | |       |   | |
+ +-+ + + + +-+-+ + + +-+-+-+ + +-+ + +-+-+-+ + +-+ + + + +-+ +-+ + +-+-+ +-+-+ + + + +-+-+-+ +-+-+ +
|   |   |   |     | |   | |   | |   | |     | |   | |   | |   |   | |     |     | | |       |     | |
+-+ +-+-+-+-+ +-+-+-+-+ + + +-+-+ +-+ +-+ +-+ + + + +-+-+ + + + +-+ +-+-+ + +-+-+-+ +-+-+-+ +-+-+ + +
| |   |       |         |   |     |   |   |   | | | |   |   | |   |     | |     |   | |   |     | | |
+ +-+ +-+-+ +-+-+ +-+-+-+ +-+-+ +-+ +-+ + + +-+ + +-+ + +-+-+ +-+ +-+-+ +-+-+-+ + + + + + + +-+ + + +
|   |     |   |   |   |         |   |   | |   | |     | |   | |   |   |       | | | | | |   |   | | |
+ + +-+-+ +-+ + +-+ + +-+-+-+-+-+ +-+ +-+-+-+ + +-+-+-+ + + + + +-+ + + + +-+ + + + + + +-+-+ +-+ + +
| | |   |     |     |           | |     |     |   |   | | |   | |   | | | |   |   |   |   | |   | | |
+ +-+ + +-+-+-+-+-+-+-+-+-+ +-+ + +-+-+ + +-+-+-+ +-+ + + +-+-+ + +-+ +-+ + +-+-+-+-+ +-+ + +-+ + + +
| |   | |                 |   | | |     |   | |       |   |   | | |       |   |     |   | |   | |   |
+ + +-+ + +-+ +-+-+-+-+-+ +-+ + + + +-+ +-+ + + +-+-+-+-+-+ + + + +-+-+-+-+-+ +-+ +-+-+ + +-+ + +-+ +
| | | |     |   |       |   | | | | |   |   |   | |       | | | | |     |         |     |   |   |   |
+ + + +-+-+-+-+ +-+ +-+-+-+ +-+ + + +-+-+ +-+ +-+ + +-+-+ + + + + + +-+ +-+-+-+-+ + +-+-+-+ +-+-+ +-+
| |     | |     |   |       |   |   |   | |   |   |   | |   |   | |   | |   | |   |   | |   |     | |
+ +-+-+ + + +-+-+ +-+ +-+-+-+ +-+ +-+ + + + +-+ + +-+ + +-+-+-+-+ +-+ + + + + + +-+-+ + + +-+ +-+-+ +
| |   |   | | |     |   |     |   |   |   |     | |   |   |     |     |   | |       | | |   |     | |
+ + + +-+ + + + +-+ +-+ +-+ +-+ +-+ +-+-+-+-+-+ +-+ +-+ +-+ + +-+ +-+-+-+-+ +-+-+-+-+ + +-+ +-+-+ + +
|   |     | | |   |         |   |   |         | |   | |     |         |   |     |     |   |     | | |
+-+-+-+-+ + + +-+ +-+-+-+-+-+-+-+ +-+ +-+ +-+ + + +-+ + +-+-+ +-+-+-+-+ + + +-+ + +-+-+-+ +-+-+ + + +
|       | | |   |     |           |     |   | | |   |   |   | |     |   | |   | |         |   |   | |
+ +-+-+ +-+ +-+ +-+ +-+ +-+-+-+-+-+-+-+-+-+ + +-+-+ +-+-+ + + + +-+ + +-+ +-+ + +-+-+-+-+ + + +-+-+ +
| |   |     |   |   |   |     |       |     | |     |     | | |   |   | |   | |         | | |   |   |
+ + +-+-+-+-+ +-+ +-+ +-+ + +-+ + +-+ + +-+-+ + + +-+ +-+-+ + +-+ +-+-+ +-+ +-+-+-+ + +-+ + + + +-+ +
| |     |     |     | |   |     | |     | |   | | |   |     | |   |       |       | |     | | |   | |
+ +-+ +-+ +-+ + +-+-+ + +-+-+-+ + +-+-+-+ + +-+ +-+ +-+ +-+-+-+ +-+ +-+ +-+-+-+ + + +-+-+-+-+ +-+ + +
|   | |   | |   |     | |     | |   |     | | |     | |   |   |     |   |     | | |           | | | |
+-+ + + +-+ +-+-+ +-+-+ + +-+ +-+-+ + +-+ + + + +-+-+ +-+ + + +-+-+-+ +-+ +-+ + + +-+-+-+-+-+-+ + + +
|   |       |     |     |   |       |   |   |   |       |   |         |   |   | | | |           | | |
+ +-+-+-+-+ + +-+-+ +-+-+-+ +-+-+-+-+-+ +-+-+ +-+ +-+-+ +-+-+-+-+-+ +-+ +-+ +-+-+ + + + +-+-+-+ + + +
| |   |   | |   |   |     | |     |     |   | |       |       |   | |   | | |     |   |   |   | | | |
+ + + + + +-+-+ + +-+ + +-+ + +-+ + +-+-+ +-+ + +-+-+ +-+-+ +-+ + +-+ +-+ + +-+ +-+-+ +-+ + +-+ + + +
| | |   |   |   |   | | |   | | | |   |       | |   |     | |   |   | |   |   |     | |   |     |   |
+ + +-+-+-+ + +-+-+ + +-+ +-+ + + +-+ +-+-+ +-+ + + +-+ + +-+ +-+-+ + + + +-+ +-+-+ + + +-+-+-+-+-+ +
| | | |     | |     | |   | |   |   |     | | | | |   | |   |     |   | | | |       | |   |     |   |
+ + + + + +-+ + +-+-+ + +-+ +-+ + +-+-+-+ + + + + +-+ +-+-+ +-+-+ +-+-+ + + +-+-+-+-+-+-+ + +-+ + +-+
| | | | | |   | |     | | |     |       | | |   |   | |     |     |     | |       |       | |   |   |
+ + + + +-+ +-+ + +-+ + + + +-+-+-+-+ +-+ + +-+ +-+ + + +-+-+ + +-+-+ +-+ +-+-+ + +-+ +-+-+ + +-+-+ +
|   | |     |     |   | |   |   |   | |   |   | |   |   |   | | |   |   | |   | | |   |     |   |   |
+ +-+ +-+-+-+ +-+-+-+-+ + +-+ + + + + + +-+-+ + + +-+-+ + + + + + + +-+ + + + + + + + + +-+-+-+ + +-+
| |   |     | |         |   | | | | | | |     | | |   | | |   | | | |   | | |   |   | | |     | | | |
+ + + + + + + + + +-+-+-+-+ + + + +-+ + + +-+-+-+ +-+ + + +-+ +-+ + + +-+ + +-+-+-+-+-+ +-+ +-+ + + +
|   | | | | | | | |   | |   | |   |   | |       |   |   | |   |   | | | | | |         | |   |   | | |
+-+-+ + + + +-+ + + + + + +-+ +-+-+ +-+ +-+-+-+ +-+ +-+-+ +-+-+ +-+ + + + + + +-+-+-+ + + + + +-+ + +
|     | | |     | | | | | |   |     |   |     | |   |   |         | | |     | |   |   |   | | |   | |
+ +-+-+-+ +-+-+-+ + + + + + + + + +-+ +-+ +-+ + + +-+ + + +-+-+-+-+ + +-+-+-+ + +-+ + +-+-+ + + +-+ +
| |       |       | | |   | | | | |   | |   | | |   | | | |       | |   |   |   |   | |     |   |   |
+ +-+ +-+-+-+-+-+ + + + +-+-+ + + + +-+ + + +-+ +-+ + + + + +-+-+ + + + + + + +-+ +-+ + +-+-+-+-+-+ +
|   |     |     | | | |       | | |   | | | |       | | | | |   | | | | | | | |   | | |   |   |     |
+-+ +-+ + + +-+ +-+ + +-+-+-+ + +-+-+ + + + + +-+-+-+ + +-+ + +-+ + + + + + + + +-+ + +-+ + + + + +-+
| |   | |   |   |   | | |   | |       | | |   |     | |     |   | | | | | |   | |   |   |   | | |   |
+ +-+ +-+-+ + +-+ +-+ + + + + +-+-+-+-+ + +-+-+ +-+ + +-+-+-+ + + + +-+ + +-+-+ + + + +-+-+-+ +-+-+ +
|   |     | |   | |   | | |   |           |   | |     |       |   |   | | |   | | |   |     |     | |
+ + +-+-+ +-+ + + + +-+ + +-+-+-+-+ +-+-+-+ + + +-+-+-+ +-+-+-+-+-+ + + + +-+ + + +-+-+ +-+ +-+-+ + +
| |     |   | |   |   | | |       |   |     | |   |   | |     |   | | |   |   | | |     |       | | |
+ +-+ + +-+ +-+-+-+-+ + + + +-+-+ +-+-+ +-+-+ +-+ + +-+ +-+ + + + + + + +-+ + + + + +-+-+ +-+-+-+ + +
| | | |   |     |     | |   |   |     | |   |   | |   |   | | | |   | | |   | | | | |   |   |   |   |
+ + + +-+-+-+-+ + +-+-+ +-+-+ +-+-+-+ + + +-+-+ + + + +-+ + + +-+-+-+ + +-+ + + +-+ +-+ +-+ + + +-+ +
|   |             |                     |         | |       |         |     | |           |   |     |
+-+-+-+-+-+-+-+-+-+-+-+-+-+-+-+-+-+-+-+-+-+-+-+-+-+-+-+-+-+-+-+-+-+-+-+-+-+-+-+-+-+-+-+-+-+-+-+-+-+-+