+-+-+-+-+-+
|         |
+-+ + + + +
|   | | | |
+ + + + + +
| | | | | |
+ + + + + +
| | | | | |
+ +-+-+-+ +
| |       |
+-+-+-+-+-+