+-+-+-+-+-+-+-+-+-+-+-+-+-+-+-+-+-+-+-+-+-+-+-+-+-+-+-+-+-+-+-+-+-+-+-+-+-+-+-+-+-+-+-+
|                                                                                     |
+-+ + +-+ + + + +-+ + + + + + +-+ +-+ + +-+ + +-+-+ +-+ + + +-+-+ + +-+-+-+-+-+ + + + +
|   |   | | | |   | | | | | |   |   | | |   |     |   | | | |     | |           | | | |
+ + + + + + +-+ + + + + + + + + + +-+ +-+ +-+-+ + +-+ + + +-+-+ +-+ +-+-+ + + + + + + +
| | | | | | |   | | | | | | | | | |   |   |     | |   | | |     |     |   | | | | | | |
+ + + + + +-+ + + +-+ + +-+ + + + + + + +-+ +-+ +-+ + +-+ + +-+ +-+ + + + + + + + + + +
| | | | |   | | | |   | |   | | | | | |   | |     | | |   | |   |   | | | | | | | | | |
+ +-+ + + + +-+-+-+ +-+ +-+ + + + + + + +-+ +-+ + + + + + + + + + + + + +-+ +-+ + +-+ +
| |   | | |     |   |     | | | | | | |   | |   | | | | | | | | | | | |   |   | |   | |
+ + + + +-+ + + +-+ +-+-+-+ +-+ + + +-+ +-+-+ + + +-+-+ + + + + +-+-+ + + + +-+-+-+ + +
| | | |   | | | |   |       |   | |   | |     | |     | | | | | |     | | |     |   | |
+ + + + + +-+ + + + + +-+ + +-+ + + + +-+ +-+ + + +-+ +-+ + +-+-+-+ +-+ + + + + + + + +
| | | | | |   | | | | |   |   | | | |   | |   | |   |   | |   |     |   | | | | | | | |
+ +-+ + + + + + + +-+ +-+-+ + +-+ + + +-+-+ +-+ +-+ + + + + +-+ + + + +-+-+-+ + + + + +
|   | | | | | | |   |   |   | |   | |     |   |   | | | | |   | | | |       | | | | | |
+ +-+ +-+-+ + + + +-+ +-+ +-+-+ + + + +-+ + +-+ +-+ +-+ +-+ + + +-+-+ + + + + +-+ +-+ +
|   |     | | | |   | |       | | | | |   |   | |   |     | | |     | | | | | |     | |
+ +-+ +-+-+-+ + +-+ +-+ +-+-+-+ +-+-+ +-+ +-+-+ +-+-+ +-+ + + + +-+-+ + +-+-+-+ + + +-+
|   |   |     |   |   |   |         |   |     | |       | | | |   |   |     |   | |   |
+ + + +-+ +-+ + + + +-+-+-+ + + + +-+-+ + + +-+ + + + + +-+-+ + +-+-+ + +-+ +-+-+ +-+ +
| | |   | |   | | | |       | | |     | | |   | | | | |     | |     | |   |     |   | |
+ +-+ + + + + +-+ + + + + + + + +-+ +-+ + + +-+ + + +-+ +-+ + + + +-+ + +-+ + + + +-+ +
|   | | | | | |   | | | | | | |   | |   | | |   | | |   |   | | |   | |   | | | | |   |
+ + + + + + + + +-+ + +-+ +-+ +-+ + + +-+ +-+ + +-+ + +-+ +-+ + + + + +-+ + + + + + + +
| | | | | | | |   | | |   |     | | |   | |   |   | | |     | | | | | |   | | | | | | |
+-+ +-+ + + + + + + + + + +-+ +-+ + +-+ +-+ +-+ + + + + +-+ +-+ + +-+ + + + + + + + +-+
|   |   | | | | | | | | | |     | | |     |   | | | | | |     | | |   | | | | | | |   |
+ + + +-+-+ + + + +-+ +-+ + + + +-+-+ +-+ + +-+-+ +-+ +-+ + +-+-+-+-+ +-+-+ + + + +-+-+
| | | |     | | | |     | | | | |     |   |   |   |     | |     |       |   | | |     |
+ + + + + +-+ + + + +-+ + + + + + +-+ + + + + +-+ +-+ + + +-+ + + + +-+-+ + + + +-+-+-+
| | | | |   | | | | |   | | | | | |   | | | | |     | | | |   | | | |     | | |       |
+-+ +-+ + +-+-+-+-+ +-+ + + + + + +-+ + +-+-+ + + + + +-+ + + + + + + +-+-+-+ +-+-+ + +
|   |   |   |         | | | | | |   | |     | | | | | |   | | | | | |       | |     | |
+ +-+ +-+-+ + +-+-+-+ + + +-+-+ + + +-+ + + + + + + + + + + + +-+ + + + + +-+-+ +-+ +-+
| |       | | |       | | |     | |   | | | | | | | | | | | |   | | | | |     | |     |
+ + + + + + + + + + +-+-+-+-+ +-+ + + + + + + + + + +-+-+ + + + + +-+ + + +-+-+ + + + +
| | | | | | | | | |       |     | | | | | | | | | |   |   | | | |   | | |     | | | | |
+-+-+-+ + + + +-+ + +-+-+-+ + + +-+ + + +-+-+-+-+-+ + +-+-+ + + +-+ +-+ + + +-+ +-+ + +
|       | | | |   |     |   | | |   | |   |         | |     | |   | |   | |   | |   | |
+ +-+ +-+ + +-+-+ +-+ + + + + + +-+ +-+ + + +-+ +-+-+-+ +-+ +-+-+-+-+-+ +-+ + + + +-+ +
| |     | |   |     | | | | | | |   |   | | |       |   |             | |   | | | |   |
+ + + +-+-+ +-+ + + +-+ + + + + + + + +-+ + + +-+-+-+ + +-+ +-+ + + +-+-+ + +-+ + + + +
| | |     |   | | |   | | | | | | | |   | | | |       | |   |   | | |     | |   | | | |
+ + +-+-+-+ +-+ + + +-+ +-+ +-+-+-+-+ +-+ + + + + + + + +-+-+ +-+ +-+-+ + + + + +-+ +-+
| |     |     | | | |   |       |     |   | | | | | | | |     |       | | | | | |     |
+ + + +-+ + + + + + +-+ + + + + + +-+ + + + + +-+-+-+ + + +-+ + +-+ + + + + +-+ + +-+ +
| | | |   | | | | | |   | | | | | |   | | | |       | | | |   |   | | | | | |   |   | |
+-+ +-+ + + +-+ +-+ + + + +-+-+-+ + +-+-+ + + + + + + + +-+-+ +-+ + + + +-+ +-+-+ + + +
|     | | | |   |   | | |     |   |   |   | | | | | | |   |     | | | |   |     | | | |
+-+ +-+ +-+ + + +-+ + + + +-+ +-+-+-+-+ + + + +-+-+-+-+ +-+ + +-+ +-+ + +-+ +-+ +-+ +-+
|     |   | | | |   | | |   |         | | | | |         |   |   | |   |   | |     |   |
+ + + +-+ + + +-+ + +-+-+ + + +-+-+-+ +-+ +-+ + +-+ + + + +-+-+ + +-+ + + + + +-+ + + +
| | |   | | |   | |   |   | |     |     | |   | |   | | |   |   |   | | | | |   | | | |
+ + +-+ + + +-+ + + + + + +-+ +-+ + + +-+ + + +-+ + +-+ + +-+-+ + + +-+ +-+-+ +-+ +-+ +
| | |   | |   | | | | | | |     | | |   | | | |   | |   |     | | | |       |   |   | |
+ + + + +-+ + + +-+ + +-+ + + +-+ +-+ + + + +-+ +-+ +-+ +-+ +-+ + +-+ + +-+ +-+ + + + +
| | | |   | | |   | |   | | |   |   | | | |   | |   |     |   | | |   | |   |   | | | |
+-+-+ +-+ + +-+-+-+ + + + +-+-+-+ + + + + +-+-+ + + +-+ + + + + + + + + + + +-+ +-+ + +
|       | | |       | | | |       | | | | |     | | |   | | | | | | | | | | |   |   | |
+ + + + + +-+ + + +-+ + +-+ +-+ + + + + +-+ +-+ + +-+-+ + + +-+-+ + + + +-+ +-+ + + + +
| | | | | |   | |   | |   |   | | | | | |   |   |   |   | | |     | | | |     | | | | |
+ + + + +-+ + + + + + +-+ +-+-+ + + + + +-+ + + +-+-+ + + + +-+-+ + + + +-+ + +-+ + + +
| | | |   | | | | | | |   |     | | | |   | | |     | | | |     | | | |   | | |   | | |
+ + +-+-+ +-+-+-+ +-+ + +-+-+ + + + +-+ +-+ + + + +-+-+ + + + +-+ +-+ + + + +-+ + +-+ +
| | |         |     | |   |   | | | |   |   | | |   |   | | |   | |   | | |   | |   | |
+ +-+ + + + + + + + + + + + + +-+ +-+-+ + + + +-+-+-+-+ + + +-+-+ + +-+ + + + + +-+ + +
|   | | | | | | | | | | | | |   |   |   | | |         | | |   |   | |   | | | | |   | |
+ + + + + + +-+-+-+ + + + + + + + + + + + + +-+ + + + + + + + + + + + + + + + +-+ + + +
| | | | | |   |     | | | | | | | | | | | |   | | | | | | | | | | | | | | | | |   | | |
+ + + + +-+-+ + + + +-+-+-+ + + + + +-+ + +-+ +-+ + + + + +-+ + + + +-+ + + + +-+ +-+ +
| | | |     | | | |   |     | | | | |   | |     | | | | | |   | | |   | | | | |     | |
+ + + + + + + + + +-+ + + + + +-+ +-+ + +-+ +-+ + + + +-+ + + + + + +-+ + + + +-+ + + +
| | | | | | | | |   | | | | |   | |   | |   |   | | |   | | | | | |   | | | | |   | | |
+ +-+ + + + +-+ + + + +-+-+-+ + + +-+-+-+ +-+-+ + +-+ + + +-+-+-+-+-+-+ +-+ + + +-+-+ +
|   | | | |   | | | |   |     | |     |       | |   | | |     |           | | | |     |
+ +-+ + +-+ + + + +-+-+ +-+ + +-+-+ +-+ + + + + + +-+ +-+-+ + + + + + + + + + + + + + +
|   | |   | | | |   |   |   |     | |   | | | | |   | |     | | | | | | | | | | | | | |
+ + +-+ + + + + + +-+-+-+-+-+ + +-+ + + + + + +-+ + + +-+ +-+ + + + +-+ +-+ + + + + + +
| | |   | | | | |     |       | |   | | | | | |   | | |   |   | | |   | |   | | | | | |
+ +-+-+ +-+-+ +-+ +-+ + +-+ + + + + + +-+ + + +-+-+ +-+-+ + +-+ + + +-+ +-+ + + +-+ + +
|     | |     |     | | |   | | | | |   | | |     | |     |   | | | |     | | | |   | |
+ +-+-+-+ + +-+ + +-+ + + + + + + +-+ + +-+-+-+-+ + + + +-+ + + + + + + + +-+-+-+ + + +
|     |   |   | | |   | | | | | | |   | |         | | | |   | | | | | | | |       | | |
+ + + + + +-+ + + + +-+ + + + +-+ + +-+ + + + + + + + + + + + + + + + +-+ +-+-+ + +-+ +
| | | | |   | | | |   | | | | |   | |   | | | | | | | | | | | | | | | |       | | |   |
+-+-+-+-+-+-+-+-+-+-+-+-+-+-+-+-+-+-+-+-+-+-+-+-+-+-+-+-+-+-+-+-+-+-+-+-+-+-+-+-+-+-+-+