+-+-+-+-+-+-+-+
|             |
+ + + + + + + +
| | | | | | | |
+-+-+ +-+-+ + +
|         | | |
+-+-+ + + + + +
|     | | | | |
+ + + +-+ +-+ +
| | | |   |   |
+ + + + + +-+ +
| | | | |   | |
+ + +-+ +-+-+ +
| |   |   |   |
+-+-+-+-+-+-+-+