+-+-+-+-+-+-+-+-+-+-+-+-+-+-+-+-+-+-+-+-+-+-+-+-+-+-+-+-+-+-+-+-+-+-+-+-+-+-+-+-+-+-+-+-+-+-+
|     |   |       |         |       | | |   |     |     |   |     |     | | | |   | |   | | |
+ +-+ + +-+ + +-+-+-+-+ +-+ +-+-+ + + + +-+ + +-+-+-+ +-+ +-+ + +-+ + +-+ + + +-+ + + + + + +
| |       | |   |     |   | |     |         | |   |       |   | |   |         | |   | |     |
+-+-+-+ +-+-+ + + +-+-+ +-+-+ + + +-+-+-+ +-+ +-+ + +-+ + + + + +-+ + +-+-+-+-+ + + +-+ + +-+
|       |     | | |     | |   | | |     | |     |   |   |   | | | | |     | |     |   | |   |
+-+-+-+ + +-+-+ + + +-+ + + +-+-+ +-+ +-+ +-+ + + +-+-+-+ +-+-+ + + + +-+-+ +-+-+-+ + +-+-+ +
|             | | | |       |   | |     |   | |   | | |   |     |   | |   |     | | | |   | |
+-+ + +-+ +-+-+ + +-+ + +-+-+ +-+ + +-+-+ +-+-+-+ + + +-+-+-+ + +-+ +-+ + + + + + + + +-+ + +
|   | | | | |   | |   |   |   | | | | | | |   |     |   | |   |     | | |   | | | | | | |   |
+-+ + + +-+ + + + +-+ +-+-+ +-+ + + + + + +-+ +-+ +-+ +-+ +-+ +-+ + + + +-+-+ +-+ +-+ + + +-+
| | |     |   |   |           |         |       | |         |   | | |   |         |         |
+ +-+ + + +-+-+-+ + + +-+-+ +-+ +-+ +-+-+-+-+-+ +-+-+-+-+ + + +-+ +-+ +-+ +-+ +-+ +-+ + +-+-+
|   | | | |         |     | |     | |   |         |     | |     | |   |   |   |   |   | |   |
+ +-+ +-+-+-+ +-+-+-+-+-+-+ +-+-+ +-+-+ +-+ +-+ +-+-+ +-+ +-+ + + +-+-+ + + +-+-+ + + + + +-+
|       |   |         |     | | | | |       |   | |   |     | | | |     | |   | |   | | |   |
+ + +-+ + +-+-+ +-+-+-+-+-+-+ + +-+ + + +-+-+ + + + +-+-+-+ + +-+ + +-+-+ + +-+ +-+-+-+ + + +
| | |     | |   |     | |     | | | | |   | | | |     | |   |   | |   |   |   | |   | | | | |
+ + +-+ +-+ + +-+ +-+ + + +-+-+ + + + + + + +-+-+ + +-+ + + + +-+-+-+-+-+-+-+ + + +-+ +-+-+ +
| |   |   | | | |   |   | |           | |     |   |     | | | |         | | |     |     |   |
+-+ +-+-+ + + + + +-+ +-+ +-+ + +-+ +-+-+-+-+-+-+ +-+-+ +-+-+ + +-+ +-+-+ + + +-+-+-+ +-+-+ +
|   | | | |       | |   |     | |   | |     |   | |   |     |     | |   |       | |   | | | |
+ +-+ + +-+ + + +-+ +-+-+-+-+ +-+-+ + + +-+ +-+ +-+ +-+-+ + + + +-+-+ + +-+-+ + + + + + + + +
| |   |     | | |   | | |         |       | |         | | |   |   |   | | | | |     |       |
+-+-+ + + +-+-+ + +-+ + +-+-+-+ +-+-+-+ + +-+-+-+ +-+-+ + +-+-+-+ + + +-+ + +-+-+ +-+-+-+-+-+
|     | |   |   |     |     |       |   |     |             |       | |       |       |     |
+ +-+ +-+-+ +-+ +-+-+ + + + + +-+ +-+-+ +-+-+ +-+ +-+-+ +-+ + +-+-+-+-+-+-+-+ +-+-+ +-+ +-+ +
|   | | | | |   |       | |   |       | |     | |   |   |   | | |   | | |     |   |   | | | |
+ +-+ + + + + + +-+ +-+-+-+-+-+ +-+-+ + +-+-+ + + + +-+ +-+-+-+ + +-+ + + +-+ +-+ + + + + + +
|   |     | | | |           |     | | | | |   |   | | |           |     |   |     | |     | |
+-+ +-+-+ + + +-+ +-+-+ +-+-+-+ +-+ + +-+ +-+ +-+-+ + +-+-+ +-+ +-+ + +-+-+-+-+ +-+ + +-+-+-+
|     |   | |   | |     | |     |     |   |   | |       | | | |     | | | |       | |   | | |
+-+ +-+ +-+ +-+-+-+ +-+-+ +-+-+-+ + +-+-+ + +-+ +-+-+ + + +-+ + +-+ +-+ + +-+ +-+ +-+ +-+ + +
|     |           | |       | |   |     |             |     |     |   | | |     | |   |   | |
+ +-+-+ +-+-+ + +-+ +-+ +-+ + + +-+ +-+-+ +-+-+ +-+ + +-+-+-+-+-+ +-+ + + +-+ +-+-+-+ +-+ + +
|   |       | | | | | |   | |   |   | |   |   | | | | |   |     | | |           |           |
+-+ + +-+ +-+ +-+ +-+ + + +-+ + + +-+ +-+ +-+ + + +-+-+ + + +-+-+ + +-+-+-+-+ +-+-+ +-+ +-+ +
| | |   | |   | | |     | | | | |   |     |   | |     | |         | |                 | |   |
+ + +-+-+ +-+-+ + +-+ +-+-+ + +-+-+-+-+ + + +-+-+ +-+ + +-+ + +-+ + +-+ + + + +-+-+-+ +-+-+ +
|   | |   |   |     | | |         |   | |   | | |   | | |   | | |     | | | |       |   | | |
+ +-+ + +-+ +-+ +-+-+ + +-+-+ +-+ + + +-+ +-+ + + +-+-+-+-+ +-+ +-+-+-+ +-+ +-+-+ +-+ +-+ +-+
|   |     |     |     | |       | | |   | |   |     |   | |         |     |   |     |   |   |
+ + + +-+-+ + +-+ +-+ + +-+-+ + +-+ + +-+-+-+ + +-+-+ + + +-+-+ + +-+-+ + +-+ +-+ +-+-+ +-+ +
| | |     | |       |   |     |   | |   |         | | |   |     |   |   | | | | |   | | | | |
+-+-+ +-+-+ +-+-+-+-+ +-+-+-+ + + + + +-+-+ + + +-+ +-+-+ + +-+ +-+ +-+-+ + +-+ + +-+ + + + +
|   | | |   |           |   | | |   | |   | | |   | | |   | |     | | | |   |     | |       |
+-+ + + + +-+-+-+-+-+ +-+ +-+-+ +-+ +-+ +-+-+-+ + + + + + +-+ +-+-+-+ + +-+-+ +-+-+ + +-+ +-+
|       | |                     | |   | | |   | |     | |   |   | |     |       |   | | | | |
+-+-+-+-+ +-+ +-+-+ +-+-+-+-+ +-+ + +-+ + + + + + + + +-+ + + +-+ + +-+ +-+-+-+-+-+ + + + + +
|           | | |   |   |     | | |     | | |   | | | |   |     |     | | | |           |   |
+ + +-+ + + +-+ +-+-+ +-+-+-+ + + +-+-+ + + + +-+ +-+-+-+-+ + + +-+ +-+-+ + + +-+-+ +-+-+ +-+
| |   | | |     |         | |       | | |   | |     | |   | | |       | | | |   | |     |   |
+ +-+-+-+-+-+-+ +-+-+ + + + +-+-+ +-+ +-+-+-+ +-+ +-+ +-+ + +-+ + +-+ + + + +-+-+ +-+-+-+ + +
|         |       | | | |         | |           | | |       |   |   | |     |       |     | |
+-+-+-+-+-+-+-+-+ + + +-+-+ +-+ +-+ + +-+-+-+ +-+-+ +-+ +-+-+-+ + + + + + + + + +-+ +-+ +-+-+
|               | |     | | |       |     |   |   |   |     | | | | | | | |   |   |   |     |
+-+ +-+-+ + +-+-+-+-+-+ + + +-+-+-+ + +-+-+-+-+-+ + +-+ +-+-+ +-+ +-+-+-+ + +-+-+-+-+ + +-+ +
|       | | |   |     |   |   | |   | |       |   |     |   | |   |     | |   |   |     | | |
+-+ +-+-+ + + + + + +-+-+ + +-+ + + + +-+-+-+ + +-+-+-+-+ +-+ + + +-+ + +-+ + + + +-+ +-+ +-+
|   |     | | |   |       | |     | |         |     |           |     | |   |   |   |       |
+ +-+ +-+ +-+-+-+ + +-+-+ + +-+-+-+-+-+ +-+ + + + +-+-+-+-+ +-+ +-+-+ +-+-+ +-+-+-+-+ +-+-+-+
|   | | |   |   | |   | | | | |       | |   |   | |         |     |       |     |           |
+-+ +-+ +-+ + + +-+-+-+ + +-+ + +-+ +-+-+-+-+ +-+-+ +-+-+-+ +-+ +-+ + +-+-+ +-+ +-+ +-+ + +-+
|   | |   |   |     |     |       | |     |   |   | |     |   |   | |   |     |   | | | |   |
+ + + +-+ + +-+-+-+ + +-+ + + +-+-+ +-+ +-+ +-+ + + +-+-+ +-+ +-+ +-+ +-+-+ +-+ + + + + + + +
| | | |         | |   |   | | |         |     | |         |   |   | | |     |   | | |   | | |
+-+-+ + +-+-+-+-+ +-+ +-+-+-+ +-+ +-+ + +-+ +-+-+-+-+ +-+-+-+-+-+ + + +-+ +-+-+ + +-+-+-+-+-+
|       | | |       |     | |   | |   |     |   | |     | |   |     |   | |   | |   | |     |
+-+ + +-+ + +-+ +-+ + +-+-+ +-+ + +-+-+-+-+ + + + + + +-+ +-+ + +-+-+-+-+-+ +-+ + +-+ + +-+-+
|   | |           |       |     | |   |       | | | | | | |   | | |   |   |     |       | | |
+-+-+ + +-+ + +-+-+ +-+-+-+ +-+-+ + +-+ +-+-+-+ + + +-+ + + + +-+ + + + +-+-+ + +-+-+-+-+ + +
|     | | | |   |   |   | |   | |     | |       |     |     |     | |   |     | |     |     |
+ +-+-+ + +-+-+-+-+ + +-+ + +-+ +-+-+-+-+-+-+-+ +-+-+ +-+-+-+ + +-+ +-+ +-+ +-+ +-+-+ + +-+-+
| | |     |     |       |     |       |     | | |     | | | | |       |   |   |         |   |
+ + +-+-+-+-+ + + +-+ +-+-+-+-+ +-+-+ +-+-+ + + +-+ + + + + +-+-+ +-+ +-+ + +-+ +-+ +-+ +-+ +
|       |   | | | | |   |     | | | |   |         | |       | |   |   | | |   | | | |   | | |
+ + + +-+-+ +-+ +-+ + + +-+-+ + + + + +-+ + +-+ +-+-+-+ +-+-+ + +-+-+-+ + + +-+-+ + + +-+ + +
| | |   |     |   | | |   |     |   |   | | | |   |         | |       | |     |     |   |   |
+-+-+-+ + +-+-+-+ + + +-+-+-+-+-+ +-+ +-+-+ + +-+ +-+ +-+ + + + +-+-+-+ + +-+-+ +-+ +-+ + + +
|     | | | |   |   |   | | |         | |   | |     | |   | |   | |       |     |     | | | |
+ +-+ + + + + +-+-+ + + + + +-+ + +-+-+ +-+ + +-+-+ + +-+ +-+-+ + +-+-+ + +-+ + +-+ +-+ + +-+
| |       |         | |   | |   |   | |   |   | |     |   |     | |   | | |   |   | |   |   |
+-+-+ + + + +-+ + +-+ +-+ + + + + +-+ + +-+-+ + +-+ +-+-+-+-+-+ + + + + + +-+-+ + +-+-+ +-+ +
| |   | | |   | |     |   | | | |   | |     | |       |       |   | |   | |     | |   |     |
+ +-+ +-+-+ +-+ +-+ +-+ + + + + +-+ + +-+ +-+-+ +-+ + +-+ +-+-+-+ +-+ + +-+-+ +-+ +-+ +-+ +-+
|     |       |   |   | | | | | |     | |         | |     |     | | | |     |   | | |   | | |
+ +-+-+-+-+-+-+ + +-+ +-+ + + +-+ +-+ + + + +-+-+-+-+ +-+-+ +-+-+-+ +-+-+-+-+ +-+ + + +-+ + +
|     | | |     | |     | |     | | | |   |   | |   |   | |         |       |   | |       | |
+-+ + + + +-+ +-+-+-+-+ +-+-+ +-+ + +-+ +-+-+-+ +-+ +-+ + + + +-+-+ +-+-+ +-+-+ + +-+ +-+ + +
|   | |     | |   | |     |   |         |         |   | |   | | |   |           |   | |   | |
+-+ + + +-+-+ + + + + + + + +-+-+ + +-+ + + +-+-+ + +-+ + + +-+ + + +-+-+ +-+-+-+ + + +-+ + +
|   |       |   | |   | | |     | | |   | | |           | |     | |         |     | |   |   |
+-+-+-+-+-+-+-+-+-+-+-+-+-+-+-+-+-+-+-+-+-+-+-+-+-+-+-+-+-+-+-+-+-+-+-+-+-+-+-+-+-+-+-+-+-+-+