+-+-+-+-+-+-+-+-+-+-+
|                   |
+ +-+ +-+ +-+-+-+-+ +
|   |   |         | |
+ + + +-+-+-+-+ + +-+
| | |         | |   |
+ +-+ +-+ + +-+ + + +
|   |   | |   | | | |
+ + + + +-+-+ + + + +
| | | |     | | | | |
+ + + +-+ +-+ + + + +
| | |   |   | | | | |
+ + + +-+ + + +-+-+ +
| | |   | | |     | |
+ + + + +-+-+ +-+-+ +
| | | |     |     | |
+ +-+ +-+ +-+-+ + + +
|   |   |     | | | |
+ + +-+-+ + +-+-+ + +
| |     | |     | | |
+-+-+-+-+-+-+-+-+-+-+