+-+-+-+-+-+-+-+-+-+-+-+-+-+-+-+-+-+-+-+-+-+-+-+-+
|                                               |
+ +-+-+ + + + + + +-+-+-+-+ + + + + + + + + + + +
|     | | | | | | |         | | | | | | | | | | |
+ + + + + + + +-+ + + + + + + + +-+ + + + +-+ +-+
| | | | | | | |   | | | | | | |   | | | |   |   |
+ + + + + +-+ + +-+ + + + +-+ + + + + + + +-+-+ +
| | | | | |   |   | | | |   | | | | | | |   |   |
+ +-+ + + + + + + + +-+ +-+ +-+ + + + + + +-+ + +
|   | | | | | | | | |     |   | | | | | | |   | |
+ + + +-+-+ +-+-+ + + + + + + + +-+ + + + +-+ + +
| | |   |     |   | | | | | | | |   | | |   | | |
+ + +-+ + + +-+ + + +-+ + +-+ +-+ + +-+ + +-+-+ +
| | |   | | |   | | |   | |     | |   | | |     |
+ + + + +-+ +-+ + + + + +-+ + +-+ + + + + + + + +
| | | |   |   | | | | |   | |   | | | | | | | | |
+ + + +-+ +-+ + + + +-+ +-+-+-+-+ + + + +-+ + + +
| | | |   |   | | | |           | | | | |   | | |
+ + + + + +-+-+-+ +-+ + + +-+ + +-+ + + + + +-+ +
| | | | |     |     | | | |   | |   | | | |   | |
+ + +-+-+ + + + + + +-+-+-+ + + + + + + + +-+-+ +
| |   |   | | | | |   |     | | | | | | | |     |
+ +-+-+-+-+ +-+-+-+ + + +-+ + +-+-+ + +-+-+ + + +
|       |   |       | |   | |   |   |   |   | | |
+ + + +-+ +-+-+ + +-+ + + + + + + + + + + +-+-+ +
| | | |       | |   | | | | | | | | | | |   |   |
+ + + + + + +-+ + + +-+ + +-+ +-+ +-+ + + + + + +
| | | | | |   | | |   | |   | |   |   | | | | | |
+-+ + + +-+ +-+ +-+-+-+ +-+ + + + +-+ + +-+ + + +
|   | |   |   |   |     |   | | | |   | |   | | |
+-+ +-+ +-+ + + + + + + + + + + + + +-+ +-+ +-+-+
|   |   |   | | | | | | | | | | | | |     |     |
+ + + +-+-+-+ + + +-+-+-+ +-+-+ + +-+ + + +-+-+ +
| | |     |   | | |         |   |   | | | |     |
+ + + +-+ + + + +-+ +-+ + + +-+-+ + + +-+ +-+ + +
| | |   | | | |   |   | | |   |   | |   | |   | |
+ + +-+ + + + + + + + + + + + + + +-+-+ + + + + +
| |   | | | | | | | | | | | | | | |     | | | | |
+ +-+-+-+ +-+ + + + +-+-+-+ + +-+-+ +-+ + + +-+ +
|       | |   | | |     |   | |     |   | |   | |
+-+-+ + + +-+-+ +-+ +-+ + + + + + + +-+ +-+ +-+ +
|     | | |     |     | | | | | | |   | |     | |
+ +-+ + + +-+ + + + + +-+ + +-+ + +-+ + +-+ + + +
| |   | | |   | | | |   | | |   |   | | |   | | |
+ +-+ + + +-+-+ + +-+ + + + +-+ +-+-+ + +-+ + + +
|   | | |   |   |   | | | |   | |     | |   | | |
+ + + +-+ +-+ + + + +-+ + + + + + + +-+-+ +-+-+ +
| | | |     | | | |   | | | | | | | |         | |
+-+-+-+-+-+-+-+-+-+-+-+-+-+-+-+-+-+-+-+-+-+-+-+-+