+-+-+-+-+-+-+-+
|             |
+ +-+-+-+-+-+-+
| | | | | | | |
+-+-+-+-+-+-+-+
| | | | | | | |
+-+-+-+-+-+-+-+
| | | | | | | |
+-+-+-+-+-+-+-+
| | | | | | | |
+-+-+-+-+-+-+-+
| | | | | | | |
+-+-+-+-+-+-+-+
| | | | | | | |
+-+-+-+-+-+-+-+