+-+-+-+-+-+
|         |
+ +-+ + + +
| |   | | |
+-+ +-+-+ +
|   |     |
+ +-+ + + +
| |   | | |
+-+ + +-+ +
|   |   | |
+-+-+-+-+-+