+-+-+-+-+-+-+-+-+-+-+-+-+-+-+-+-+-+-+-+-+-+-+-+-+-+-+
|                                                   |
+ +-+ +-+ +-+ +-+ +-+-+-+-+ +-+-+-+ +-+ +-+-+ +-+ + +
|   |   |   |   |         |       |   |     |   | | |
+ +-+ + +-+ + + +-+ +-+-+-+-+ +-+-+-+-+-+-+-+ +-+ +-+
|   | |   | | |   |         |               |   |   |
+ +-+-+ + +-+ +-+-+-+-+-+-+ + +-+-+-+ +-+ + +-+-+ + +
|     | |   |             | |       |   | |     | | |
+ + + +-+-+-+-+-+-+ +-+-+-+-+ +-+-+ + +-+-+-+-+-+-+ +
| | |             |         |     | |             | |
+ + +-+ + +-+-+ + + +-+-+ +-+ + +-+-+-+ + +-+-+ +-+ +
| |   | |     | | |     |   | |       | |     |   | |
+ + + +-+-+-+ + + +-+ +-+-+ + +-+-+-+ + + + + + +-+ +
| | |       | | |   |     | |       | | | | | |   | |
+ + +-+-+-+-+ +-+-+-+ +-+ + +-+ + + + +-+-+ +-+-+-+ +
| |         |       |   | |   | | | |     |       | |
+ +-+ +-+ +-+ + +-+ +-+-+-+-+-+-+-+ +-+ +-+ + + + + +
|   |   |   | |   |               |   |   | | | | | |
+ + +-+-+ + + + + + +-+-+-+-+-+ +-+-+-+-+-+ + +-+-+ +
| |     | | | | | |           |           | |     | |
+ +-+-+-+ +-+ + + +-+ + +-+ + + + +-+ +-+-+-+ + + +-+
|       |   | | |   | |   | | | |   |       | | |   |
+ + +-+-+-+ + + + + +-+-+ + +-+ + +-+ +-+-+-+-+ +-+ +
| |       | | | | |     | |   | |   |         |   | |
+ + +-+-+-+ + + + + +-+ + +-+-+-+-+-+ + + + +-+ + + +
| |       | | | | |   | |           | | | |   | | | |
+ + +-+-+-+-+ +-+ + + +-+-+ +-+-+-+-+ +-+ + +-+-+ + +
| |         |   | | |     |         |   | |     | | |
+ + +-+ + + +-+-+ + +-+-+-+-+-+ + +-+-+ +-+ +-+-+-+-+
| |   | | |     | |           | |     |   |         |
+ + +-+-+-+-+-+-+ +-+-+-+-+ +-+ + + + +-+-+ +-+-+-+-+
| |             |         |   | | | |     |         |
+ +-+ + + +-+ +-+-+ +-+-+-+ + + + +-+-+ +-+ + +-+-+ +
|   | | |   |     |       | | | |     |   | |     | |
+ +-+-+-+-+-+-+-+-+-+-+ + + + + +-+ + +-+ + +-+ + +-+
|                     | | | | |   | |   | |   | |   |
+ +-+-+ + +-+-+ +-+ +-+-+-+ + + +-+-+-+ + + + + + + +
|     | |     |   |       | | |       | | | | | | | |
+ + +-+ + + +-+ +-+-+-+ +-+-+-+-+ +-+ +-+-+-+-+ +-+ +
| |   | | |   |       |         |   |         |   | |
+ + + +-+ +-+ +-+ + +-+ +-+-+-+ +-+ + +-+ + +-+ + + +
| | |   |   |   | |   |       |   | |   | |   | | | |
+ + + +-+ + + +-+-+ +-+ +-+-+ + + + + +-+-+-+ + +-+-+
| | |   | | |     |   |     | | | | |       | |     |
+ +-+ +-+-+-+ +-+ +-+-+ + +-+-+-+-+ +-+ + +-+ + + + +
|   |       |   |     | |         |   | |   | | | | |
+ + + + +-+ +-+ +-+ +-+-+-+-+ +-+-+-+ + +-+ + +-+ + +
| | | |   |   |   |         |       | |   | |   | | |
+ +-+ + + +-+-+ +-+-+-+ +-+-+ +-+-+ + + + + + + + +-+
|   | | |     |       |     |     | | | | | | | |   |
+ + +-+ + +-+-+ +-+ + + + + +-+-+-+-+ +-+ + +-+ +-+-+
| |   | |     |   | | | | |         |   | |   |     |
+-+-+-+-+-+-+-+-+-+-+-+-+-+-+-+-+-+-+-+-+-+-+-+-+-+-+