+-+-+-+-+-+-+-+-+-+-+-+-+-+-+-+-+-+-+-+-+-+-+-+-+-+-+-+-+-+-+-+-+-+-+-+-+-+-+-+-+-+-+-+-+-+-+-+-+-+-+
|           |     |   |                 |         |         |   | |       |   |       |     |     | |
+-+-+-+-+-+ + +-+ + + + +-+-+-+ +-+-+-+ + +-+-+ + +-+-+-+ + + + + + + +-+ + + + +-+-+ + +-+ + + + + +
|   |     | |   | | |     |   |       |   |     |         |   | |   | |   | |   |     |   |   | | | |
+ +-+ + +-+ +-+ + +-+-+-+ + + + +-+-+-+-+-+ + +-+-+ +-+-+-+-+-+ +-+-+ + +-+ +-+-+ +-+-+-+ +-+-+ + + +
|     | |   |   |       | | | | |         | | |   | |   |   |   |     | |     | | |     | |     | | |
+ +-+-+ + +-+ +-+-+-+-+ + + + +-+ +-+-+-+ + +-+ + +-+ + + +-+ +-+ +-+-+ +-+ + + + + + +-+ + +-+-+ + +
|   |   |     |       | | | |   |     | | | |   |     | |     |   |   |   | | |   | |     |   | |   |
+-+ + +-+-+-+-+ + +-+ + +-+ +-+ +-+-+ + + + + +-+-+-+-+ + +-+-+-+ + + +-+ +-+ + +-+-+-+-+-+-+ + +-+ +
| | |         | |   | |     | |   |   | | | | |   |   | | |     | | |   | |   | |             |     |
+ + +-+-+ +-+ +-+-+ +-+-+-+-+ +-+ + +-+ + + + + + + + + + + +-+ + + +-+ + + +-+ + +-+-+-+-+-+-+ +-+-+
| |   |   |         |           |   | |   |   | |   |   |   |   | |   |   |   |   | |       | | |   |
+ +-+ + +-+-+-+-+-+ + +-+-+-+ +-+-+-+ + +-+-+ + +-+-+-+-+-+-+ +-+ +-+-+ +-+-+ +-+-+ + +-+ + + + + + +
|   | |         |   | | |   |     |     |   | |     |             |   |     |     |     | |   | | | |
+-+ + +-+-+-+-+ +-+-+ + + + +-+-+ + +-+-+ + +-+-+ + + +-+-+-+-+-+ + + +-+-+ +-+-+ +-+-+-+ +-+-+ + + +
|   |   |     | |     |   |     | |       |     | | |   |   |     | |   |         |   |   |     | | |
+ +-+-+ + +-+ + + +-+-+ +-+-+-+ + +-+-+-+-+-+-+ + + +-+ + + +-+-+-+ +-+ +-+-+-+-+-+ + + + + +-+-+ + +
|     | |   | |   |     |       |           | | | | |   | | |       | |   |     |   |   | | |     | |
+-+-+ + +-+ +-+-+-+ +-+-+ +-+-+-+-+-+-+-+ + + + +-+ +-+-+ + + +-+-+-+ +-+ + + + + + +-+-+-+ + + +-+ +
|     |   |       | |   |   |     | |     |   |   |       | | |         | | | | | |   |     | | |   |
+ +-+-+-+ +-+ +-+ + + + +-+ + + + + + +-+-+-+ +-+ + +-+-+-+ + +-+ + +-+-+ + + +-+ +-+ + +-+-+-+ + +-+
| |       |   | | |   |   | | | |   |   |   |   | |     | | |   | | |   | | |     |   | |       |   |
+ + +-+-+-+ +-+ + +-+-+-+-+ + + +-+ +-+ + + +-+-+ +-+-+ + + +-+ + +-+ + + + +-+-+-+ +-+ +-+ +-+-+-+-+
| |         | |   |       |   | |     |   |     |     |   | |   |   | | | | |     | |   |   |       |
+ +-+-+-+-+-+ + +-+ +-+-+ +-+-+ +-+-+-+-+-+-+-+ +-+-+ +-+ + + +-+-+ + + + + + +-+ + + +-+ + + +-+-+ +
|     |   |     |       |     | |   |       |   |   | | | | |     | | |   | | | | | | |   | | | |   |
+ +-+ + + + +-+-+ +-+-+ +-+-+ + + + + +-+-+ + + + +-+ + + + +-+-+ + + +-+-+-+ + + + + + + +-+ + + + +
| |     | |   |       | |       | | | |       |   |   |   |         | |       |     | | | |   | | | |
+ +-+-+-+ +-+ +-+-+-+ + + +-+-+-+ + + + +-+-+-+-+ + +-+-+-+-+-+-+ +-+ + +-+-+-+ +-+-+ + +-+ +-+ + + +
|       |   |   |     | |     |   |   | |   |   | |         |   | |   | |     | |     |   | |   | | |
+ +-+-+ +-+-+-+ + +-+-+ +-+-+-+ +-+-+-+-+ + + + + +-+-+-+-+ + + +-+ +-+ + +-+ +-+ +-+-+ + + + +-+ + +
|     | |     | |   | |       |           |   | | |     |   | | |   |   | | |     | |   |     |   | |
+-+-+-+ + +-+ + +-+ + +-+-+-+ +-+-+-+-+-+-+-+-+ +-+ + +-+ +-+ + + +-+ + + + +-+-+-+ + +-+-+-+-+ +-+ +
|   |   |   |   | |   |     |   |   | |     |   |   |   |     |   |   | | |     | |   |         |   |
+ + + + +-+ +-+-+ +-+ +-+ + + + + + + + +-+ + + + +-+-+ +-+-+-+-+-+ +-+ + + +-+ + + +-+ +-+ +-+-+-+ +
| | | |   |     |     |   | | |   |   |   |   | |     |     |       | | | |   |   |   |   | |     | |
+ + + +-+-+-+-+ +-+-+ + +-+-+ +-+ +-+-+-+ +-+ +-+-+-+ +-+-+ + +-+-+ + + + + + +-+-+-+ +-+ + + +-+ + +
| | | |       |     | | |   | |   |       | | |     |   | | | |   | |   | | |         | | | |   | | |
+ + + + +-+ +-+-+-+ + + + + + +-+ + +-+-+-+ + + +-+ +-+ + + + + + + +-+-+ + +-+-+-+-+-+ + +-+-+ + +-+
| |   |   |       | | |   | |   | |   |       |   |     | |   | | |       | |     |     | |     |   |
+ +-+-+-+ +-+-+ +-+ + +-+-+ +-+ +-+-+ +-+-+-+-+-+ +-+-+-+ +-+-+ + +-+-+-+-+ + +-+ + +-+ + + +-+-+-+ +
| |       |   |   | |   |     |     |           |               |   |   |   |   |   |   |   | |     |
+ + +-+-+-+ +-+-+ + +-+ + +-+-+-+ +-+-+-+-+-+ + +-+-+-+-+-+-+-+-+-+ + +-+ +-+-+-+-+-+ +-+-+-+ + +-+ +
| |     |       | |   |   |     |       |     |         |     |   | |   |   |   |     |   |   | |   |
+ +-+-+ +-+-+ + + +-+ + +-+ +-+ + +-+-+ + +-+-+-+-+-+-+ + +-+-+ + + + + +-+ + + + +-+ + + + + + +-+ +
|   |   |     | |   | | |   | | | |     |   |         |   |     |   | |   | | | | |   | |   | |   | |
+ + + +-+ +-+-+ + +-+ + + +-+ + + + +-+ +-+ + +-+-+-+ +-+ + +-+-+-+-+ + +-+ + + + +-+-+ +-+-+ +-+ +-+
| | | |   | |   |   | | | | |   | | |   |   |     |   |   | |         |   | | | |           |   |   |
+ +-+ + +-+ + +-+-+ + +-+ + + +-+-+ + +-+ + +-+-+ + +-+ +-+ +-+-+-+-+-+-+ + + + + +-+-+-+-+ + +-+-+ +
|     | |       |   | |   | | |     |   | | |   | |   |   |       |   |   |   | |   |   |   |   |   |
+ +-+-+ + +-+-+-+ + + + +-+ + +-+ + +-+-+ + + + + +-+ +-+ +-+-+-+ + + + +-+-+-+ +-+-+ + + +-+-+ + +-+
| |     | |   |   | | |   | |   | | |   | | | | |   |   |   |   |   | |       |   |   | | | |   |   |
+ + + +-+-+ + + +-+-+ + + + +-+ + +-+ + + +-+ + +-+ +-+ +-+ + +-+-+-+ + +-+-+ +-+ + +-+ + + + + +-+ +
| | | |     |   |     | | |   |   |   | | |   |   | | |     |   |   | | |   |   | | |   |   | |   | |
+ + + + + +-+-+-+ +-+-+-+ + + +-+ + +-+ + + +-+-+ + + +-+-+-+ + + + + + +-+ + +-+ + +-+ +-+-+ +-+ + +
| | | | | |       |       | |   | |   | | | |     |   |     | |   | | |     |     |   |     | |   | |
+ + +-+ +-+ +-+-+-+-+ +-+-+-+ + + +-+ + + + + +-+-+-+ + + + + +-+-+ + +-+-+ +-+-+-+-+ +-+-+ + + +-+ +
| |   |   | |         |       | |   | |   | | |       | | | |     | |   |             |       | |   |
+ +-+ +-+ + + + +-+-+-+ +-+-+-+-+-+ + + +-+ + + +-+-+-+-+ + +-+-+-+ +-+ +-+-+-+-+-+-+-+ +-+-+-+-+ +-+
| |     | | | | |   |           |   | | |   | |           |     |     | |             |   |     |   |
+ + +-+-+ + +-+ + + +-+ +-+-+-+ + +-+ + + +-+ +-+ +-+-+-+-+-+-+ + +-+-+ + +-+-+-+-+-+ + +-+ +-+ +-+ +
|   |     |   |   |   |   |   |     | | | | | |   |         | |   |     |   |       | | |   | | |   |
+-+-+ +-+-+-+ + +-+-+ +-+-+ + +-+-+ + +-+ + + +-+-+ +-+-+-+ + +-+ + +-+-+-+ + +-+-+ + +-+ +-+ + + +-+
|   | |     | |   | |       |   |   |       |     | |   |   |   | |         | |   |   |   |     |   |
+ + + + + +-+ +-+ + +-+-+-+-+-+ + +-+-+-+-+-+-+-+ + + +-+ +-+-+ + +-+-+-+-+-+ + + +-+-+ +-+ +-+-+-+ +
| |   | |     |   | |     |     |     | |         | |   |   |   |   |   |   |   | |     | |   |     |
+ +-+-+ +-+-+-+-+ + + +-+ + +-+-+-+-+ + + +-+-+-+ + +-+ +-+ + +-+-+ + + +-+ +-+-+ + +-+-+ +-+ + +-+-+
|     |     |   |   |   |   |       |   |   | |   |   |   | |         |     |     | |       | | |   |
+ +-+ +-+-+ + + +-+ +-+ +-+ + +-+-+ +-+-+ + + + +-+-+ + +-+ +-+-+-+-+ +-+-+-+ +-+-+ +-+ + +-+ + + + +
|   | |   | | |   |   | | | | |         | | | |   |   |   | |       | |   |   |   |   | |     |   | |
+-+-+ + + + + +-+ +-+ + + + + +-+-+-+-+ +-+ + + +-+ +-+-+ + + +-+-+ +-+ + + +-+ + + + + +-+-+-+-+-+ +
|     | | |   | |   | | |   |       |       |   |   |     | |   | |     | |   | |   | |   |         |
+ +-+ + + +-+-+ +-+ + + +-+-+-+-+-+ +-+-+-+-+ +-+ +-+-+ + + +-+ + +-+-+-+ +-+ +-+-+-+ +-+ + +-+-+-+-+
| |   | |         | | |         | |   |       |   |     | |   |     |   |   |     |   | | |         |
+ +-+-+ +-+-+ +-+ + +-+-+-+-+ + + +-+ +-+-+ +-+ +-+-+ +-+-+-+ +-+-+ + +-+ + +-+-+ + +-+ + +-+-+-+-+ +
| |         | |   |   |       | |   | |   |   |   |   |     |   | | | |   |   | |   |   |       |   |
+ + +-+-+-+ + +-+-+-+ + +-+-+-+ +-+ + + + + +-+-+ + +-+ + +-+ + + + + + +-+-+ + +-+-+ +-+-+-+-+ + +-+
|   |   |   |   |   | |   |     |   | | | | |     |     | |   |   | | | |   |         |   |     |   |
+-+-+ + +-+-+ + + + + + + +-+-+ + + + + + +-+ +-+-+-+-+-+ + +-+-+-+ + + +-+ +-+-+-+ +-+ + + +-+-+-+ +
|     |     | |   | | | |     |   | |   |   | |           |     |     | |     |     |   |   | |     |
+ +-+-+-+-+ +-+-+-+ + + +-+-+ +-+-+ +-+-+-+ + +-+-+ +-+-+ +-+-+ + +-+-+ + +-+-+ +-+-+ +-+-+-+ + + + +
| |       |         | |   |   | |   |     | |     | |         |   | |   | |     |     |   |     | | |
+ + +-+-+ +-+ +-+-+ + +-+ + +-+ + +-+-+ +-+ +-+-+ + +-+-+-+-+ +-+-+ + +-+ + +-+-+ +-+-+ +-+ +-+-+ + +
| |   |   |   |   | | |   | |   |       |     |   |     |   | |     | |       |   |             | | |
+ +-+ + +-+-+-+ + +-+ + +-+ + + +-+-+-+ + +-+-+ +-+ +-+ + +-+ +-+ +-+ +-+-+-+ + +-+-+ +-+-+-+-+-+ + +
|   | |   |     | |   |   | | |   |     |   |   |     | |       |   |   |   | |     | |           | |
+ +-+ +-+ + +-+-+ + +-+-+-+ + +-+ + +-+-+-+ + +-+-+-+-+ +-+-+-+ +-+ +-+ + + + +-+-+ + + +-+-+-+-+-+ +
|       |     |   |       | | |   |     | |   |       | |     |     |   | | | |   | | | |       |   |
+ +-+-+-+-+-+-+ + +-+-+-+ + +-+ +-+-+-+ + +-+-+ +-+-+ + + +-+ +-+-+-+ + + + + + +-+ + + +-+-+ +-+ +-+
|   |   |       |   |   |   |   |     | |         |     |   | |       | | | |   |   | |     |   | | |
+ +-+ + + +-+-+-+-+ + + +-+-+ +-+ + +-+ + +-+-+ + +-+-+-+-+ + + +-+-+-+-+ + +-+ + +-+-+-+ + +-+ + + +
| |   |   |         | | |   |     |     | |   | |   |       | | |   |     | |   | |     | |   | | | |
+ + +-+-+-+-+-+-+-+-+ + + + + +-+-+-+-+-+-+ + +-+-+ + +-+-+-+ + + + + +-+-+ +-+-+ +-+ + +-+-+ + + + +
| |   |   |     |     |   | |   |       |   |     |       |   | | |   |   |     | |   |       | | | |
+ +-+ + + + +-+ + +-+-+-+-+ +-+ +-+-+ + + +-+-+-+ +-+ +-+-+ +-+ + +-+-+-+ +-+-+ + + +-+-+-+-+-+ + + +
|   | | | |   |   |     |     |   |   |   | |   |   | |   |   |   |       | |   | | |           |   |
+-+ + + + +-+ +-+-+ +-+ + +-+-+-+ + +-+-+-+ + + +-+ +-+ + +-+ +-+-+-+-+ + + + +-+ + +-+ + +-+-+ +-+ +
|   |   |   |   |   |   |       | | |   |     |   | |   |             | |   |   | |   | |   |   |   |
+ +-+-+-+ +-+-+ + +-+ +-+-+-+-+ + + + +-+ +-+-+-+ + + +-+-+-+-+-+-+-+ + +-+ +-+ + +-+ + +-+ +-+-+ +-+
|       |         |           |     |           |     |                 |     |       |   |         |
+-+-+-+-+-+-+-+-+-+-+-+-+-+-+-+-+-+-+-+-+-+-+-+-+-+-+-+-+-+-+-+-+-+-+-+-+-+-+-+-+-+-+-+-+-+-+-+-+-+-+