+-+-+-+-+-+-+-+-+-+-+-+-+-+
|                         |
+ + +-+ + +-+-+-+-+-+-+-+-+
| |   | | |.|.|.|.|.|.|.|.|
+-+-+-+-+-+-+-+-+-+-+-+-+-+
|.|.|.|.|.|.|.|.|.|.|.|.|.|
+-+-+-+-+-+-+-+-+-+-+-+-+-+
|.|.|.|.|.|.|.|.|.|.|.|.|.|
+-+-+-+-+-+-+-+-+-+-+-+-+-+
|.|.|.|.|.|.|.|.|.|.|.|.|.|
+-+-+-+-+-+-+-+-+-+-+-+-+-+
|.|.|.|.|.|.|.|.|.|.|.|.|.|
+-+-+-+-+-+-+-+-+-+-+-+-+-+
|.|.|.|.|.|.|.|.|.|.|.|.|.|
+-+-+-+-+-+-+-+-+-+-+-+-+-+
|.|.|.|.|.|.|.|.|.|.|.|.|.|
+-+-+-+-+-+-+-+-+-+-+-+-+-+
|.|.|.|.|.|.|.|.|.|.|.|.|.|
+-+-+-+-+-+-+-+-+-+-+-+-+-+
|.|.|.|.|.|.|.|.|.|.|.|.|.|
+-+-+-+-+-+-+-+-+-+-+-+-+-+
|.|.|.|.|.|.|.|.|.|.|.|.|.|
+-+-+-+-+-+-+-+-+-+-+-+-+-+
|.|.|.|.|.|.|.|.|.|.|.|.|.|
+-+-+-+-+-+-+-+-+-+-+-+-+-+
|.|.|.|.|.|.|.|.|.|.|.|.|.|
+-+-+-+-+-+-+-+-+-+-+-+-+-+