+-+-+-+-+-+-+-+
|             |
+ +-+-+-+-+-+-+
|             |
+ + + + + +-+ +
| | | | |   | |
+ + + + +-+-+ +
| | | |     | |
+ + + + + + +-+
| | | | | |   |
+ + + + +-+ +-+
| | | |   |   |
+ + +-+-+ + + +
| |     | | | |
+-+-+-+-+-+-+-+