+-+-+-+-+-+-+-+-+-+-+-+-+-+-+-+-+-+-+-+-+-+-+-+-+-+-+-+-+-+-+-+-+-+-+-+-+-+-+-+-+-+-+-+-+-+-+-+-+-+-+
|                                                                                                   |
+ + + + + +-+ + +-+-+ +-+ + + + + + +-+ +-+ + +-+-+ +-+ + +-+-+-+-+-+ +-+-+-+-+ +-+-+ +-+-+ +-+ + +-+
| | | | |   | |     |   | | | | | |   |   | |     |   | |           |         |     |     |   | |   |
+ +-+-+-+-+ +-+ +-+-+-+ +-+-+-+-+ + + + + + +-+-+ +-+ +-+-+ + + + +-+ + + +-+ + +-+-+-+-+-+ +-+ +-+-+
|         |   |       |         | | | | | |     |   |     | | | |   | | |   | |           |   |     |
+ +-+-+ +-+ + +-+ +-+ + +-+ + + + +-+-+ +-+ + +-+-+-+ + + + +-+ +-+-+-+ +-+-+-+ +-+ + + +-+-+ +-+ +-+
|     |   | |   |   | |   | | | |     |   | |       | | | |   |       |       |   | | |     |   |   |
+ +-+ +-+ + +-+ +-+-+-+ +-+-+-+-+ +-+-+ + +-+-+ + + + + + + + +-+-+ + + + +-+-+ + + +-+-+-+ +-+ + + +
|   |   | |   |       |         |     | |     | | | | | | | |     | | | |     | | |       |   | | | |
+ +-+ + +-+-+-+-+-+ +-+ +-+ +-+ + + +-+ + +-+-+ + + + + + + +-+-+ +-+ +-+ +-+-+ + + + +-+-+ +-+ +-+-+
|   | |           |   |   |   | | |   | |     | | | | | | |     |   |   |     | | | |     |   |     |
+ +-+-+ + +-+ + +-+ +-+ +-+-+-+-+ +-+ +-+ +-+ +-+ + + + + + + +-+-+-+ +-+ + + + +-+ +-+-+ +-+-+-+ +-+
|     | |   | |   |   |         |   |   |   |   | | | | | | |       |   | | | |   |     |       |   |
+ +-+ + + +-+-+-+-+-+ + +-+ + + +-+ + +-+ +-+-+-+-+ + +-+ + + +-+-+ + +-+ + +-+ +-+-+-+ +-+-+-+ + +-+
|   | | |           | |   | | |   | |   |         | |   | | |     | |   | |   |       |       | |   |
+ +-+ +-+ +-+ +-+ +-+-+ + +-+ +-+ + +-+ + + +-+-+ +-+-+-+ + +-+ + + +-+-+ +-+ + + + +-+ + +-+-+-+ + +
|   |   |   |   |     | |   |   | |   | | |     |       | |   | | |     |   | | | |   | |       | | |
+ +-+ + + +-+ + + +-+-+-+ +-+-+-+ +-+ + + +-+ + +-+-+ + +-+-+ +-+ + +-+-+ + + +-+ + + +-+-+-+ +-+-+-+
|   | | |   | | |       |       |   | | |   | |     | |     |   | |     | | |   | | |       |       |
+ +-+ +-+ +-+ +-+-+ + + + + +-+ +-+ +-+-+ +-+-+ + +-+ + + +-+ + + + +-+-+-+ + +-+ +-+ + +-+-+-+-+-+-+
|   |   |   |     | | | | |   |   |     |     | |   | | |   | | | |       | |   |   | |             |
+ + + + + +-+-+ +-+-+-+ +-+ +-+ + +-+ +-+ + +-+ + + +-+ +-+-+-+-+-+ + +-+-+-+ +-+ +-+-+ + + + + + + +
| | | | |     |       |   |   | |   |   | |   | | |   |           | |       |   |     | | | | | | | |
+ +-+ + + +-+-+-+-+ + +-+ + +-+ + + +-+-+-+ + +-+-+ +-+ + + +-+-+ + +-+-+-+-+ + +-+ + +-+ + + + +-+ +
|   | | |         | |   | |   | | |       | |     |   | | |     | |         | |   | |   | | | |   | |
+ +-+ +-+ + +-+ +-+ + + +-+ + + +-+-+-+ + +-+-+ + +-+ +-+-+-+-+-+ +-+ +-+ + +-+ +-+-+-+-+-+ + + +-+ +
|   |   | |   |   | | |   | | |       | |     | |   |           |   |   | |   |           | | |   | |
+ + +-+-+-+ + + +-+-+ + +-+-+ +-+ +-+-+-+-+-+-+-+ + + +-+ + + +-+-+ + +-+-+ +-+ +-+ +-+-+ +-+ +-+-+ +
| |       | | |     | |     |   |               | | |   | | |     | |     |   |   |     |   |     | |
+ + + + +-+ +-+ + +-+ + +-+ + + + + + + + +-+ + +-+ + +-+-+-+ + + + +-+ + + + +-+-+ + + + + + + + + +
| | | |   |   | |   | |   | | | | | | | |   | |   | |       | | | |   | | | |     | | | | | | | | | |
+ + +-+-+ + + + +-+ +-+-+-+-+ + + +-+ + +-+ + +-+-+ + + +-+ +-+ +-+-+-+ + +-+ + +-+ + + +-+-+-+-+ + +
| |     | | | |   |         | | |   | |   | |     | | |   |   |       | |   | |   | | |         | | |
+ + + + + +-+ +-+-+ +-+-+-+-+ +-+ +-+-+ + + +-+ +-+-+-+-+-+-+-+ +-+ +-+-+-+ + + + +-+-+-+ + +-+-+-+ +
| | | | |   |     |         |   |     | | |   |               |   |       | | | |       | |       | |
+ +-+ +-+-+ +-+ +-+-+ +-+-+ + + + +-+ + +-+ + +-+ + + + + +-+ +-+-+ + + +-+ +-+-+-+ +-+-+ +-+-+ +-+-+
|   |     |   |     |     | | | |   | |   | |   | | | | |   |     | | |   |       |     |     |     |
+ + + +-+ + + + + + + + + + +-+ +-+ +-+ +-+ +-+-+ +-+ + +-+-+ + +-+ +-+ + +-+ +-+ + +-+ + + + + + + +
| | |   | | | | | | | | | |   |   |   |   |     |   | |     | |   |   | |   |   | |   | | | | | | | |
+ + + + + + +-+ +-+-+ +-+-+-+ + +-+-+ +-+ +-+ + + + + +-+-+-+ + + + +-+-+-+-+ + + + + +-+ +-+ +-+ +-+
| | | | | |   |     |       | |     |   |   | | | | |       | | | |         | | | | |   |   |   |   |
+ + + + + + +-+-+-+ + + +-+ + +-+-+-+-+ + +-+ +-+-+ + + +-+ + +-+-+ +-+-+ +-+-+-+ + +-+-+ + + +-+ +-+
| | | | | |       | | |   | |         | |   |     | | |   | |     |     |       | |     | | |   |   |
+ +-+-+-+-+ +-+ +-+ +-+ + +-+-+-+ + +-+-+ +-+-+-+-+-+-+ + +-+-+ + +-+-+-+ +-+ +-+ +-+ +-+ + + +-+-+ +
|         |   |   |   | |       | |     |             | |     | |       |   |   |   |   | | |     | |
+ + + + + +-+-+-+ + +-+-+-+ +-+-+ + +-+ + + + +-+ + +-+-+ +-+ +-+-+-+-+-+-+ +-+-+-+ + + +-+-+-+ +-+ +
| | | | |       | |       |     | |   | | | |   | |     |   |             |       | | |       |   | |
+ +-+-+-+-+-+ +-+-+-+-+-+-+ + + + +-+ + +-+-+ +-+ + + +-+-+-+ + + +-+-+-+-+-+ + + +-+ +-+-+ +-+-+ + +
|           |             | | | |   | |     |   | | |       | | |           | | |   |     |     | | |
+ + +-+ + + + + + + +-+ +-+-+ + +-+-+-+-+-+-+ + + + +-+ +-+ +-+ + + +-+ +-+ + +-+-+ +-+ + +-+ + + + +
| |   | | | | | | |   |     | |             | | | |   |   |   | | |   |   | |     |   | |   | | | | |
+ +-+-+-+ +-+-+-+-+-+-+-+ +-+-+ +-+ +-+-+ +-+-+-+-+ + + +-+ + + +-+ +-+-+ + + +-+-+-+ + +-+ +-+ + +-+
|       |               |     |   |     |         | | |   | | |   |     | | |       | |   |   | |   |
+ +-+ + + + + + + + +-+ + + + +-+ + +-+ + + + +-+ +-+-+ + +-+-+-+ +-+-+ +-+-+-+ + +-+-+-+-+ + +-+ + +
|   | | | | | | | |   | | | |   | |   | | | |   |     | |       |     |       | |         | |   | | |
+ +-+ +-+ +-+ + + + + + + +-+ +-+ +-+-+-+ +-+ +-+-+-+-+ + +-+-+ +-+ + + +-+-+-+ +-+ + + + +-+ +-+ +-+
|   |   |   | | | | | | |   |   |       |   |         | |     |   | | |       |   | | | |   |   |   |
+ + +-+-+ + + +-+ + +-+-+-+-+ +-+-+ + +-+-+ + +-+ +-+-+ +-+ +-+-+-+-+ +-+-+-+ +-+ +-+-+-+-+-+-+-+-+ +
| |     | | |   | |         |     | |     | |   |     |   |         |       |   |                 | |
+ +-+ +-+-+-+ +-+-+-+-+ +-+-+-+-+ +-+-+-+ + +-+ + + +-+-+ + +-+ +-+ +-+-+-+-+-+ + + +-+ + + + + + +-+
|   |       |         |         |       | |   | | |     | |   |   |           | | |   | | | | | |   |
+ +-+-+-+-+-+ +-+-+-+-+-+-+ + + +-+-+ +-+-+-+-+-+ + +-+ + + + + + + +-+-+ +-+ +-+ +-+ + +-+-+ +-+ +-+
|           |             | | |     |           | |   | | | | | | |     |   |   |   | |     |   |   |
+ +-+-+-+-+ + +-+-+ +-+-+-+ + +-+ + + +-+-+ +-+-+ + + +-+-+-+ + + + +-+ + + +-+-+-+ +-+ +-+-+ +-+ +-+
|         | |     |       | |   | | |     |     | | |       | | | |   | | |       |   |     |   |   |
+ +-+-+ + +-+-+-+ +-+ + +-+ +-+ + + + +-+ +-+ + + + + +-+ + +-+ +-+-+-+ + +-+ +-+ + +-+-+-+-+ + +-+ +
|     | |       |   | |   |   | | | |   |   | | | | |   | |   |       | |   |   | |         | |   | |
+ + + + + + +-+-+-+ +-+-+ + +-+ +-+ + + +-+ +-+-+ + + + + + + + +-+ +-+ +-+-+ + + +-+-+ + + + +-+ +-+
| | | | | |       |     | |   |   | | |   |     | | | | | | | |   |   |     | | |     | | | |   |   |
+ +-+ +-+-+ +-+-+-+-+ + +-+ +-+ +-+-+-+ + +-+-+-+-+ +-+ +-+-+ + +-+ +-+-+ +-+-+ + +-+ +-+ + +-+ + +-+
|   |     |         | |   |   |       | |         |   |     | |   |     |     | |   |   | |   | |   |
+ +-+ + + + +-+ +-+ +-+ +-+-+ + +-+-+-+-+-+ +-+ + +-+-+ + +-+-+ +-+ + + + + +-+-+ + + + +-+-+-+ +-+-+
|   | | | |   |   |   |     | |           |   | |     | |     |   | | | | |     | | | |       |     |
+ +-+-+-+ + +-+ + + + +-+-+-+ + + +-+ +-+ + + +-+-+-+ +-+ +-+ + +-+-+-+ +-+ +-+ +-+-+ + + + + + + +-+
|       | |   | | | |       | | |   |   | | |       |   |   | |       |   |   |     | | | | | | |   |
+ +-+ +-+-+-+-+-+-+ +-+-+ + + + + +-+-+ +-+-+-+-+-+-+-+-+ + + + + +-+ + + +-+ +-+ + +-+-+-+ + +-+-+-+
|   |             |     | | | | |     |                 | | | | |   | | |   |   | |       | |       |
+ +-+-+-+-+-+-+-+-+-+ +-+-+-+ +-+ + + +-+ + + + +-+-+ +-+ + +-+ +-+ +-+-+-+-+-+ + +-+-+ +-+ +-+-+ +-+
|                   |       |   | | |   | | | |     |   | |   |   |           | |     |   |     |   |
+ + + + + + +-+-+-+ + +-+-+ +-+ + +-+-+-+ + +-+ +-+ + +-+-+ + + + +-+ +-+-+ +-+ +-+-+-+ + + + +-+-+ +
| | | | | |       | |     |   | |       | |   |   | |     | | | |   |     |   |       | | | |     | |
+ + + +-+ + + + + +-+-+ + +-+ + +-+ +-+-+ +-+-+-+ +-+-+-+-+-+-+ + +-+-+-+ + + +-+ + +-+ + + + + + +-+
| | |   | | | | |     | |   | |   |     |       |             | |       | | |   | |   | | | | | |   |
+ + + +-+-+ +-+-+ +-+-+-+ + +-+-+ +-+ +-+-+-+ + + +-+ + +-+-+ +-+-+ + + + +-+ + + + +-+-+ + +-+ + + +
| | |     |     |       | |     |   |       | | |   | |     |     | | | |   | | | |     | |   | | | |
+ +-+ + + + + + + +-+ +-+-+-+ + +-+ + +-+-+ + + + +-+-+ +-+-+-+ + + +-+ + +-+-+-+ + +-+ + + +-+ +-+-+
|   | | | | | | |   |       | |   | |     | | | |     |       | | |   | |       | |   | | |   |     |
+ +-+ + + +-+-+ + + +-+-+ + +-+ + + + + + +-+-+-+ +-+-+-+-+ + +-+ + + + +-+ + +-+ +-+-+-+-+-+ +-+-+ +
|   | | |     | | |     | |   | | | | | |       |         | |   | | | |   | |   |           |     | |
+ + + +-+ + + + +-+-+ + +-+-+ +-+-+ + +-+-+-+ +-+ + + +-+-+-+ + +-+-+ + + + + +-+ +-+ + + + +-+-+ + +
| | |   | | | |     | |     |     | |       |   | | |       | |     | | | | |   |   | | | |     | | |
+ + +-+-+-+ + + +-+ +-+-+ +-+-+ +-+-+-+ +-+ +-+ + +-+ +-+-+ +-+ +-+ + + + +-+-+-+-+ +-+-+ +-+-+-+-+ +
| |       | | |   |     |     |       |   |   | |   |     |   |   | | | |         |     |         | |
+ +-+ + + + +-+ +-+ + +-+-+ +-+ +-+ +-+-+ + +-+-+-+-+-+ + + +-+-+ +-+-+-+ +-+-+-+-+-+ +-+-+-+ +-+-+-+
|   | | | |   |   | |     |   |   |     | |           | | |     |       |           |       |       |
+ +-+ +-+ + +-+-+-+ +-+-+-+ +-+ + +-+-+-+-+-+-+ + + + + + + + +-+-+-+ + +-+-+ + +-+ + + + +-+ +-+ +-+
|   |   | |       |       |   | |             | | | | | | | |       | |     | |   | | | |   |   |   |
+ + +-+-+ +-+-+-+-+-+-+ +-+-+ +-+ +-+ + + + + +-+ + + + + +-+-+-+-+-+ +-+ +-+ + + +-+ + +-+ +-+-+ +-+
| |     |             |     |   |   | | | | |   | | | | |           |   |   | | |   | |   |     |   |
+-+-+-+-+-+-+-+-+-+-+-+-+-+-+-+-+-+-+-+-+-+-+-+-+-+-+-+-+-+-+-+-+-+-+-+-+-+-+-+-+-+-+-+-+-+-+-+-+-+-+