+-+-+-+-+-+-+-+
|   |         |
+ + +-+-+-+ +-+
| | | | |     |
+ + + + + + + +
| | |     | | |
+ +-+ + +-+ + +
|   | |   | | |
+-+ + +-+ +-+-+
|   | |   | | |
+-+ + +-+-+ + +
|             |
+-+-+ +-+-+-+ +
|       |     |
+-+-+-+-+-+-+-+