+-+-+-+-+-+-+-+-+-+-+-+-+-+-+-+-+-+-+-+-+-+-+-+-+-+-+-+-+-+-+-+-+-+-+-+-+-+-+-+
|                                                                             |
+ + + + +-+ + + +-+-+-+-+ + + + + + + + + + + + + + + + + + + +-+ + + + + + + +
| | | | |   | |       |   | | | | | | | | | | | | | | | | | |   | | | | | | | |
+-+ + + + + + +-+-+-+ +-+-+-+-+-+ +-+ +-+ + + + + + +-+ +-+ + + + +-+ + + + + +
|   | | | | |       |     |       |     | | | | | | |     | | | | |   | | | | |
+ + + + +-+-+ + +-+ +-+ + + + + + + + +-+ + +-+ + + +-+ + +-+ + + + + + +-+ + +
| | | |   |   | |     | | | | | | | | |   |   | | | |   |   | | | | | |   | | |
+ +-+ + +-+-+ + +-+ + + + + +-+-+ +-+ + + + +-+ + + + + +-+ +-+ + + + + + +-+ +
|   | | |     |   | | | | | |     |   | | |   | | | | | |     | | | | | |   | |
+ + + +-+ +-+ + + + + + + +-+-+-+ + + + + + + + +-+ +-+ + + + +-+-+-+ +-+-+ + +
| | | |     | | | | | | | |       | | | | | | |   | |   | | |     |     |   | |
+ + +-+ + +-+-+ +-+-+ + + + + +-+-+-+ +-+ + +-+ +-+ + + + + +-+-+ +-+ + +-+ + +
| | |   |     |   |   | | | | |         | |   | |   | | | | |     |   |   | | |
+ + +-+ + + + + + +-+ + + +-+-+ +-+-+ + + + + + + + + + + + + +-+ +-+ + + + +-+
| |   | | | | | |   | | |     |     | | | | | | | | | | | | |   |   | | | |   |
+ +-+ + + + + + +-+-+-+ + +-+ +-+ + + + + + +-+ +-+ + + +-+ + + +-+-+ + + + + +
|   | | | | | | |       | |     | | | | | |   |   | | | |   | |   |   | | | | |
+ + +-+ + + +-+ + + + + + + + +-+-+ + + + +-+ + +-+ + + +-+ +-+ +-+-+-+-+ +-+ +
| |   | | |   | | | | | | | | |     | | | |   |   | | |   | |     |         | |
+-+ + + + + + + + + + + +-+-+ + +-+-+ + +-+ +-+ +-+ + + +-+-+ +-+-+ + + + + +-+
|   | | | | | | | | | |   |   | |     |   |   |   | | |   |     |   | | | |   |
+ + + +-+-+ + +-+ + +-+ +-+-+ + + + +-+ + + +-+ + + +-+ + +-+ + + +-+ + + + + +
| | | |     |   | | |     |   | | |   | | |   | | | |   | |   | | |   | | | | |
+ + + + + +-+ + +-+-+ +-+ + + + + +-+ + + + + +-+ + +-+ + +-+-+ + + + + +-+ + +
| | | | | |   | |       | | | | |   | | | | |   | | |   |   |   | | | |   | | |
+-+ + +-+-+ +-+ +-+ + + + + + + + + + +-+ + + + + + + + + + + + +-+ + + + + + +
|   |     | |     | | | | | | | | | | |   | | | | | | | | | | | |   | | | | | |
+ + + +-+-+ + + + + + +-+-+ +-+ +-+ + +-+ +-+ + + +-+-+ + + + + + +-+ + + + + +
| | |   |   | | | | |     |   | |   |   |   | | |     | | | | | |   | | | | | |
+ + + +-+ + + + + + + +-+ + + + + + +-+-+ + + +-+-+-+ + + + + + + +-+-+-+-+ + +
| | |   | | | | | | |   | | | | | |     | | | |       | | | | | |   |       | |
+ +-+ + + + + + + + +-+ + + + + + + +-+-+-+ + + + + +-+ +-+-+ +-+ + + + + + + +
| |   | | | | | | |   | | | | | | |     |   | | | |   | |     |   | | | | | | |
+-+ + + +-+ + + + +-+ + + +-+ + +-+-+ +-+-+ + + + +-+ + +-+ + + +-+ + + +-+-+-+
|   | |   | | | | |   | | |   | |       |   | | | |   |   | | | |   | |       |
+ + + +-+ + + + + +-+ +-+ +-+-+-+-+ + + + + +-+ + +-+ + + + + + + + + + +-+ + +
| | |   | | | | |   | |         |   | | | | |   |   | | | | | | | | | | |   | |
+ + + +-+ + + + +-+ +-+ + + +-+ + + + +-+-+-+ + +-+ + + +-+-+ +-+ + +-+ + + + +
| | | |   | | | |   |   | | |   | | | |       |   | | | |       | | |   | | | |
+ +-+ +-+ + + + + + + +-+-+ + + + + + + +-+-+ + +-+-+ +-+ + + +-+-+ + + +-+ + +
|   |   | | | | | | | |     | | | | | |     | | |       | | |   |   | |   | | |
+ + +-+ +-+-+-+ +-+ + + + + + + +-+-+ + + + + + + + + + + + +-+ + +-+-+ + +-+ +
| | |         |   | | | | | | |     | | | | | | | | | | | | |   |   |   |   | |
+ + +-+ + + +-+ + + + + +-+-+ +-+ + +-+ +-+ + +-+ +-+ +-+ + + + + + + + + + + +
| |   | | |   | | | | |     |   | |   | |   | |     | |   | | | | | | | | | | |
+ +-+ + + + + + + +-+ + + + +-+-+-+ + + +-+-+-+ + +-+ + + + + +-+-+-+ +-+ + +-+
|   | | | | | | | |   | | |   |     | |     |   |   | | | | |     |     | |   |
+ + + + + + + + + +-+ + +-+ + + + +-+ + + + + + + + + + + +-+-+ + + +-+ + + + +
| | | | | | | | | |   |   | | | | |   | | | | | | | | | |     | | |   | | | | |
+ + + + + +-+ + + + +-+ + +-+-+-+ +-+ + + + + +-+ + + + +-+ +-+-+ + + +-+ +-+ +
| | | | |   | | | | |   |       |   | | | | |   | | | | |       | | |   |   | |
+ +-+ + + + + + + + + +-+ + + +-+-+ +-+ + + + + + +-+ + + +-+-+-+ +-+ + + +-+ +
| |   | | | | | | | | |   | | |       | | | | | |   | | | |         | | |   | |
+ + + + +-+-+ +-+ + + + + + + + + + +-+ +-+-+-+ + +-+ + + + + + +-+ +-+ +-+ + +
| | | |     | |   | | | | | | | | |   |       | | |   | | | | | |     | |   | |
+ +-+ + + + +-+-+ + + +-+ + + + +-+ + + + +-+ + + + + + +-+ + + + +-+-+ + + + +
|   | | | | |     | | |   | | | |   | | | |   | | | | |   | | | |     | | | | |
+ + + +-+-+ + +-+ + + + + + +-+ + + +-+ +-+-+-+-+ +-+ + +-+ + + +-+ + + + +-+ +
| | |     | | |   | | | | | |   | |   |   |       |   |   | | |   | | | |   | |
+ + + +-+-+-+ + + + + + +-+-+ + +-+ + + + + + +-+ + + +-+ + + + +-+ + +-+ +-+ +
| | | |       | | | | |     | | |   | | | | |   | | |   | | | | |   |   |   | |
+-+-+ + + +-+-+-+ +-+ + +-+ +-+-+-+ + +-+ + + + + + + + + + + + + +-+ +-+ + + +
|     | |     |   |   | |         | |   | | | | | | | | | | | | | |     | | | |
+ + +-+ + +-+ + + +-+ +-+ + + +-+-+-+ + + +-+-+ + + + +-+ + + + + +-+ + + +-+ +
| | |   |   | | |   |   | | |     |   | |     | | | |   | | | | |   | | |   | |
+ + + + +-+ +-+ + + +-+-+-+ +-+ + +-+ + +-+ + + +-+ + + + + + + + +-+-+ + + + +
| | | |   |   | | |   |       | | |   |   | | |   | | | | | | | | |     | | | |
+ +-+ + +-+ + +-+ + +-+-+ +-+ +-+-+ +-+ + +-+-+ + + + +-+ + +-+ +-+ + + + +-+ +
|   | | |   | |   |     | |     |   |   |   |   | | | |   | |   |   | | | |   |
+-+ + +-+ +-+-+-+ +-+-+-+ + + + + +-+-+ +-+-+ +-+-+-+-+ +-+ +-+ +-+ + +-+-+ + +
|   | |   |       |       | | | |   |     |     |         |   | |   |     | | |
+ + + +-+-+-+ +-+ + + + + +-+ +-+-+ + +-+-+-+ +-+-+ +-+ + +-+ + + + + +-+-+-+ +
| | |     |   |   | | | |   |     | |       | |       | |   | | | | |       | |
+-+ + + +-+ + + +-+ +-+-+ + + + + + + + +-+ + + + +-+ +-+ + +-+ +-+-+ + +-+-+ +
|   | | |   | | |       | | | | | | | |   | | | | |   |   | |     |   |   |   |
+-+ + + +-+ + +-+ + +-+ + +-+ +-+ +-+-+ + + + + + +-+ + +-+ +-+ + + + + + + +-+
|   | |   | | |   |   | | |     |     | | | | | | |   | |     | | | | | | |   |
+-+-+-+-+-+-+-+-+-+-+-+-+-+-+-+-+-+-+-+-+-+-+-+-+-+-+-+-+-+-+-+-+-+-+-+-+-+-+-+