+-+-+-+-+-+
|         |
+ + + + +-+
| | | |   |
+ +-+ +-+ +
|   |   | |
+ + +-+ + +
| |   | | |
+ + +-+ +-+
| |   |   |
+-+-+-+-+-+