+-+-+-+-+-+-+-+-+-+-+-+-+-+-+-+-+-+-+-+-+-+-+-+-+-+-+-+-+-+-+-+-+-+-+-+-+-+-+-+-+-+-+-+-+-+-+-+-+-+-+
| | |       | |   |     |   |     |   | |           |   |     |     |       |     | | |   | |     | |
+ + + +-+ + + + +-+-+ +-+ +-+ +-+-+ + + + +-+-+ +-+-+ +-+ + +-+-+ + +-+ + +-+ +-+-+ + + +-+ +-+-+ + +
| | |   | |     | |       | | |   | | | | |     |   |   | | | |   | |   |     |             | |   | |
+ + + + + +-+-+ + +-+ +-+ + + +-+ +-+ + +-+ +-+ + +-+-+ + +-+ +-+-+ + + + +-+-+-+-+-+-+-+-+ + +-+ + +
|     | |   | | |   | |   | |     |   | |   |   |       |     |   | | | |         |         | | |   |
+-+-+-+-+-+ + + + + +-+-+ + + + + + +-+ +-+ +-+-+ + + + +-+-+ +-+ + + +-+-+-+-+ +-+-+-+-+-+ + + + +-+
| | | | |     | | |           | |     |           | | | |   |             |           |         |   |
+ + + + + +-+-+ + + + + +-+-+-+ +-+-+-+-+-+ +-+-+-+ +-+-+ +-+ +-+ + +-+-+-+ + +-+-+-+ + +-+ + + + +-+
|   |       |     | | | | |       |   |   | |   |     | |   | |   |   |     |       |     | | |     |
+ +-+ + +-+ + +-+-+-+-+ + +-+ +-+ + + +-+ + + +-+ +-+-+ + + +-+-+-+-+-+-+-+ +-+-+ +-+-+-+-+-+-+ +-+ +
|     | |   | |         | | |   | | |   |       | | |     |     | |   | |   |     |     | | |   |   |
+-+-+ +-+ + +-+ +-+-+-+ + + + +-+ + +-+ + +-+-+-+-+ +-+-+-+-+ +-+ + +-+ +-+-+-+-+-+-+-+ + + +-+ + + +
|     |   | |     |     | | | |       | |       |       | |   |     |   |   |   |   |     |   | | | |
+-+ + + +-+ +-+-+-+ + +-+ + + +-+-+ +-+ + + +-+-+-+-+ +-+ + +-+ +-+ +-+ +-+ + +-+-+ + + +-+-+ + +-+ +
| | | | |   |     | | |   | | |   | | | | |   | |       |     |   | | |     |   |     | |   |     | |
+ +-+-+ + +-+-+ +-+ +-+ +-+ + + + + + + +-+ +-+ + +-+-+-+ +-+-+-+ + + + +-+ +-+ + + +-+-+ +-+-+-+ +-+
| |     | |     | |   |       | |     |       |           |       | |     | |     | |   |           |
+ +-+ +-+-+ +-+ + +-+-+ + +-+-+-+ +-+-+-+ + +-+-+-+-+ +-+-+-+-+ +-+-+ + + + +-+ +-+-+ +-+-+-+ +-+-+-+
|       | | |   |   |   |   |   |   |     |     | | |   |     |     | | | | |     |         | |     |
+-+ +-+ + + +-+-+ +-+-+ +-+-+-+ + +-+ + +-+ + +-+ + +-+ +-+-+ +-+-+ + + +-+ +-+ +-+ + +-+ +-+ +-+ + +
| | |     | |   |   | | | | |   | |   | |   | | | |     | |     |     | | |   |   | | |           | |
+ +-+-+-+-+ + + + + + + + + +-+ +-+-+-+-+-+ +-+ + +-+ +-+ + + +-+ +-+ +-+ +-+ + + +-+-+ +-+-+ +-+ + +
| | |         | | | | | | |     |     | |     |             | | |   | | |   | | |       | |     | | |
+ + + + +-+ +-+ +-+ + +-+ +-+-+ + +-+ + + +-+-+ + + +-+-+ + + + +-+-+ + +-+ + + +-+ +-+-+ + +-+-+-+ +
|   | | |   |     | |   | | |     | |   | | |   | |   |   | |   | |   | | |       |   |   |   |     |
+-+ +-+ +-+ +-+ +-+ + + + + + +-+-+ + +-+ + +-+-+-+ +-+-+ +-+ + + + + + + + +-+-+-+ +-+-+ +-+ +-+-+ +
|   |     |   | |     |             |       |   |   |     | | | | | |     | |     | |       |   |   |
+ + +-+-+-+ +-+-+ +-+-+-+-+ +-+ +-+-+-+ + +-+-+ +-+ +-+ +-+ +-+ + +-+-+ +-+ +-+ +-+ +-+ +-+ + + + +-+
| |       |     |   |       |   |     | |         | | |   |   | |         | | | | | | | | |   | |   |
+ +-+-+ +-+ + + +-+-+-+ + +-+ + +-+ + +-+ +-+-+ + +-+ +-+ +-+ +-+-+ +-+-+-+-+ + + +-+ + + +-+-+-+-+-+
|     |     | |   |     | |   | |   |   | |     |     |   |   |   | | |       |       |           | |
+ + +-+-+ +-+ +-+ + +-+ +-+-+ +-+-+ + + +-+-+-+ +-+ +-+ + + + + +-+ + +-+ +-+-+-+ + +-+ +-+ +-+ +-+ +
| |     | | | |   | |   |   | |     | | | |       |     | | |   | |   |       |   |   | |   |       |
+-+-+ + +-+ +-+-+ + +-+-+-+ + +-+-+-+-+ + +-+ + + + +-+ +-+ + + + + + + +-+ + + +-+ +-+ +-+-+-+ +-+-+
| | | |     |     |       |         |       | | | | |   |   | | |   |   |   | | |   |       |       |
+ + +-+ +-+-+ +-+ +-+ +-+-+ +-+-+ +-+ +-+-+ + +-+-+ +-+-+-+ +-+-+-+ +-+-+-+-+ +-+ +-+-+-+ +-+-+-+-+ +
|         | | |   |     |   |     |   |         |     | |       |     |     |     |     |         | |
+-+-+ + +-+ + +-+ + + + + + + + + + +-+-+ +-+ +-+-+-+-+ +-+ +-+-+ +-+ +-+ +-+-+ + +-+-+ + +-+ +-+-+ +
|   | | |   |   |   | | | | | | | | | |   |   |   | | |     |   | |       |   | |   | | |   |     | |
+-+ + + + +-+ +-+-+-+ + +-+-+ +-+-+-+ + +-+-+ + + + + +-+ +-+ +-+-+-+ +-+-+ +-+-+ +-+ + + +-+-+ +-+ +
|   | | |   |     |   | | |   |   | |     | |   |         | |     |   |     |   | |       |   |   | |
+ +-+ + +-+ +-+-+-+-+ +-+ + +-+ +-+ + +-+-+ +-+ + +-+ +-+-+ +-+ +-+-+ +-+-+ + + +-+-+-+-+ + +-+ + +-+
|     | |   | |   |   |     | | | |         |   |   |     | | |     | |     | | |     | |   |   |   |
+ +-+-+ +-+ + + +-+-+-+ +-+ + + + +-+-+-+ +-+-+-+-+-+-+-+ + + +-+-+ + + +-+ + +-+ + +-+ +-+-+-+ + + +
|     |   |   | |   |   | |       |         | |     |               | | |   | |   |     |       | | |
+-+-+-+ +-+ +-+ + +-+ + + + + +-+-+-+ +-+ +-+ + + + +-+-+-+ +-+-+-+ +-+-+ + + + +-+ + + + +-+-+ +-+ +
|     | |         |   | |   | |   | |   | | | | | |   |   | |   |   | |   | |     | | |   |     | | |
+-+-+ +-+ + + + +-+-+ +-+ + + + +-+ + + +-+ + + + +-+-+-+ +-+-+ + +-+ +-+-+ +-+ +-+-+ +-+-+ +-+-+ + +
| |     | | | | |     | | | |   |   | |     |   | |       | | | |     | | |       |   |     |     | |
+ +-+ + + +-+-+ +-+-+ + +-+ +-+ +-+ + + +-+ +-+ + + + +-+-+ + + +-+ + + + + + +-+-+-+-+ +-+-+-+ +-+ +
| |   |     |   | |   |       |     | | | |   | |   | |     |     | |   |   |       |   | | |     | |
+ +-+ + +-+ +-+-+ +-+-+ + + +-+ + +-+ +-+ + +-+-+-+-+ + +-+-+ +-+ +-+ + +-+-+-+-+ +-+-+-+ + +-+-+ +-+
|   | | | |   |   | |   | | |   | |   |       |       |       | |     | |       |   | | |   |   | | |
+ + +-+ + + +-+-+ + + + + +-+ + +-+ + +-+ + + +-+ +-+-+ +-+-+ + + +-+ + +-+ +-+ +-+ + + + +-+ +-+ + +
| |     |       |     | |   | | |   |   | | |         | | |   | |   | | | |   | |     |   |   |   | |
+-+-+ +-+ +-+ +-+ + + +-+-+ +-+-+-+-+ + +-+ +-+-+ +-+ + + + +-+ +-+-+ + + + + +-+-+-+ + +-+ +-+ + + +
|     |   | |   | | |   | | | |       |   | | | |   | | |   |     |   |     | |   |         |   |   |
+ +-+ +-+-+ +-+-+ + + +-+ + + +-+-+ +-+ +-+-+ + +-+-+-+-+-+-+ + + + +-+ +-+ + + + + +-+ + + +-+ + +-+
| |   |   | |     | |   | | |         |           | |       | | | |   | |   |   |   | | | |   | |   |
+-+ +-+ + + + +-+-+-+ +-+ +-+-+-+-+-+-+ +-+ +-+-+-+ +-+-+-+ + + +-+-+-+ + +-+ + + + + +-+-+ +-+ +-+-+
|       | |         | |   |     |     | |       | | |         | |     | |   | | | | |       | |     |
+-+-+ + + + + +-+-+ +-+-+ + +-+ +-+-+ +-+-+ + +-+ + +-+-+ +-+-+-+ +-+ +-+ +-+-+ + +-+ + + +-+ +-+-+ +
|   | | | | | |     |         | |           |   |   |   |   | | | |   |       | |   | | |           |
+ +-+ + + +-+ +-+-+ + + +-+-+-+ + + +-+-+-+-+-+-+ + +-+ + +-+ + + +-+-+ + +-+ +-+ + +-+-+ +-+-+-+ + +
|   | | | | |     |   |       | | |   | | | |     |     |       |     | |   |   | | | |   | |     | |
+ + +-+ +-+ + + +-+ +-+-+-+-+ +-+-+-+ + + + +-+-+ +-+-+ + +-+-+-+ +-+ + +-+-+ + + +-+ + +-+ +-+-+-+ +
| | | |       |   |     |         | |     | | |   |   |       |   |   | |   | | | |     |     |     |
+ +-+ +-+ +-+-+ +-+-+-+-+-+-+-+-+ + + + + + + +-+ + + + +-+-+-+ +-+-+ + +-+ +-+ + + +-+-+-+ + +-+-+ +
|   |       |     |   |     |       | | | |   | | | |   | |   |   |     |     | | | | |     |       |
+ +-+ +-+-+-+ +-+ + +-+-+ +-+ +-+-+-+-+-+-+-+ + +-+-+ + + + + +-+ +-+ + +-+-+ +-+-+-+ + +-+-+-+ + + +
|   |       | | | |     | | |         |   |   | |     |   | |   | |   |   | | |       |   |     | | |
+ + + +-+-+-+-+ +-+-+ + + + +-+ +-+-+ +-+ + +-+ +-+-+ +-+ + +-+-+-+-+-+-+-+ + + + +-+-+-+-+ + + +-+-+
| |             | |   | |   |     |   | | |   | |   |   | | |   |           | | |   |   |   | |   | |
+ +-+ +-+ + +-+-+ +-+-+ + +-+-+-+ + + + + +-+ + +-+ +-+ +-+ + +-+-+-+ +-+-+ + +-+ +-+-+ +-+-+-+-+ + +
|   |   | | | |       | |       | | |   | | | |       |   | | |     | |           |     |     |     |
+ + +-+-+ +-+ +-+-+-+ + +-+ +-+-+-+-+ +-+ + + +-+ +-+-+-+ + + + + + +-+ + +-+ +-+ + + + + + + +-+-+ +
| | |           |     | | | | | | | | | |           |   |       | |   | | |   |   | | |   | | |     |
+ +-+-+-+-+-+-+-+ +-+-+ + + + + + + + + +-+-+ +-+-+ +-+ + +-+ +-+-+ + + +-+-+-+ +-+-+ + +-+-+ +-+ + +
|   | | |   |       |         |         |         |         | |     | |   |   | | | | | |     |   | |
+ + + + + +-+-+-+-+ +-+ +-+-+-+ +-+ +-+ +-+ +-+ +-+ +-+-+ + +-+ + +-+-+ + + + +-+ + +-+-+ +-+-+-+-+ +
| | |         |       | | | | |   | |     |   |   | |     |   | |   |   |   |   |   |         | |   |
+ + +-+ +-+ +-+ +-+-+-+ + + + +-+-+-+-+-+ + +-+-+-+ +-+ +-+-+ + + + + +-+-+ + +-+ +-+ +-+-+ +-+ +-+-+
| |     | | | | | |               | | | |   |   | |   | |     | | | |     | | |     |     |     |   |
+-+ + +-+ + + + + +-+-+ + +-+-+-+ + + + +-+ +-+ + +-+-+ +-+ + +-+-+ + +-+-+-+-+-+-+ +-+ + + +-+-+ +-+
|   | |     |           |   |   |   | | |     | | |   |   | |   |   | |         |     | | |         |
+-+ +-+-+ +-+-+ + + + +-+ +-+-+ + +-+ + + + +-+ + +-+ + +-+-+ +-+ + + + +-+ + + + + +-+-+-+-+ + +-+ +
|       |       | | | | | |   |       |   | |         | |       | |       | | | | | | | |     |   | |
+-+-+ +-+ +-+ +-+ +-+ + + + +-+ + + +-+ +-+-+-+-+ +-+ +-+-+ +-+-+-+-+ + + +-+-+ + + + + + +-+-+-+ +-+
|     |     |   | |   | |     | | |   |   | |   | | | | |       |   | | | |   |   |           |   | |
+-+ +-+ +-+-+-+-+ +-+ + + +-+ + +-+-+ +-+-+ + + + + + + +-+-+ +-+ +-+ +-+-+ +-+-+-+-+-+ +-+-+ +-+-+ +
|   |   | | |       | |     | | | |   |       | | |         | |   |     |         | | | |       | | |
+-+ +-+ + + +-+ +-+-+-+ +-+ + +-+ +-+ + +-+-+-+-+ + +-+ +-+-+-+-+ + + +-+-+ +-+-+ + + + + +-+ +-+ + +
|     | | |   |     |   | | | |   |     |         |   | |   |       | |     | |         |   | | | | |
+-+-+-+ + + + +-+-+ +-+-+ +-+-+ +-+ + +-+-+ + +-+-+-+-+-+ + + +-+ +-+-+-+-+ + + +-+-+-+-+-+ +-+ + + +
|       | | | |     | |   |   | |   |       |           | | |   | | |     | |           |   |       |
+ +-+-+-+ +-+ +-+-+ + +-+ +-+ + + +-+-+ +-+ +-+ +-+-+ +-+-+ +-+ +-+ +-+ + +-+-+ +-+-+-+-+-+ + + +-+-+
|   | |           |   |     |   |   |   | |   |   |   | | |   | |       | | |   |       |     | | | |
+ + + +-+-+ + +-+ +-+ +-+ + + +-+ + +-+-+ + + +-+-+ + + + +-+ + +-+ + +-+ + + +-+-+-+-+ + +-+-+ + + +
| |     |   |   |         |   |   | |       | |     |     |       | | |               |   |         |
+-+-+-+-+-+-+-+-+-+-+-+-+-+-+-+-+-+-+-+-+-+-+-+-+-+-+-+-+-+-+-+-+-+-+-+-+-+-+-+-+-+-+-+-+-+-+-+-+-+-+