+-+-+-+-+-+-+-+-+-+-+-+-+-+-+-+-+-+-+-+-+-+-+-+-+-+-+-+-+-+-+-+-+-+-+-+-+-+-+-+-+-+-+
|                                                                                   |
+ + +-+ + +-+-+ +-+-+-+ +-+-+-+ + +-+-+ + + + + + + + + + +-+ + +-+ + +-+ +-+-+ +-+-+
| |   | |   |   |           |   |   |   | | | | | | | | |   | |   | | |   |         |
+ +-+ + + +-+-+-+ +-+-+ +-+ + +-+-+ + + +-+ + + + + + + +-+ + +-+ +-+ + + + + +-+-+ +
| |   | |       |   |   |   | |     | | |   | | | | | |   | |   |   | | | | |   |   |
+ + + +-+-+ + + +-+ +-+ + + + + + +-+ + +-+ + +-+ + +-+ + +-+ +-+ +-+ +-+-+-+ + + + +
| | |   |   | | |   |   | | | | |   | |   | |   | |   | | |     | |   |       | | | |
+-+ + + +-+-+ + + + + +-+ + + + + + +-+ + + + +-+-+ +-+-+ + +-+ + + +-+ +-+ + +-+ + +
|   | | |     | | | | |   | | | | |   | | | |     | |     | |   | | |   |   | |   | |
+ +-+ + + + +-+ + +-+-+-+ + + + + + + + + + + + +-+-+ + + + + + +-+ + +-+-+-+ + + + +
|   | | | |   | |       | | | | | | | | | | | | |     | | | | |   | |       | | | | |
+ +-+ + +-+ + +-+ +-+-+ +-+-+ +-+-+-+ + + + +-+ + +-+ + +-+ +-+ + +-+ + + +-+ +-+ + +
|   | |   | |   |   |   |         |   | | |   | |   | | |   |   |   | | | |     | | |
+ +-+ + + +-+ +-+ + + + + + + + + + + + +-+ + + + + + + +-+ + + + +-+ + + + + +-+ + +
| |   | | |     | | | | | | | | | | | | |   | | | | | | |   | | |   | | | | | |   | |
+ + + + +-+ + +-+ + + +-+-+-+ + + +-+ + + +-+ +-+ + + + + + + +-+ + + +-+ +-+-+ +-+ +
| | | |   | |   | | |       | | |   | | | |   |   | | | | | | |   | | |       |   | |
+ + + + +-+-+ +-+ +-+-+ + + + + + + +-+-+ +-+ + +-+ + + +-+-+ +-+-+ +-+ + + + + + + +
| | | | |       |   |   | | | | | |     |   | | |   | | |     |       | | | | | | | |
+-+ + +-+ + +-+ +-+ + +-+ +-+ + + +-+ +-+ +-+-+ + + +-+ + + + + +-+ + +-+-+ +-+-+ + +
|   |   | | |   |   |   | |   | |   | |       | | |   | | | | |   | | |         | | |
+-+ + + + + + + +-+ +-+ +-+-+ +-+ + +-+ + +-+-+ + + + + + +-+ + +-+ + + +-+-+ +-+ +-+
|   | | | | | |   | |   |       | | |   | |     | | | | | |   | |   | |     | |     |
+-+ +-+ +-+ + + + + +-+ + + + +-+ + + +-+ +-+ + + + + + +-+ +-+ + +-+ + + + +-+ + + +
|     | |   | | | |   | | | |   | | |   |   | | | | | |   |   | |   | | | | |   | | |
+ + + + +-+ +-+ +-+ + + + +-+ + + + + + + + + + +-+ + +-+ + +-+-+-+ + +-+ + +-+ + + +
| | | | |   |     | | | | |   | | | | | | | | |   | | |   |   |     | |   | |   | | |
+-+ + + +-+-+-+ + + +-+-+ +-+-+ +-+-+-+ + + + + + + + + +-+ + + + + + + + +-+ + + + +
|   | |   |     | | |     |         |   | | | | | | | | |   | | | | | | | |   | | | |
+ +-+ + + + +-+-+ +-+-+ +-+-+ + + + +-+ + + + +-+ + +-+ + + + + + + + + + +-+ + + + +
|   | | | | |     |     |     | | |   | | | | |   |   | | | | | | | | | | |   | | | |
+-+ + + +-+-+ + +-+-+-+ + + + + + +-+-+ +-+-+-+ + + + +-+ +-+-+ + + +-+-+-+ + +-+ + +
|   | |   |   |       | | | | | |   |     |     | | |   |     | | |     |   |   | | |
+ +-+ + + + +-+ +-+ + +-+-+ + + + + + +-+ + +-+ + + +-+-+-+ + + + +-+ +-+ +-+-+ +-+ +
|   | | | | |   |   |     | | | | | | |   | |   | |       | | | |   | |   |     |   |
+-+ + + +-+-+ + +-+ + + +-+ + +-+ + + + + +-+-+-+-+-+ +-+ + + +-+-+ + + + +-+ + +-+ +
|   | | |     | |   | | |   | |   | | | |           |   | | |   |   | | |   | |   | |
+ + +-+ +-+ +-+ + +-+ + +-+ + + + + + +-+ +-+ + +-+-+ +-+ +-+ + + + + +-+ + + + +-+ +
| |   |   |   | |   | | |   | | | | |   | |   | |       |   | | | | |   | | | | |   |
+ +-+ +-+-+ +-+ + + + + + + + + + + +-+ + + + +-+ + + + + +-+ + + + + +-+ + + + + + +
| |     |     | | | | | | | | | | |   | | | |   | | | | |   | | | | | |   | | | | | |
+ + + + + + +-+ + + + + + + + + + + + +-+ + + +-+-+ + + + + + + +-+ + +-+ + +-+ + + +
| | | | | |   | | | | | | | | | | | |   | | |     | | | | | | |   | |   | |   | | | |
+ +-+-+ +-+ +-+ + + +-+ + +-+ + + + + + + + + + +-+ +-+ + + + + +-+-+ + + + + +-+ + +
| |     |   |   | | |   |   | | | | | | | | | | |     | | | | |     | | | | |   | | |
+ +-+ + + +-+ + + +-+-+ + + + +-+ +-+ + + + + +-+ + + + + + + + + +-+ +-+-+ +-+ + + +
| |   | |   | | |   |   | | | |     | | | | | |   | | | | | | | | |   |       | | | |
+ + + + + + +-+ +-+ + + + + + + + +-+ +-+ + + + + +-+ +-+ + +-+ +-+-+ +-+ +-+ +-+-+ +
| | | | | | |   |   | | | | | | |   | |   | | | | |     | |   | |       | |       | |
+ + + +-+-+ +-+-+ +-+-+ +-+-+-+ +-+ +-+ +-+ + +-+ +-+ + + +-+ +-+ +-+-+ +-+ + +-+ + +
| | | |     |       |   |         |   |   | |   | |   | | |     |   |   |   | |   | |
+ +-+ + +-+ + + +-+-+-+ +-+-+ +-+ + + + +-+ +-+-+ +-+ + + + + +-+ +-+-+-+-+-+ + + + +
|   | |   | | |   |       |   |   | | | |       | |   | | | |   |   |         | | | |
+ +-+-+ + + + + + +-+ +-+-+ +-+-+ + +-+ + + +-+ + + + + + + +-+ +-+ + + +-+-+ +-+-+ +
|     | | | | | | |   |     |     |   | | | |   | | | | | | |     | | |     |     | |
+-+ + + + +-+-+ + + +-+ + + + +-+ + + + + + +-+ +-+ +-+-+ + + +-+-+ + +-+ +-+-+ + + +
|   | | |     | | | |   | | |   | | | | | | |     | |     | | |     |   |   |   | | |
+ +-+ + + + + + + + +-+ + + +-+ + + +-+ + + + + + + + + +-+-+ +-+-+ +-+ + + + +-+-+ +
|   | | | | | | | |   | | |   | | |   | | | | | | | | |     |   |     | | | | |     |
+ +-+ + +-+-+ +-+ + +-+ +-+ + +-+-+-+ +-+ + + + + +-+-+ + + + + +-+ +-+ +-+-+-+ +-+ +
|   | | |       | | |     | |       | |   | | | | |     | | | | |   |         | |   |
+-+ +-+-+-+-+-+ + + + +-+ +-+ + + +-+-+ + + + + +-+-+-+ + +-+ +-+ +-+ + + + +-+ +-+ +
|         |     | | |   |   | | | |     | | | |     |   | |   |     | | | |   |   | |
+ + +-+-+ +-+-+ + + +-+ + +-+-+ + +-+-+-+ +-+ + + + + +-+ +-+-+-+ +-+ + + +-+ + + +-+
| |   |       | | |   | | |     |       | |   | | | |   | |         | | |   | | |   |
+ + + + + +-+ + + + + + +-+-+-+-+ + + + + + + +-+ + +-+-+ + + + +-+ + +-+ + +-+-+ + +
| | | | |   | | | | | |   |       | | | | | | |   | |     | | |   | | |   | |     | |
+ + +-+-+-+-+ + +-+ + + + + + + + + +-+-+ + +-+ + + + + + +-+-+-+-+ +-+ + + + + + + +
| |     |     |   | | | | | | | | |   |   | |   | | | | |       |     | | | | | | | |
+ + + +-+-+-+ + + + + + +-+ + + + + + + +-+-+ +-+ + + +-+ + +-+ + + + +-+ + +-+ +-+ +
| | |     |   | | | | | |   | | | | | |     | |   | |   | | |   | | |   | |   | |   |
+ + + + + + + +-+ + + +-+ + +-+ +-+ + + + +-+-+ + + +-+-+ + + +-+-+-+-+ +-+-+-+ + +-+
| | | | | | |   | | | |   |   |   | | | |     | | |   |   | |       |         | |   |
+ + + + +-+ + +-+-+-+ +-+-+ + + + +-+ +-+-+ + + + + + +-+ + + +-+ + +-+-+ +-+ + + + +
| | | |   | |       |   |   | | | |     |   | | | | | |   | |   | |   |     | | | | |
+ +-+ +-+ + +-+ + +-+ + + + + + + + +-+ + + + + + + + + + +-+ + + + +-+ + +-+-+ +-+ +
|   |   | | |   | |   | | | | | | | |   | | | | | | | | |   | | | |   | | |     |   |
+ + +-+-+-+ + +-+ + +-+-+ + + + + + +-+-+ + +-+ + + + + +-+ + +-+-+ +-+ +-+-+ + + + +
| |       | | |   |     | | | | | | |     |   | | | | |   | |     | |   |     | | | |
+-+-+-+ + +-+ +-+-+ + + + + + + +-+ + + +-+-+ +-+-+-+ +-+-+ + + + + +-+-+ + +-+ + + +
|       | |     |   | | | | | |   | | | |     |       |     | | | | |     | |   | | |
+ + + +-+-+-+-+-+-+-+-+ + + + +-+ + + +-+ + + + + + +-+-+-+-+ +-+-+ + + + + + + + + +
| | |   |               | | |   | | | |   | | | | |       |       | | | | | | | | | |
+-+-+-+-+-+-+-+-+-+-+-+-+-+-+-+-+-+-+-+-+-+-+-+-+-+-+-+-+-+-+-+-+-+-+-+-+-+-+-+-+-+-+