+-+-+-+-+-+-+-+-+-+-+-+-+-+-+-+-+-+-+-+-+-+-+-+-+-+-+-+-+-+-+-+-+-+-+-+-+-+-+-+-+-+-+-+-+-+-+-+-+
| |         |                 |       |     |         |         |           |     |   |     |   |
+ +-+ + +-+-+ +-+-+-+-+ +-+-+ + +-+-+ + +-+ + +-+ +-+ + +-+-+-+ + +-+-+-+-+ + + + + + + +-+ + + +
|   | |         |       |     | |   | | | | | | |   |   |     | |     |   | | | | | |   |   | | |
+-+ +-+-+-+-+ +-+ +-+-+-+ +-+-+ + +-+ + + + + + +-+ +-+-+-+ + + +-+-+ + +-+ + + + + +-+-+ + + + +
|   |       | |   |   | | |   | | |   | | |       | |       | | |     | |   | | | |   | | | | | |
+ +-+ +-+-+ +-+ +-+ + + + + + + + + + + + +-+-+-+-+ + +-+-+-+-+ + +-+-+ + +-+-+ + +-+ + + +-+ + +
|   | |   | |   |   |   | | |   | | | | |   |       | |   |   |   |     |       | |     |     | |
+-+ + + + + + +-+-+ +-+ + +-+ +-+ + +-+ +-+ + +-+-+-+ + + + + +-+-+-+-+ +-+-+ +-+-+ +-+-+-+-+-+ +
|   | | | | | |   |   | |   |   | |         |   |       |   |               | |     | |         |
+ +-+ +-+ + + + + +-+ +-+-+ +-+ + +-+-+-+ +-+-+ +-+-+ +-+-+-+-+ +-+-+ +-+-+-+ + +-+-+ + + +-+-+ +
| |   |   | | | |   | |   | |   | |     | |   |     |     |   |     | |       |       | | |   | |
+ + +-+ + + + + +-+ + + + + +-+ + + +-+ +-+ + +-+-+ +-+-+ + +-+-+-+ + + +-+-+-+-+-+-+ + +-+ + + +
| | |   | | |     | | | | |   |   |   | |   | |   | |     |       | | |       |   |   |   | | | |
+ + + + +-+ +-+-+-+ + + + +-+ +-+-+-+ + + +-+ + + + +-+ +-+-+-+ + + +-+-+-+-+ +-+ + +-+-+ + + +-+
|   | |   | |   |   | | |             |   | |   | |   |       | | |         |   | | |   |   |   |
+-+-+ +-+ + + + + +-+ + +-+-+-+-+-+-+-+-+-+ +-+-+ + + +-+-+-+ +-+ +-+-+-+ + +-+ + + +-+ +-+-+ + +
|   | |   |   | |   |     |   |       |       |   | |   |   |     |       |   |   |   | |   | | |
+ +-+ + + +-+-+ +-+ +-+-+-+ + + +-+-+ + +-+ + + +-+ +-+ + + +-+-+ + +-+-+ +-+-+ +-+-+ + + + +-+ +
|     | | |   |   |   |     | |     | |   | | |   |   | | |     | | |   | |   | |     | | |     |
+ +-+-+ +-+ + +-+ + + + +-+-+ + +-+ +-+-+ + +-+-+ +-+-+ + +-+-+ + + + + +-+ + + + +-+-+ + +-+-+ +
| |   |     |   | | | |   |   |   |       |     |       |     | | |   |     |   | |     | |   | |
+ + + +-+-+-+-+ + +-+ + +-+ +-+-+ +-+-+-+-+-+-+ +-+-+-+-+-+ + +-+ +-+-+-+-+-+-+-+ +-+ + + + + + +
| | |   |   |   |   |   |   |   |         |     |         | | |   |   |       |   |   | |   | | |
+ + +-+ + +-+ +-+-+ + +-+ +-+-+ +-+-+-+ +-+ +-+ + + +-+-+ +-+ + +-+ +-+ +-+-+ + +-+ +-+ +-+-+ + +
|   | | |   |       |   |     |         |   | | | | |   |   | |     |   |   | |     | | |   | | |
+-+-+ + + + +-+-+-+-+-+ +-+-+ + +-+-+-+-+ +-+ + + + + + +-+ + +-+-+ + +-+ +-+ +-+-+-+ + +-+ + +-+
|     | | |   |       |   |   |   |       |     | |   |   |   |     | |   |       |         |   |
+ + + + +-+ + +-+ +-+ + +-+ +-+-+ + +-+-+-+ +-+-+-+-+-+-+ +-+-+ +-+-+ +-+ + +-+-+-+ +-+-+-+ +-+ +
| | | |     |   |   |   |   |   | | |   |                 |     |         |         |   | | |   |
+ + + +-+-+-+-+ +-+ +-+-+ +-+ + +-+ + + + +-+-+-+ +-+-+-+-+ +-+-+ +-+-+-+-+-+ +-+-+-+ + + + + +-+
| | |     |   | | |   | | |   |   | | | | | |   | |         |   | |   |     |   |   | | |   |   |
+ + +-+-+ +-+ + + +-+ + + + +-+-+ + +-+ + + + + +-+ +-+-+ +-+ + + +-+ + +-+ +-+-+ + + + + +-+-+ +
| |   |       | |   | | |   |     |   |     | |     |   |   | | |   | |   |       |   | | |     |
+ +-+ +-+-+-+ + + + + + +-+-+ +-+-+ + + +-+-+ +-+-+-+ + +-+-+ + +-+ + +-+ +-+-+ +-+-+-+ +-+ +-+ +
|   |     |   | | | |       |   |   | | |     |     | |       |   | |   |     | |     |     |   |
+-+-+-+-+ + +-+ +-+ +-+-+-+ +-+ +-+-+ +-+ +-+-+-+ + + +-+-+-+-+ +-+ + + +-+-+ +-+ +-+ +-+-+-+ +-+
|     |   | |   |   |     | | | |   |   |   |     | |       |   |   | | |   |   |   | |         |
+ +-+ + +-+-+ +-+ +-+ +-+ + + + + + + + +-+ + +-+-+ +-+-+-+ + +-+ +-+ + + + +-+ +-+ + +-+-+-+-+ +
|   | |   |   |   |   | |   | | | | | |       |   | | |     |     |   |   |   |   | |   |     | |
+ + + +-+ + +-+-+ + +-+ +-+-+ + + + + +-+-+-+-+-+ + + + +-+-+-+-+-+-+-+-+-+-+ +-+ + +-+ + +-+ + +
| | | |   |   |   | |         | | | |   |   |     |   |   |     |     |   |   | |     | | |   | |
+ + + + +-+-+ + +-+ + + +-+-+-+ + + +-+-+ + +-+ + +-+ +-+ +-+-+ + + + + + + + + +-+-+-+ + + +-+-+
| | |   |     | |   | |   |   |   |   |   |   | |   |   |     |   | |   | | |     |   | | |     |
+ + +-+ + +-+-+ + +-+ +-+ + + +-+-+-+ + +-+-+ + +-+ +-+ +-+-+ + +-+ +-+-+ + +-+-+-+ + + + +-+-+ +
| |   | |   |   | | | | |   |       |   |     |   | | |     | |   |     | |     |   | |       | |
+ +-+ +-+-+ +-+ + + + + +-+-+-+ +-+-+-+-+ +-+-+ + + + +-+ +-+ +-+-+-+-+ + +-+ + + +-+ + +-+-+-+ +
| |   |   |   |   |       |   |         | |   | | |   |   |             |   | | | |   | | |     |
+ + +-+ + +-+ + +-+ +-+-+-+ + + +-+ +-+ + +-+ + + +-+-+ +-+ +-+-+-+-+-+-+-+ +-+ + + +-+ + + +-+ +
| | |   |   | | | | |   |   | | |   |   |   |   |       |   |   |         |   | | | |     |   | |
+ + + +-+-+ + + + + + + + +-+ +-+ +-+ +-+-+ +-+-+ +-+-+-+ +-+ + +-+ +-+-+-+-+ + + + +-+-+-+-+ +-+
| |   |     | | | | | |   |   |   |   |     |   | |     |   | |   |           | | |         |   |
+ +-+-+ + +-+ + + + + +-+-+-+ + +-+-+ + +-+-+ + +-+ +-+ +-+ + +-+ + +-+-+-+ +-+ + +-+-+-+-+ + + +
|   |   | |   | | | |   |   |   |   | |       |     |   |   | | | |   |   |     |     |   | | | |
+-+ + +-+-+ +-+ + + +-+ + + +-+-+ + + +-+-+ +-+-+-+ + + + +-+ + + +-+-+ + + +-+-+-+ + + + + + + +
| | |   |   |   |   | |   |       | | |   | |     | | | |   | | | |     | | |     | | | | | | | |
+ + +-+ + +-+ +-+ +-+ +-+-+-+-+-+-+ + + + + + +-+ + + +-+-+ + + + + +-+-+ +-+ +-+ +-+ +-+ + +-+ +
|   |   | | |   |     |           | | | | | | | | | |   |   | |     |   | |   | |   |   |   |   |
+ +-+ +-+ + +-+ +-+-+ +-+-+ + +-+-+ + + + +-+ + + +-+-+ + +-+ +-+-+-+-+ + + +-+ +-+ +-+ + +-+ + +
|   |   | |     |           | |     | | |   | | |     | |   |   |       |   |     | |   |   | | |
+ +-+-+ + +-+-+ +-+-+ +-+-+-+ + +-+-+ + +-+ + + +-+-+ + +-+ +-+ +-+-+ +-+-+-+ +-+-+ + +-+-+ + + +
| |     |     |     | |     | | |   | | | | | |     | |       |     |   |           |     |   | |
+ + +-+-+-+-+ +-+-+ +-+ +-+ +-+ + + + + + + + + +-+-+ +-+-+-+ +-+-+ + + + +-+-+-+-+-+-+-+ +-+-+ +
| |   |     | |         |       | |   | | | | |           |   |   | | |                 | | |   |
+ +-+ + +-+ + +-+-+ +-+-+-+-+-+-+-+-+-+ + + + +-+-+-+-+-+ + +-+ + + +-+-+-+-+-+-+-+-+-+ + + + +-+
|   |   |   |     | |               |   | |   |       |   |   | | |       |           | | |     |
+ +-+-+ + +-+-+-+ +-+ +-+-+-+-+-+-+ + +-+ +-+ + +-+-+ + +-+-+ + + +-+-+-+ +-+-+-+ +-+-+ + +-+-+ +
| |   | |       | |   |           | | |       | |   | | |   |   |       | |     |       |   |   |
+ + + +-+-+-+ + + + +-+-+ + +-+-+-+ + +-+ +-+-+ + +-+ + + + +-+-+-+-+-+ + + +-+ +-+-+ +-+-+ + +-+
| | | |       | |   |   | | |   |   |   |     |   |   |   |     |     | |   | |     | |     |   |
+-+ + + +-+-+-+ +-+-+ + + + + + + +-+ + +-+-+-+-+ + +-+-+-+-+-+ + + +-+ +-+-+ +-+-+ + +-+ +-+-+ +
|   |   |     |       |   | | |   |   |           | |   |       | |   | |   |     | |   | |   | |
+ + +-+-+ + +-+-+-+-+-+-+-+ + +-+-+ +-+-+-+-+-+-+-+ + +-+ +-+-+-+ +-+ + + + +-+ + + +-+ + +-+ + +
| | |   | |   |         |   |     |   |   |         | |   |         |     |     | |   |   |   | |
+ +-+ + + +-+ + + +-+ +-+ +-+-+-+ +-+ + + + +-+-+-+-+ + +-+-+-+-+-+-+-+-+-+-+-+-+ +-+ +-+-+ +-+ +
|     | | | |   |   | |   |     | |     | | |   |     | |   |         |     |   | |   | |   |   |
+ +-+-+ + + +-+-+-+ +-+ +-+-+ +-+ +-+-+-+-+ + +-+ +-+ + + + + +-+-+-+ +-+ + + + + + +-+ + + + +-+
| |     |   |     |   | |     |   |   |     |   | | |   | |   |     |   | |   |   | |     | |   |
+-+ +-+-+ +-+ +-+ + + + + +-+ + +-+ + + +-+-+ + + + +-+-+ +-+-+ +-+-+-+ +-+-+-+-+-+ +-+-+-+ +-+ +
|   |     |   | | | | | | |   |     |   |     | |   |   |   |         |           | |     | |   |
+ +-+-+-+ + +-+ + + + + + +-+-+-+-+-+-+-+ +-+-+ +-+ + + +-+ + +-+-+-+ +-+-+-+-+-+ + + +-+ + + +-+
| |     | |     | | |     |     |     | | | |   |   | |     |   | |   |         | |   | | | | | |
+ + +-+ + +-+-+ + +-+-+-+-+ +-+ + + + + + + + +-+ +-+ +-+-+-+-+ + + + + + +-+-+-+ + +-+ + + + + +
|   |   | |     | |     |   | |   | |   |   | |   | |   |   |   | | | | |       | |     | |   | |
+ +-+ + +-+ +-+-+ + +-+ + +-+ +-+-+ +-+ +-+ + + +-+ + + +-+ + +-+ + +-+ +-+-+-+ + +-+-+ + +-+ + +
|   | | |   |   |   | | |   |     |   | |   | |   |   |   | |   | |   |       |   |   | |   |   |
+-+ + + + +-+ + +-+-+ + +-+ + +-+-+-+ +-+ +-+ +-+ +-+ +-+ + +-+ + +-+ +-+-+-+ +-+-+ + + +-+ +-+-+
|   | | |     | |     |     |       |     |     |   |   | | |       |   |     |     | |   |     |
+ +-+ +-+-+-+-+ + +-+ +-+-+-+-+ + + +-+-+-+ +-+-+-+ + +-+ + + +-+-+-+-+ + +-+-+-+ +-+ +-+-+-+-+ +
| |   |       |   | | |       | | | |     |       | | |   |     |   |   |         | |         | |
+ + +-+ + + +-+-+-+ + +-+ + + + + +-+ + +-+-+-+ +-+ + + +-+-+-+-+ + + + +-+-+-+-+-+ +-+-+-+-+ + +
| |   | | | |       |   | | | | |     | |       |   | | |         |   | |       |   |       |   |
+ +-+ + + +-+ +-+ +-+-+ +-+ + +-+-+-+-+ + +-+-+-+ +-+-+ +-+ + +-+-+-+-+ + +-+ +-+ + + + +-+-+-+ +
| | |   |   |   |   |   |   | |       | |   |     |   |   | | |       | |   | |   | | |         |
+ + +-+-+-+ +-+ +-+ + +-+ +-+ + +-+-+ + +-+ + +-+-+ + +-+ + +-+ +-+-+ +-+-+ + + +-+ + +-+-+-+-+-+
|         |       |       |     |         |         |     |         |       |     |             |
+-+-+-+-+-+-+-+-+-+-+-+-+-+-+-+-+-+-+-+-+-+-+-+-+-+-+-+-+-+-+-+-+-+-+-+-+-+-+-+-+-+-+-+-+-+-+-+-+