+-+-+-+-+-+-+-+-+-+-+-+-+-+-+-+-+-+-+
|                                   |
+ + +-+ +-+ +-+-+-+ +-+-+-+-+ + + + +
| |   |   |       |     |     | | | |
+-+ + + + +-+ +-+ + +-+ +-+ + + + + +
|   | | | |     | |   | |   | | | | |
+ + + + +-+ + + + + + + + + +-+-+-+ +
| | | | |   | | | | | | | |       | |
+-+ +-+-+-+-+-+ +-+ + +-+ +-+ +-+ + +
|   |           |   | |     | |   | |
+ +-+-+-+ + + + + +-+ + +-+ + +-+ + +
|       | | | | | |   |   | |   | | |
+ + + +-+ + + + + + +-+ + +-+-+-+ + +
| | | |   | | | | |   | | |       | |
+ + +-+ + + +-+-+ + + + + +-+ +-+-+ +
| |   | | |     | | | | |   |     | |
+-+ +-+-+ +-+ + + + + + + +-+ +-+ + +
|       | |   | | | | | |   | |   | |
+ + +-+ + +-+ + + +-+-+-+ + + + + + +
| |   | | |   | |   |     | | | | | |
+-+-+-+ + + + + + +-+ + +-+-+-+-+ + +
|       | | | | |   | |       |   | |
+ + + + + + + +-+ +-+ +-+ + +-+ + +-+
| | | | | | |   |   | |   |   | |   |
+ +-+ + +-+ + +-+-+ + + +-+ + +-+-+ +
|   | | |   |   |   | |   | |   |   |
+ + + + +-+ +-+ + + + + + +-+-+-+ + +
| | | |   |   | | | | | |       | | |
+-+ + + + +-+ + + + +-+ +-+ + + + +-+
|   | | |   | | | |   |   | | | |   |
+ + + +-+ +-+ + +-+ +-+ +-+ + +-+ + +
| | |   |   | |   | |   |   |   | | |
+ + + + + + + + +-+ + + +-+-+ +-+-+ +
| | | | | | | |   | | | |         | |
+ +-+-+ +-+ + +-+ +-+ +-+-+ +-+-+ + +
|     | |   |   | |     |     |   | |
+-+-+-+-+-+-+-+-+-+-+-+-+-+-+-+-+-+-+