+-+-+-+-+-+-+-+-+-+-+-+-+-+-+
|                           |
+ + +-+ + + +-+ +-+ + +-+ +-+
| |   | | |   |   | |   |   |
+ +-+-+ +-+ +-+ +-+ +-+-+ + +
|     |   |   |   |     | | |
+ + + + + +-+ +-+-+-+-+-+ + +
| | | | |   |           | | |
+ + +-+-+-+ + + + +-+-+-+ + +
| |       | | | |       | | |
+ + + + + +-+-+-+-+ +-+ + + +
| | | | |         |   | | | |
+ +-+-+ + +-+ +-+ +-+ + + + +
|     | |   |   |   | | | | |
+ + + + +-+ +-+-+-+-+-+-+ +-+
| | | |   |             |   |
+ +-+-+-+-+-+ + +-+-+-+-+ +-+
|           | |         |   |
+ + +-+ +-+ +-+ +-+ + +-+ +-+
| |   |   |   |   | |   |   |
+ +-+-+ + +-+ +-+ + + +-+-+-+
|     | |   |   | | |       |
+ + +-+ + +-+ + + +-+ + + +-+
| |   | |   | | |   | | |   |
+ + + + +-+-+ + + + +-+-+-+ +
| | | |     | | | |       | |
+ +-+ + + +-+-+-+-+-+-+-+ +-+
|   | | |               |   |
+-+-+-+-+-+-+-+-+-+-+-+-+-+-+