+-+-+-+-+-+-+-+-+-+-+-+-+-+-+-+-+-+-+-+-+-+-+-+-+-+-+-+-+-+-+-+-+-+-+-+-+-+-+
|                                                                           |
+ + + + + + + +-+ + +-+ +-+-+ + + +-+ + + +-+ +-+-+ + + +-+-+ +-+ + + +-+ + +
| | | | | | |   | | |     |   | | |   | |   |     | | |     |   | | | |   | |
+-+ +-+ + + +-+-+ + + +-+ +-+ +-+-+ +-+ + +-+ + +-+ + +-+ +-+-+-+ + +-+ +-+ +
|   |   | | |     | |   | |   |       | |   | |   | | |     |     | |     | |
+ + +-+-+-+-+-+-+ + + +-+ + + + + + + + +-+ + + +-+ + + +-+ + +-+ +-+ +-+-+ +
| | |             | | |   | | | | | | |   | | | |   | |   | |   |   |     | |
+ +-+ + + +-+-+-+ + + + + + + + + + + +-+-+-+ +-+-+ + + + + + +-+ +-+-+ + + +
| |   | |     |   | | | | | | | | | | |         |   | | | | |   |   |   | | |
+ + + + + +-+ + + + +-+ +-+-+ + + + + + + + +-+ + +-+ +-+ +-+-+ + + +-+-+ +-+
| | | | |   | | | | |   |     | | | | | | |   | | |   |       | | | |       |
+ +-+ + +-+-+ +-+-+-+ + +-+-+ +-+ +-+ +-+ +-+ + + +-+-+ + + + +-+ + + + + + +
| |   |     |     |   |     |   |   |   |   | | |   |   | | | |   | | | | | |
+ + +-+-+-+ + + + + +-+-+ + + + +-+-+ +-+ + + + +-+ + + + + + + + + +-+ +-+ +
| |     |   | | | | |     | | |   |   |   | | |   | | | | | | | | |   |   | |
+ +-+ + +-+ + +-+ + + + +-+ +-+-+ + +-+-+-+ +-+ +-+-+ + + + + +-+ + +-+ +-+ +
|   | | |   | |   | | |   |   |   | |       |       | | | | | |   | |     | |
+-+-+ + + + + + + +-+ +-+ + + + +-+-+-+-+-+-+ +-+ + + + + + + + + + + + +-+-+
|     | | | | | | |     | | | |   |             | | | | | | | | | | | |     |
+ + + + +-+ + + + + +-+ + + + + + +-+ +-+ + + + +-+ + + + +-+ + + +-+ +-+ + +
| | | | |   | | | | |   | | | | | |     | | | | |   | | |   | | | |     | | |
+-+ + + + + + + + + +-+-+ + + + + + + +-+ + + + + + + +-+-+ + + +-+ +-+ + + +
|   | | | | | | | |   |   | | | | | | |   | | | | | |   |   | |   |   | | | |
+ + + + + + +-+ + + +-+ + + + + + + +-+ + + + +-+ +-+ + + + + + + + +-+ +-+ +
| | | | | |   | | | |   | | | | | | |   | | |   | |   | | | | | | |   |   | |
+ + +-+-+ + +-+ +-+ + + +-+-+-+ +-+ + +-+ + +-+-+ + +-+ +-+ + + + + + +-+ +-+
| |   |   | |   |   | |       |   | |   | |     | | |     | | | | | | |     |
+ + +-+ + + + +-+ + +-+ + + + + +-+ +-+ +-+-+-+ + + +-+ + + +-+-+ + +-+-+ + +
| | |   | | |   | |   | | | | | |   |         | | | |   | |   |   | |     | |
+ +-+-+ +-+ + +-+ +-+ + + +-+ + + + + + +-+ +-+ + + +-+-+ + +-+ +-+ +-+-+ + +
|   |     | | |   |   | |   | | | | | |   | |   | |     | |   | |       | | |
+ + + +-+ +-+-+ + +-+-+ + + + + +-+ + + + +-+ + + + + + +-+ + +-+ + + +-+-+ +
| | | |   |     |   |   | | | |   | | | | |   | | | | |   | | |   | |     | |
+ + + +-+ + + + + +-+ + +-+-+ + +-+ + + + + + + +-+-+ + + + + + + + +-+ + + +
| | | |   | | | |   | |     | |   | | | | | | |   |   | | | | | | | |   | | |
+ + + + +-+ + +-+ + +-+-+ + +-+ + +-+ + + + + + +-+-+ + +-+-+ +-+ + + +-+ +-+
| | | | |   | |   | |     |   | |   | | | | | |   |   | |     |   | | |     |
+ + + +-+ +-+ + +-+ + + +-+-+ + + + + + + + + +-+-+ + + +-+ +-+ +-+ +-+ + + +
| | | |     | | |   | |   |   | | | | | | | | |     | |   | |   |   |   | | |
+ + + + +-+ +-+ + + + +-+ + +-+ + + + +-+-+ + +-+ + + + + +-+ + +-+ +-+ +-+ +
| | | | |     | | | |   | |   | | | |     | |   | | | | | |   | |     | |   |
+ + +-+ +-+ + +-+-+ + + + + +-+ +-+ + + + +-+ + + +-+ +-+-+ +-+ +-+ + + + + +
| | |   |   | |     | | | | |     | | | | |   | | |       |   | |   | | | | |
+ + +-+-+ + + + + + + +-+ + + + + + +-+ + + + + + + + +-+-+-+ + +-+ + +-+ + +
| |   |   | | | | | | |   | | | | |   | | | | | | | | |       |   | |   | | |
+ +-+ + + + + + +-+-+ + +-+ + + + + + +-+ +-+ +-+ + +-+ +-+ + + + + +-+ +-+ +
|   | | | | | |   |   |   | | | | | |   | |     | |   |   | | | | |   | |   |
+ +-+ + + + +-+ + + +-+ +-+ + + +-+ + + +-+-+-+-+ + +-+ + + + +-+ + + + +-+-+
|   | | | |   | | |   |   | | |   | | |     |     | |   | | |   | | | |     |
+ + + + +-+ + +-+ + +-+-+ + +-+-+ +-+ + + + + + +-+ +-+ + + + + + +-+ + + +-+
| | | | |   |   | |     | |     |   | | | | | |   |   | | | | | |   | | |   |
+ +-+ + +-+-+ +-+ + + +-+ + + + +-+-+ + + +-+ + + + + +-+-+-+-+ + + + + + + +
|   | |     |   | | | |   | | |     | | | |   | | | |       |   | | | | | | |
+ + +-+ + +-+ + +-+ +-+ +-+ + +-+ + + + + + + +-+ +-+-+ +-+ + +-+ + + + + +-+
| | |   |   | | |     | |   | |   | | | | | | |   |       | |   | | | | |   |
+ + + +-+-+-+ + + + + +-+ +-+ + + + + +-+ + +-+ + + + +-+ + +-+-+ + +-+-+-+ +
| | |       | | | | | |   |   | | | |   | |   | | | |   | |     | |     |   |
+ + + +-+-+ +-+-+-+ +-+ +-+ + + +-+-+ +-+ +-+ + + + +-+-+ + +-+ + +-+-+ +-+ +
| | |     |   |     |   |   | |     |   |   | | | |     | | |   | |       | |
+ +-+ +-+ + + + +-+ +-+ +-+ + + +-+ +-+ +-+-+ +-+ + +-+-+-+ + +-+ + + +-+-+ +
| |     | | | |   | |     | | | |   |     |     | |       | |   | | |     | |
+ +-+ +-+ +-+ + + + +-+-+ + + + + +-+ +-+ +-+-+-+ +-+ +-+ + + +-+ + + +-+ + +
| |   |   |   | | |     | | | | | |   |         |   |   | | | |   | |   | | |
+ +-+ + + +-+-+ + +-+-+-+-+-+ + +-+ + + +-+-+ + +-+ +-+-+ + + + + + +-+-+ + +
|   | | |   |   |         |   | |   | |   |   |   |     | | | | | | |     | |
+ + + +-+ + + +-+ + + +-+-+ + +-+ + +-+ + + + +-+ +-+ +-+ +-+-+-+-+ +-+-+ + +
| | |   | | | |   | |   |   | |   |   | | | |   |   | |       |     |     | |
+ +-+ + + + + +-+ + + + +-+-+ +-+ +-+ +-+ + + + +-+ + + +-+ + + + +-+ + +-+ +
| |   | | | | |   | | |     |   |   | |   | | |   | | |   | | | | |   |   | |
+ + + + + + +-+ + + + + + + + +-+-+ +-+ + + + + + + + +-+ +-+ +-+-+-+ +-+ + +
| | | | | | |   | | | | | | |     |   | | | | | | | | |   |   |         | | |
+ + + + +-+ + + + + + +-+ + + +-+ + + + + + +-+ + + + + + +-+ + +-+-+ + +-+ +
| | | | |   | | | | | |   | | |   | | | | | |   | | | | |   | | |     |   | |
+-+ +-+ +-+ + + + + +-+-+ + +-+ +-+ + +-+-+ +-+ + + + + +-+ +-+-+ + + + + + +
|     | |   | | | |     | | |     | |   |     | | | | |   | |     | | | | | |
+-+-+-+-+-+-+-+-+-+-+-+-+-+-+-+-+-+-+-+-+-+-+-+-+-+-+-+-+-+-+-+-+-+-+-+-+-+-+