+-+-+-+-+-+-+-+-+-+-+-+-+-+-+-+-+-+-+-+-+-+-+-+-+-+-+-+-+-+-+-+-+-+-+-+-+-+-+-+-+-+-+-+-+-+-+-+-+-+
|   |                 |     |           |       |   |     |         |       |   |       |     |   |
+-+ + +-+ +-+-+-+-+-+ +-+ + + +-+-+ +-+-+ +-+ + + +-+ +-+ + +-+ +-+ + +-+-+ + + +-+ +-+-+ + + +-+ +
| | | |   | |       |   | |     | |       | | | |       |   | | |     |       |     |     | |   | |
+ + +-+ +-+ + +-+ +-+-+ +-+-+-+ + +-+-+-+-+ + + +-+-+-+ +-+-+ + +-+-+-+ +-+-+-+-+ +-+ +-+-+ +-+ + +
| |   |   | |   |     |     | |     |       | | |   |         | |     | |     |   |   |   |   |   |
+ +-+ +-+ + +-+ +-+ +-+-+-+ + +-+-+ +-+ +-+-+ + + + +-+-+-+-+ + + +-+ +-+ +-+ + +-+ +-+ + +-+ +-+-+
|   |     |   |   |     |   |     |   | |     |   |       |   |   |   |   |   |   | | | |   |     |
+ +-+-+-+-+-+ +-+ +-+-+ + +-+ +-+ +-+ + + +-+-+-+-+-+-+-+ +-+-+-+ + + + +-+ +-+ +-+ + + + +-+-+-+ +
|         |   |   |   |   |   | | |   | |   |             |     | | | |   | |   |   |   |     |   |
+ +-+ +-+ + + + +-+ +-+-+-+ +-+ + + +-+ +-+ +-+-+-+ +-+-+ + +-+ +-+ +-+-+ + +-+-+ +-+-+ +-+-+ + + +
|   | |   | | | |         | |   |   |     | |     | |   |   |     |       | |     |   | | |   | | |
+-+ + +-+ + + + + +-+-+-+ + + + +-+-+ + +-+ + +-+ +-+ + +-+-+-+-+ +-+-+-+ + + +-+-+ + + + + +-+ + +
| | |   |   | | | |     |   | | |     | |   | | |     |         |       | |   |     | |   | |   | |
+ + +-+ +-+-+-+ + +-+ + +-+-+ + +-+-+ + + + + + +-+-+-+-+-+-+-+ +-+-+-+ +-+-+ +-+ +-+ +-+-+ + +-+ +
|   | |         | |   |       | |     | | | |   |     |       |   |   |     |   | | |       |   | |
+ +-+ +-+-+-+-+-+ + + +-+-+-+-+ + +-+-+-+ +-+-+ + +-+ + +-+ + +-+ + +-+-+-+ +-+ + + +-+-+-+ +-+ + +
|   | |           | | |       | |       |     | |   |   |   |   | | |     | |   | |   |       | | |
+-+ + + +-+-+-+-+-+ + + +-+-+ + +-+ +-+ +-+ + + +-+-+-+-+ +-+-+-+ + + +-+ + +-+ + +-+ + +-+-+-+ + +
|   | | |       |   | |     | |   | |   | | | |           |       |   |   |   | | |   | | |     | |
+ +-+ + +-+ +-+ +-+ + +-+-+ + +-+ +-+ + + + +-+ +-+-+-+-+-+ +-+-+-+-+-+ + +-+ + + + +-+ + + +-+-+ +
| |   |   | |     | | |   | |   |   | | | |     |     |   | |         | | | | |   |     | |     | |
+ + +-+-+ + +-+-+ + +-+ + + +-+ +-+ + + + +-+-+-+ +-+ + + + +-+-+ +-+ + + + + +-+-+ +-+-+ +-+-+ +-+
| |     | |     |   |   |   |     |   | |   |   | | |   |   |     |     |   |   |         |   |   |
+ +-+ +-+ + +-+ + +-+ +-+-+-+-+-+ +-+-+ + + +-+ + + +-+-+-+-+ +-+-+-+ +-+-+-+-+ + +-+-+-+-+ + +-+ +
|   |   | |   | | |   |   |   |       |   |     | |         |       | |       | | |         |   | |
+-+ + + + +-+ + +-+ +-+ + + + +-+-+-+ + +-+-+-+-+ + +-+-+ +-+ +-+-+ +-+ +-+-+ + +-+ +-+-+-+-+-+ + +
| | | |   | | |   |     | | | |   |   | |     |   | |     |   |   |     |     |     | |       | | |
+ + +-+ +-+ + +-+ +-+-+ + + + + + +-+ +-+ +-+ + +-+ +-+ +-+ +-+ + +-+-+-+ +-+-+-+-+-+ + + +-+ + + +
| |   | |   | |   |   | |   | | |   |     | |   |     |   | |   |   | |   |         |   |   | | | |
+ +-+ + + + + + +-+ + +-+-+-+ + +-+ +-+-+-+ +-+-+ +-+ +-+ + +-+-+ + + + +-+ + +-+ +-+ +-+-+ +-+ + +
|   | | | |   |   | |       | |   | |         | |   | | | | |     |   |   | |   | |   |   |     | |
+ +-+ + +-+-+-+-+ + +-+-+-+ + +-+ + + +-+ +-+ + +-+ + + + + + +-+-+-+ +-+ + +-+ + + +-+ +-+-+-+-+ +
|     |         | | |       |     | | |   |   | |   | |   |   |       |   | |   | |   |       |   |
+ +-+-+-+-+-+-+ + + + +-+-+ +-+-+-+ +-+ +-+ +-+ + +-+ +-+-+-+-+ +-+-+-+ + + + +-+-+-+ + +-+ + + + +
|   |     | |   | | | |   |       | |   | |   |     | |           |     | | | |       |   | | | | |
+-+ + +-+ + + +-+ + +-+ + +-+-+-+ + + +-+ +-+ + +-+-+ + +-+-+-+-+-+ +-+-+-+ + + +-+-+-+-+-+ + +-+ +
|   | |   |   |   |     |   |   | | |   |   | | |     | |   |       |       |   |           |   | |
+ +-+ + +-+-+ + + +-+-+-+-+ + + + + +-+ + +-+ +-+ +-+-+ +-+ + +-+-+ + +-+-+-+-+-+ +-+ + +-+-+-+ + +
| |   |     |   |   |       | |   | |   |   |     |   |   | | |     |       |   | |   | |     |   |
+ +-+ +-+-+ +-+-+ +-+ +-+-+-+ +-+-+ + +-+ + +-+ +-+ + +-+ + + +-+ +-+-+-+-+ + + +-+ +-+-+ +-+ +-+ +
|     |   | |   | |   |       |     | |   |     |   |     | |   | |     |   | |   |     | | | |   |
+-+-+-+ + + +-+ + + +-+ +-+-+-+-+ +-+ +-+-+ +-+-+ +-+-+-+-+ +-+ + +-+ +-+ +-+ +-+ +-+-+ + + + + +-+
|       | |   | | | | |       |   |       | | |   |     |     | |     |   |     | |   | |   | | | |
+ +-+-+-+-+-+ + + + + +-+-+-+ + +-+ +-+-+ + + + +-+ +-+ +-+ + + +-+-+ + +-+-+-+ + + + + +-+ + + + +
| |         | | | | | |     |   |   |     |   |     | |     | |   | | | |       | | | |     | |   |
+ + +-+-+-+ + + + + + + + +-+-+-+ +-+ +-+-+-+ +-+-+-+ +-+-+-+ +-+ + + + + + +-+-+ + + + +-+-+ +-+-+
|   |   |   | | | | |   |       | | |       |             | | | | |   | | |   | |   | |     |     |
+ +-+-+ + + + + + + + +-+-+ +-+-+ + +-+-+-+ +-+-+ +-+-+-+ + + + + +-+-+ +-+-+ + +-+-+ +-+-+ +-+-+ +
|       | | | |   | |     |         |     | | |   |     |   |   |       |     |     | |     |     |
+ +-+-+ + +-+ + +-+ +-+-+-+ +-+-+-+-+ +-+ + + + +-+ +-+ +-+ +-+ +-+-+-+-+ + +-+-+-+ + +-+-+-+ +-+ +
| |   | |   | |   |       | |   |   | |   | | |   | |   | |   | |   |     | |     | |       | | | |
+-+ + +-+-+ + +-+-+ +-+-+ + + + + + + + +-+ + +-+ + + +-+ +-+ + + + + +-+ + + +-+ + +-+-+-+ + + + +
|   |       | |   | |   | | | |   |   |     |     | |   |     | | | | |   | |   | |       |   | | |
+ +-+-+-+-+ + + + + +-+ + + + + +-+-+-+-+-+-+-+-+-+ +-+ +-+ +-+ + + +-+ +-+-+-+ + + +-+-+-+-+-+ + +
|   | |   | | | | | |   | | | | |     |       |   | | |   |   | | |     |       | |   |     |   | |
+ + + + + + + + + + + +-+ +-+ +-+ +-+ + +-+-+ + + + + +-+ +-+-+ + +-+-+-+ +-+-+-+ +-+ + + +-+ + + +
| | | | |   |   | | |   |   |     | |   |   |   |   |   |     | | |     | |       |   | |     | | |
+ + + + +-+-+-+-+ + +-+ +-+ + +-+-+ +-+-+-+ +-+-+-+-+ +-+-+ + + + + +-+ + + +-+-+-+ + + +-+-+-+ + +
| | | |   |   |   | |   | | |                     |   |   | |   | |   | | |   |     | | |   | |   |
+-+ + +-+ +-+ + +-+ + + + + +-+-+-+-+-+-+-+-+-+-+ + +-+ + + +-+-+ + +-+ + +-+ +-+-+ + + + + + +-+-+
|   |         | |     | | |     |           |   |   |   | |   |   | |   |   |     | | | | |     | |
+ +-+ +-+-+-+ + +-+-+-+ + +-+-+ + +-+-+-+-+ + + +-+ + +-+ +-+ + + + + +-+-+ +-+-+ + +-+ + +-+-+ + +
| |   |   |   | |   |       | |   |       | | |   | | | | | |   | | |   |     |   |   |   |   | | |
+ +-+-+ + +-+-+ + + + +-+-+ + +-+-+ +-+-+ + + +-+ + + + + + +-+-+ + +-+ + +-+-+ +-+-+ +-+-+-+ + + +
|     | |   |   | | | |   |       |   |   | | | | | | | | | |   | | | | | |     |   |     |   | | |
+ +-+ + +-+ + +-+ + +-+ + +-+-+-+ +-+ +-+-+ + + + +-+ + + + + + + + + + + + +-+-+ + +-+ + + + + + +
| | |   |   | |   |   | |     | |   | |   | |   |   | | | |   |   | | |   |     | |     | | | |   |
+ + +-+-+ +-+ + +-+-+ + +-+-+ + +-+ + + + + +-+ +-+ + + + + +-+-+-+ + +-+-+-+-+ + +-+-+-+ + +-+-+ +
| |   |   |   | |   | | |     |   | |   | | |     |     | |   |               | | |         |     |
+ +-+ + +-+ +-+ + + + + + +-+-+ +-+ + +-+ + + +-+-+-+-+-+ + +-+ +-+-+-+-+-+ +-+ + +-+-+-+-+-+ +-+-+
|     |   |   |   | |   | |         |   | |   |   |       | |     |   |   | |   | |           |   |
+-+-+-+-+ +-+ +-+-+ +-+-+ +-+ +-+-+ +-+-+ +-+-+ + + +-+-+ +-+ +-+-+ + + +-+ + +-+ + +-+-+-+-+-+ +-+
|           |       |   |   | |   |       | |   | | |     |   |     | |   | | |   | | |       |   |
+ +-+-+-+-+ +-+-+-+-+ + +-+ +-+ + +-+-+-+ + + +-+ + +-+-+-+ +-+ +-+-+ +-+ + + +-+ + + + +-+ + +-+ +
| |   |   | |     |   |   | |   | |         | | | |         |   |   |   |   |   |   |   |   |     |
+ + +-+ + + + +-+ + +-+ +-+ + +-+ +-+-+-+-+ + + + +-+-+-+ +-+ +-+ +-+-+ + +-+-+ + +-+-+-+ +-+-+-+ +
| |     | |   | |   |   |   | | |       | | | | |       | |   |   |   | | |     |       |   |   | |
+ +-+ +-+ +-+-+ +-+-+ +-+ +-+ + +-+-+-+ + + + + +-+-+-+ +-+ +-+ +-+ + + + + +-+-+-+-+-+ +-+ + +-+ +
|   |   |               |   | |         |   | |       | |   |   |   |   | | |         |     |   | |
+-+ +-+-+ +-+-+-+ +-+-+-+-+ + + +-+-+-+-+-+-+ + +-+ + + + +-+-+ + +-+-+-+ + + +-+-+-+ +-+-+-+ + + +
|   |   |   |   |     |     | | |     |     | |   | | |   |     | | |   | | |   |   |       | | | |
+ +-+ + +-+-+ + +-+-+-+ +-+-+ + +-+ + + + + + +-+-+ + +-+-+ + +-+ + + + + + +-+-+ + + +-+-+-+ + + +
|     |     | |       | |     |     | | | |   |     |   |   |     |   | | |       | |   |     |   |
+ +-+-+-+-+ + +-+-+-+ + +-+-+ +-+-+-+ + + +-+-+ +-+-+-+ + +-+-+-+-+ +-+ + +-+-+-+-+ + + + +-+-+-+-+
| |   |   |   |   |   |     | |       | |   |     |   | | |       | | |     |       | |   |   |   |
+ + + + + +-+-+ +-+ +-+-+-+ + + +-+-+-+-+-+ + +-+ + + +-+ +-+-+ +-+ + +-+-+ + +-+-+-+ +-+-+ +-+ + +
| | |   |       |   |     |   | |           | |   | |     |     |     |   | | |     |     | |   | |
+ +-+ +-+ +-+-+ + +-+ +-+ +-+-+ +-+ +-+ +-+-+-+ + + +-+-+-+ +-+-+ +-+-+ + +-+ + +-+ +-+-+ + + +-+ +
|   | |   |   | |   | | |     |   | | |   |     | |     |           |   |   | |   |   |   | |   | |
+-+ + + +-+ + + +-+ + + +-+ +-+-+ + + +-+ +-+ +-+ +-+-+ + +-+-+-+-+-+ +-+-+ + + + +-+ + +-+ + +-+ +
| | | |   | |     | | |   |       |   |   |   |   |     | |     |   | |   |   | |   | |   |   |   |
+ + + +-+ +-+-+-+ + + +-+ +-+-+-+-+-+-+ +-+ +-+-+-+ +-+-+ +-+ + + + + + + +-+-+-+-+ +-+-+ + +-+ + +
| | | | |     |   | |   |     |     |   |   |       |   |   | | | | | | |   |       |     |   | | |
+ + + + +-+-+ + +-+ +-+ + + + + +-+ + +-+ +-+ +-+-+-+ + +-+ + + + + + + +-+ + + +-+-+ +-+-+-+ + + +
|   |   |     | | |   | | | |   | |   | |   | |     | |   |   | | | |     | | | |     |     | | | |
+ +-+-+-+ +-+-+ + +-+ + +-+ +-+-+ +-+-+ + + + + +-+ + +-+ +-+-+-+ + +-+-+-+ + + + +-+-+ +-+ +-+ + +
|         |         |       |             |     |     |           |         | |         |       | |
+-+-+-+-+-+-+-+-+-+-+-+-+-+-+-+-+-+-+-+-+-+-+-+-+-+-+-+-+-+-+-+-+-+-+-+-+-+-+-+-+-+-+-+-+-+-+-+-+-+