+-+-+-+-+-+-+-+
| |   | |     |
+ + + + + +-+ +
|   | | | |   |
+-+-+ + + + + +
|     |   | | |
+ +-+-+ +-+ + +
| |     |   | |
+ +-+-+-+ +-+ +
| |     |   | |
+ + +-+ + + +-+
| | | | | |   |
+ + + + +-+-+ +
|   |         |
+-+-+-+-+-+-+-+