+-+-+-+-+-+-+-+
| |     |     |
+ +-+ +-+-+ + +
|       |   | |
+ + +-+ + + +-+
| | |     |   |
+-+ +-+-+ +-+-+
| | |         |
+ +-+ + + +-+ +
|     | |   | |
+-+-+ +-+-+-+-+
|   |   |     |
+ +-+ +-+ +-+ +
|         |   |
+-+-+-+-+-+-+-+