+-+-+-+-+-+-+-+-+-+-+-+-+-+-+-+-+-+-+-+-+-+-+-+-+-+-+-+-+-+-+-+-+-+-+-+-+-+-+-+-+-+-+-+
|                                                                                     |
+ + + + + + + +-+ + +-+ + +-+-+ + + + + +-+-+-+ + + + +-+ +-+-+ + + + +-+ +-+-+-+-+ +-+
| | | | | | |   | |   | |     | | | | |       | | | |   |     | | | |   |         |   |
+ + +-+-+ + +-+ + +-+ + + + +-+-+-+-+-+ + +-+-+-+-+ +-+-+ + + + + +-+-+-+-+ + +-+ + +-+
| |     | |   | |   | | | |           | |         |     | | | | |         | |   | |   |
+ + +-+-+ + + +-+ +-+ +-+-+ +-+-+-+-+ + +-+-+-+-+-+ + + +-+-+ + + +-+-+ + + + +-+-+-+-+
| |     | | |   |   |     |         | |           | | |     | | |     | | | |         |
+ + + +-+-+ + + +-+-+-+ + + +-+-+ +-+-+-+ +-+ + + + +-+-+-+ + +-+ + +-+ +-+-+-+ + +-+ +
| | |     | | |       | | |     |       |   | | | |       | |   | |   |       | |   | |
+ + + +-+ +-+-+ +-+-+ +-+ + +-+ +-+ + +-+ +-+ +-+-+ +-+-+-+-+ + + +-+ +-+ + + + + +-+ +
| | |   |     |     |   | |   |   | |   |   |     |         | | |   |   | | | | |   | |
+ + + + + + +-+ + +-+-+-+ + + +-+-+ +-+-+-+-+ + +-+ +-+-+ + + + +-+ + + +-+-+-+-+-+-+-+
| | | | | |   | |       | | |     |         | |   |     | | | |   | | |               |
+ +-+-+ + + + + + + +-+ + + + + + + +-+ +-+-+-+-+-+ + +-+ + + +-+-+-+ + + + + +-+ + +-+
|     | | | | | | |   | | | | | | |   |           | |   | | |       | | | | |   | |   |
+ + + + +-+-+ +-+ + + +-+-+-+-+-+ + + +-+-+ + + +-+ + +-+-+-+-+-+ +-+ +-+ +-+-+-+ +-+ +
| | | |     |   | | |           | | |     | | |   | |           |   |   |       |   | |
+ + + + +-+-+-+ +-+-+-+-+-+ +-+ +-+-+-+ + + +-+-+-+ +-+ +-+-+ + +-+-+-+-+-+ + +-+-+ + +
| | | |       |           |   |       | | |       |   |     | |           | |     | | |
+ +-+ + + + +-+-+-+-+-+-+-+-+ + +-+-+-+ + +-+ + +-+ + +-+ + +-+-+ +-+-+-+-+-+-+-+-+-+ +
|   | | | |                 | |       | |   | |   | |   | |     |                   | |
+ + +-+ + +-+ + + +-+ +-+-+ + +-+ + +-+ + + + +-+-+ +-+ + + + +-+-+-+-+-+-+-+ + +-+ +-+
| |   | |   | | |   |     | |   | |   | | | |     |   | | | |               | |   |   |
+ +-+ +-+-+ +-+ + +-+-+-+-+ + +-+ +-+ +-+-+-+ +-+-+ +-+ + +-+-+ + + +-+-+-+ +-+-+ + + +
|   |     |   | |         | |   |   |       |     |   | |     | | |       |     | | | |
+ + + + + + + +-+-+-+ +-+ +-+-+-+ + +-+ +-+-+-+ + + +-+ +-+ + + +-+-+-+-+ +-+-+-+ + + +
| | | | | | |       |   |       | |   |       | | |   |   | | |         |       | | | |
+ +-+-+-+-+-+ + + +-+-+ +-+ +-+-+ +-+ + +-+-+-+-+-+ + +-+ +-+ +-+ + +-+-+-+-+ + +-+-+ +
|           | | |     |   |     |   | |           | |   |   |   | |         | |     | |
+ + + + + + +-+ + + + +-+ +-+ + +-+ + +-+-+ +-+-+ +-+ +-+-+ + + +-+-+ + +-+ +-+-+ + +-+
| | | | | |   | | | |   |   | |   | |     |     |   |     | | |     | |   |     | |   |
+ +-+ + +-+ +-+-+ +-+-+-+ +-+-+-+-+ + + +-+ +-+ +-+ +-+-+-+ +-+ +-+ + +-+-+ + +-+-+-+-+
|   | |   |     |       |         | | |   |   |   |       |   |   | |     | |         |
+ + +-+ +-+-+ +-+-+ +-+-+-+ + + +-+-+-+ +-+-+-+-+ +-+-+-+ + + +-+-+-+ +-+-+-+-+ +-+ + +
| |   |     |     |       | | |       |         |       | | |       |         |   | | |
+ + +-+-+ +-+-+ + + +-+-+-+ + +-+-+ +-+-+-+ + + + +-+-+-+-+-+-+ + + + +-+-+ + +-+-+ +-+
| |     |     | | |       | |     |       | | | |             | | | |     | |     |   |
+ +-+-+ +-+-+-+-+-+-+-+ +-+ +-+ +-+ + + + + + + +-+ +-+ +-+-+ + +-+ + +-+ +-+ + +-+-+ +
|     |               |   |   |   | | | | | | |   |   |     | |   | |   |   | |     | |
+ + +-+-+-+-+ +-+ +-+-+-+-+-+ + +-+ +-+-+ + + + +-+ + + + +-+-+-+-+-+-+-+ +-+ +-+-+-+-+
| |         |   |           | |   |     | | | |   | | | |               |   |         |
+ + +-+ + + +-+ + + +-+ +-+-+ + +-+ +-+ + + + +-+ + +-+-+ +-+ + + +-+ + + + + + + +-+ +
| |   | | |   | | |   |     | |   |   | | | |   | |     |   | | |   | | | | | | |   | |
+ + + + +-+ + +-+-+ + + + +-+ + +-+-+ +-+ +-+ +-+ +-+-+-+ +-+ + + +-+-+-+ + +-+-+ + +-+
| | | |   | |     | | | |   | |     |   |   |   |       |   | | |       | |     | |   |
+ + + +-+-+-+-+ + + +-+ + + + +-+-+-+-+-+-+-+-+-+-+ + +-+ +-+ +-+ +-+-+ +-+-+-+-+ + +-+
| | |         | | |   | | | |                     | |   |   |   |     |         | |   |
+ +-+-+ +-+ +-+ +-+-+ + + +-+-+-+-+-+-+ + +-+ + + +-+-+-+ +-+ +-+ +-+ + +-+-+-+ +-+ +-+
|     |   |   |     | | |             | |   | | |       |   |   |   | |       |   |   |
+ +-+ +-+ +-+ + + + + + + + +-+-+ + + + + + + + + + +-+ +-+ + +-+ + + +-+ +-+-+ + +-+-+
|   |   |   | | | | | | | |     | | | | | | | | | |   |   | |   | | |   |     | |     |
+ +-+-+ + +-+ +-+ + + +-+-+ +-+-+ +-+ +-+-+-+ + + +-+ + +-+ +-+ +-+ + + + + + + + +-+ +
|     | |   |   | | |     |     |   |       | | |   | |   |   |   | | | | | | | |   | |
+ + +-+ + +-+-+-+ + + + +-+ +-+-+-+-+ + +-+ +-+-+ + +-+-+ + + + +-+ + +-+-+-+ + + + + +
| |   | |       | | | |   |         | |   |     | |     | | | |   | |       | | | | | |
+ + + +-+ + + +-+-+ + +-+-+-+-+ + + +-+-+-+-+-+ +-+-+ +-+ + + + +-+ +-+-+-+-+-+-+ + + +
| | |   | | |     | |         | | |           |     |   | | | |   |             | | | |
+ +-+-+ +-+-+-+ + + +-+-+-+ + + +-+ + +-+ +-+-+-+-+ +-+ +-+ +-+ + +-+ + +-+-+-+ +-+-+ +
|     |       | | |       | | |   | |   |         |   |   |   | |   | |       |     | |
+ + + +-+-+ + + +-+ +-+ + + + +-+-+-+ + +-+-+-+ + + + +-+-+ + + + + +-+ +-+-+-+-+-+ + +
| | |     | | |   |   | | | |       | |       | | | |     | | | | |   |           | | |
+ + +-+ + + + + + +-+-+ +-+ + +-+-+-+-+-+ +-+-+-+-+-+-+-+-+-+-+-+ +-+-+-+ +-+-+-+ +-+ +
| |   | | | | | |     |   | |           |                       |       |       |   | |
+ +-+-+ + +-+-+-+-+ + + + + + +-+-+-+-+ + +-+-+-+-+ + + +-+ +-+ +-+-+-+-+ +-+-+-+-+ + +
|     | |         | | | | | |         | |         | | |   |   |         |         | | |
+ +-+ +-+-+-+-+ +-+-+-+ +-+ + +-+-+ +-+ +-+-+ +-+ +-+-+ + +-+-+-+-+-+ +-+ + + +-+-+-+ +
|   |         |       |   | |     |   |     |   |     | |           |   | | |       | |
+ + +-+-+-+-+ + +-+-+ + + +-+-+-+-+-+-+-+-+-+ +-+ +-+ + +-+-+-+ + +-+-+-+ + +-+-+-+-+ +
| |         | |     | | |                   |   |   | |       | |       | |         | |
+ +-+ + + + + + +-+-+-+-+ +-+-+-+-+-+-+-+-+-+ + +-+ + +-+ + +-+ +-+-+ + +-+ + +-+-+-+-+
|   | | | | | |         |                   | |   | |   | |   |     | |   | |         |
+ +-+ + + + +-+ +-+-+ +-+ +-+ + + + + + +-+ +-+-+-+ +-+ + + + +-+-+ + + +-+-+ + +-+-+ +
|   | | | |   |     |   |   | | | | | |   |       |   | | | |     | | |     | |     | |
+ +-+ + + + + +-+ + + + +-+-+ + +-+-+ +-+-+-+ + +-+-+-+ + +-+ + + + + + +-+ +-+-+ +-+ +
|   | | | | |   | | | |     | |     |       | |       | |   | | | | | |   |     |   | |
+ + + +-+ +-+-+ +-+ +-+-+ + + +-+ + + + +-+-+-+ +-+-+-+ +-+ + +-+ + + + + +-+ +-+-+-+-+
| | |   |     |   |     | | |   | | | |       |       |   | |   | | | | |   |         |
+ +-+-+-+-+ +-+ + +-+ + + +-+ +-+-+-+ +-+ +-+-+-+ + + + + + +-+ + + + +-+-+ +-+ + +-+-+
|         |   | |   | | |   |       |   |       | | | | | |   | | | |     |   | |     |
+ + + +-+-+-+-+ +-+ +-+-+-+ +-+ +-+-+-+ + + + + + + +-+ +-+ + +-+-+-+ +-+-+-+ + + + +-+
| | |         |   |       |   |       | | | | | | |   |   | |       |       | | | |   |
+ +-+-+ +-+-+ +-+-+-+-+-+-+-+ +-+-+-+ + + +-+-+-+ + +-+ +-+ + +-+ +-+-+-+ + + + + + +-+
|     |     |               |       | | |       | |   |   | |   |       | | | | | |   |
+ +-+-+-+ +-+-+ +-+ + + + +-+ + + + +-+-+ + +-+ +-+-+ + +-+-+-+-+-+-+ +-+ +-+-+-+-+-+ +
|       |     |   | | | |   | | | |     | |   |     | |             |   |           | |
+-+-+-+-+-+-+-+-+-+-+-+-+-+-+-+-+-+-+-+-+-+-+-+-+-+-+-+-+-+-+-+-+-+-+-+-+-+-+-+-+-+-+-+