+-+-+-+-+-+-+-+-+-+-+-+-+-+-+-+-+-+-+-+-+-+-+-+-+-+-+-+-+-+-+-+-+-+-+-+-+-+-+-+-+-+-+-+-+-+-+-+-+-+-+
|                                                                                                   |
+ + + +-+ +-+ + + + + +-+ + + +-+-+ +-+ +-+ +-+-+ + + +-+-+ + + + +-+ + + +-+ +-+ + +-+ + + + + +-+ +
| | | |     | | | | |   | | |     |   | |       | | |     | | | |   | | |   |   | | |   | | | |   | |
+ +-+-+ + + +-+-+ + + +-+ +-+ + + + +-+ + + +-+ +-+-+-+ +-+ +-+ + + + +-+ + + + + + +-+-+ + + +-+ +-+
|     | | |     | | | |     | | | |   | | | |         |   |   | | | |   | | | | | |   |   | | |     |
+ + + + + + + + + + + + +-+ +-+-+ + +-+-+ + + + +-+-+ +-+ + +-+ + + +-+ + +-+ +-+ + + +-+ + + + + +-+
| | | | | | | | | | | | |     |   | |     | | |     | |   | |   | | |   |   | |   | |   | | | | |   |
+ + +-+ +-+ +-+ + +-+-+ + + + +-+ + + + +-+-+ + +-+ + + +-+-+ + + + + +-+ + + +-+-+ + + + + +-+-+-+ +
| |   | |   |   |     | | | | |   | | |   |   |   | | |   |   | | | | |   | | |     | | | | |       |
+ + +-+ + +-+ + +-+ +-+ + + + + + + +-+-+-+ + + + + +-+ + + +-+ + + + +-+ + + +-+ +-+ + + + +-+ + +-+
| | |   |   | | |   |   | | | | | | |       | | | | |   | | |   | | | |   | | |   |   | | | |   |   |
+ +-+ + + + + + +-+-+-+ + +-+ +-+ +-+ +-+ +-+ +-+-+ +-+-+ + + + + + +-+ + + + + + + + + + +-+ + + + +
| |   | | | | |       | |   | |   |     | |   |         | | | | | | |   | | | | | | | | | |   | | | |
+-+ + + +-+ + + + + +-+ + + + +-+-+ + +-+-+ +-+ + + + + + + +-+ + + + + +-+-+ +-+ + + +-+-+-+-+ +-+ +
|   | |   | | | | | |   | | |     | |     | |   | | | | | |   | | | | |     | |   | |       |   |   |
+ + + +-+ +-+ + + + +-+-+ + +-+ +-+ + + + + + + + + + + + + + + + + + +-+-+ + + +-+ + +-+ + + + + + +
| | |   |   | | | | |     | |   |   | | | | | | | | | | | | | | | | | |     | | |   |   | | | | | | |
+ + +-+ +-+ + + +-+ +-+ +-+ + + + + + + + +-+ +-+ + +-+ + + +-+ + +-+ +-+ +-+-+ + + + + + +-+ + + +-+
| |   | |   | | |   |     | | | | | | | | |     | |   | | |   | | |     |     | | | | | |   | | |   |
+ + + + + + + +-+ + + +-+-+ +-+ + + + + + +-+ + +-+ + + + + + + +-+ + + + + + + +-+-+ +-+ + + + + + +
| | | | | | | |   | |     | |   | | | | | |   | |   | | | | | | |   | | | | | |     |   | | | | | | |
+ + + + +-+ + + + +-+ +-+ + + +-+ + + +-+ + +-+-+ +-+ +-+-+ + + + + +-+ +-+ +-+ + +-+-+ + + + + + +-+
| | | |   | | | | |   |   | |   | | |   | | |       |     | | | | | |   |     | |     | | | | | |   |
+ + + + + + + +-+-+ + + +-+-+ + + +-+ + + +-+ +-+ +-+-+ +-+-+ + +-+ +-+ + + +-+-+ +-+ + + + + +-+-+ +
| | | | | | | |     | |   |   | | |   | |   |   |   |     |   |   |   | | | |       | | | | |   |   |
+ + + + + + +-+-+ + + +-+-+-+-+ + + + + + + + + + +-+ + + + + + +-+ + + + +-+ + + +-+ + + + + + +-+ +
| | | | | |   |   | | |         | | | | | | | | |   | | | | | |   | | | |   | | | |   | | | | |   | |
+ + + +-+ + +-+ +-+ + +-+ + + + + +-+ +-+ + + + +-+ + + + +-+ + + + + + +-+ + + + + +-+-+-+ + + +-+ +
| | |   | | |     | |   | | | | |   | |   | | |   | | | |   | | | | | | |   | | | |       | | | |   |
+ +-+-+ +-+ + + + + + + + + +-+ +-+ + + + + + +-+-+ + + + + + +-+ +-+ +-+ + + + +-+ + + +-+ +-+ +-+ +
|   |   |   | | | | | | | | |   |   | | | | |     | | | | | | |     |   | | | |   | | | |   |     | |
+ +-+-+-+ + + + +-+ +-+ + +-+-+ + + +-+-+-+ + + + + +-+-+-+ +-+-+ + +-+ +-+-+ +-+ + +-+-+ +-+-+ + +-+
|   |     | | | |     | |     | | | |       | | | |   |         | | |   |     |   |     | |     |   |
+ + +-+ + + + + +-+ + +-+-+ + + +-+ + +-+-+-+ + + +-+ +-+-+ + +-+-+ + +-+ + + + +-+ +-+ +-+-+-+ + + +
| | |   | | | |   | | |     | |   | | |       | |   |   |   |   |   |   | | | |   |   |     |   | | |
+ + + +-+-+ + +-+ + + + + + +-+ + +-+ + +-+ +-+ + +-+ + + + + + + + +-+ + + +-+ +-+-+ + + +-+-+-+ + +
| | |     | | |   | | | | | |   | |   | |     | | |   | | | | | | | |   | |   | |     | | |       | |
+ + + + + +-+-+-+ + + + + +-+ +-+-+ + +-+ +-+-+ +-+ +-+-+ + + + +-+ +-+-+ +-+ + +-+-+-+ + + + + + +-+
| | | | | |       | | | | |       | |   |     | |       | | | | |   |       | |       | | | | | |   |
+ + + +-+ + +-+ +-+-+-+-+ + + + + + + +-+ + + +-+ +-+ + + + +-+ +-+ +-+ + + + +-+ +-+ + + +-+-+-+ +-+
| | | |   |   |     |     | | | | | |   | | | |     | | | |   |   | |   | | | |     | | |       |   |
+ + +-+ + +-+-+ + + + + + +-+-+-+ + + + + + + + + + + +-+ + + + + + + + +-+-+-+ +-+ + + +-+-+ + + + +
| | |   | |     | | | | | |       | | | | | | | | | | |   | | | | | | | |         | | |     | | | | |
+ + + +-+ + + +-+ + + + + +-+-+-+ +-+-+ +-+ + +-+ + + + + +-+-+ + + +-+-+ +-+ + + + + +-+ +-+ + + + +
| | | |   | |   | | | | |   |     |       | | |   | | | |   |   | |     |   | | | | | |   |   | | | |
+ + + +-+-+-+ + +-+ + +-+ + +-+ + + +-+ +-+ + + + + + + + +-+ + +-+-+-+ +-+ +-+-+-+ + +-+ + +-+-+-+ +
| | |   |     |   | | |   | |   | |   | |   | | | | | | |   | |     |     |       | |   | |   |     |
+ +-+ +-+ + + + + + + + + + +-+ + + + +-+-+ +-+ + + + + + + +-+-+-+ +-+ + +-+ + + + + +-+ + +-+ + + +
| |   |   | | | | | | | | |   | | | |     | |   | | | | | |   |     |   |   | | | | | |   | |   | | |
+ +-+ + + + + + +-+ + +-+ + + + + + + + + + + +-+-+ +-+ +-+ + + + + + +-+ + + + +-+-+ + + +-+ +-+-+-+
|   | | | | | |   | | |   | | | | | | | | | | |     |   |   | | | | |   | | | |     | | | |         |
+ + + +-+ + + + + + + + +-+ + + + + + + + +-+ +-+-+-+ + + +-+ + +-+-+ + + +-+ + + + + +-+ +-+-+-+ + +
| | |   | | | | | | | | |   | | | | | | | |       |   | | |   |     | | |   | | | | |   | |       | |
+ +-+ +-+-+-+-+-+ + + + +-+ + + + + + + + + + +-+ + +-+ + + + + + + +-+ +-+ + +-+ +-+-+-+-+ + + + + +
| |   |           | | |   | | | | | | | | | | |   | |   | | | | | |   | |   | |           | | | | | |
+-+ +-+ + + +-+ +-+ + + + + +-+ + + + +-+-+ + + +-+ + + + + + +-+ + +-+ +-+-+-+ + + + +-+ +-+ + +-+ +
|     | | | |   |   | | | |   | | | |     | | | |   | | | | |   | | |       |   | | |   |   | | |   |
+ +-+ + + +-+-+-+ +-+-+ + + + + + + + + +-+ +-+ + +-+ + + + +-+ + + + + +-+ + +-+-+ + + +-+ + + + + +
| |   | | |           | | | | | | | | | |     | | |   | | |   | | | | |   | | |     | | |   | | | | |
+-+ + + +-+ +-+ +-+-+ + + +-+ + + +-+ + + + +-+ + + +-+ + +-+-+ +-+ +-+-+ + + + + + + +-+ + +-+-+ +-+
|   | |   |   | |     | |   | | | |   | | | |   | | |   | |     |   |     | | | | | |   | |   |     |
+ + + + + +-+ +-+ + + + +-+ + + + + + + + + +-+-+ +-+ +-+ + +-+-+-+ + +-+ +-+ +-+-+ +-+-+ +-+ + + + +
| | | | | |   |   | | |   | | | | | | | | | |     |   |   |       | | |     |     | |     |   | | | |
+-+ + + + +-+-+-+ + + + + + +-+ +-+ + + +-+ +-+ + + +-+-+ + + +-+ +-+-+ + + + + +-+ +-+-+ + + + + + +
|   | | |     |   | | | | | |   |   | |   | |   | |   |   | | |   |     | | | | |     |   | | | | | |
+-+ +-+ + + + +-+ +-+ + + + + +-+ +-+ + + + +-+ + + + + +-+ + + +-+-+ + + + + +-+ +-+-+ + + +-+ +-+-+
|   |   | | | |   |   | | | |   |   | | | |   | | | | | |   | |     | | | | | |       | | |   |     |
+ + +-+ + + + +-+ +-+-+ + +-+-+-+ + + + + +-+ + + + + + + +-+ + + + + + +-+ + +-+ + + +-+ + + + + + +
| | |   | | | |   |     | |       | | | | |   | | | | | | |   | | | | |   | |   | | | |   | | | | | |
+ +-+-+ + + + + +-+ +-+ + + + +-+-+ + + + +-+ + +-+-+ +-+ + +-+ +-+ +-+-+ + + + + + +-+ + + + + + + +
|     | | | | |   |   | | | | |     | | | |   | |       | | |   |       | | | | | |   | | | | | | | |
+-+ +-+ + +-+ + + + + + + + + +-+ +-+ + + + + +-+ + +-+ + + + + + +-+ +-+ + +-+ +-+ + +-+ +-+ + +-+ +
|   |   | |   | | | | | | | |   |   | | | | | |   |   | | | | | | |   |   | |     | | |     | | |   |
+ + + + + + + + +-+-+ + + + + +-+-+-+ +-+-+ +-+ + +-+ + + +-+ +-+ +-+ + + + + + + +-+ +-+-+ +-+ +-+ +
| | | | | | | | |     | | | |       |     | |   |   | | | |   |     | | | | | | | |       |   | |   |
+ +-+-+-+ + + + + +-+ + + +-+-+ + + + + +-+-+ + + +-+-+ + + + +-+-+ + + +-+-+ +-+ + + + + +-+ + + + +
|   |     | | | | |   | |     | | | | | |     | |     | | | | |     | |     | |   | | | |   | | | | |
+ + +-+ + + +-+-+-+ + +-+-+ + + + + + + + +-+ + +-+ +-+-+-+ + + + + +-+-+-+ +-+-+ + +-+-+ + + + + + +
| | |   | |   |     |     | | | | | | | |   | | |         | | | | |       | |     | |     | | | | | |
+ + + + +-+ + + + + +-+ + + + + + +-+ + + +-+ + + + + + + + + + + +-+ +-+-+ + + +-+-+ + +-+-+ +-+ + +
| | | |   | | | | | |   | | | | | |   | | |   | | | | | | | | | |   |   |   | |   |   |   |   |   | |
+ +-+-+ + +-+ +-+ + + +-+-+-+ + +-+ +-+ +-+ + +-+-+ +-+ + + +-+ +-+ + +-+ +-+-+ + + + + + +-+ + + + +
| |     | |     | | | |       |   |   | |   |     | |   | | |     | |   |     | | | | | |   | | | | |
+-+ + +-+ +-+-+ + +-+ + + + + + + + + +-+-+ +-+-+ + + + +-+-+ +-+ + + + + + +-+-+ +-+ + + + + +-+ + +
|   | |   |     | |   | | | | | | | | |     |     | | |   |   |   | | | | | |     |   | | | |   | | |
+ + +-+ + + + + + + + +-+ +-+ + + +-+ + +-+ +-+ +-+-+ +-+-+ +-+-+ +-+ + + + + + +-+ + +-+ + + + +-+ +
| | |   | | | | | | | |     | | |   | |   | |   |         |     | |   | | | | |   | |   | | | |   | |
+-+ +-+-+-+-+ + + +-+ + + + + +-+ +-+ + + +-+ + + +-+-+-+-+ + + +-+-+ +-+-+ +-+ +-+-+ + +-+ + + + + +
|       |     | |   | | | | | |     | | | |   | |     |     | | |         | |       | | |   | | | | |
+ +-+ +-+ + + +-+ +-+ + +-+-+ + + + +-+-+-+-+-+ +-+ +-+ + + + +-+-+ +-+ +-+-+ + + + + + + +-+-+-+ + +
|   |   | | |   | |   | |     | | |           | |     | | | |     | |   |     | | | | | |     |   | |
+ + + +-+ + +-+ +-+ + + +-+ +-+ + +-+-+ + +-+ +-+ +-+-+-+ + + + + +-+-+ +-+-+ + +-+ + +-+-+-+-+-+ +-+
| | | |   | |   |   | | |   |   |     | |   |   |   |     | | | |   |     |   | |   |           |   |
+ + + + + + +-+ +-+-+ + +-+ + +-+ +-+ + +-+-+ + + + +-+ + + + + + + + + + +-+ +-+ +-+-+-+ +-+-+-+ + +
| | | | | | |       | |   | | |   |   | |     | | |   | | | | | | | | | | |     |   |           | | |
+-+ + + + + + +-+ +-+ +-+-+ + + + + + + + + + + + + + +-+-+ + +-+ + + + + + +-+ + +-+-+ + + +-+ +-+ +
|   | | | | |   | |       | | | | | | | | | | | | | |   |   |   | | | | | | |   |     | | | |     | |
+ +-+-+ + + + + + + + +-+ +-+ + + + + + + + + + + + + + +-+-+ + + +-+ +-+ + +-+ + + + + + + + + + + +
| |     | | | | | | | |     | | | | | | | | | | | | | |     | | |   | |   |   | | | | | | | | | | | |
+-+-+-+-+-+-+-+-+-+-+-+-+-+-+-+-+-+-+-+-+-+-+-+-+-+-+-+-+-+-+-+-+-+-+-+-+-+-+-+-+-+-+-+-+-+-+-+-+-+-+