+-+-+-+-+-+-+-+-+-+-+
|     |       |     |
+ +-+-+ +-+-+-+-+ +-+
| | |     | |   |   |
+ + + +-+-+ + +-+ + +
|                 | |
+-+-+-+-+-+ + +-+-+-+
| |   |   | |   |   |
+ + +-+ +-+-+ + + +-+
|     |       |     |
+ +-+-+-+-+ + +-+-+ +
|   | |     | |   | |
+ + + +-+ +-+ +-+ +-+
| |     | | |       |
+-+-+-+ +-+ +-+-+ +-+
|     |       |   | |
+-+ + +-+ + +-+ +-+ +
|   |     |         |
+ + + +-+-+ + + + +-+
| | |     | | | |   |
+-+-+-+-+-+-+-+-+-+-+