+-+-+-+-+-+-+-+-+-+-+-+-+-+-+-+-+-+-+-+-+-+-+-+-+-+-+-+-+-+-+-+-+-+-+-+-+-+-+-+-+-+-+-+-+-+-+-+-+-+-+
| |       |     |         |           |         |     |     |       |         |   |               | |
+ +-+-+ +-+ + + + +-+-+-+ +-+-+ +-+-+ + +-+-+-+-+ + + +-+ + + +-+-+ + +-+ +-+ + + + +-+ +-+-+-+-+ + +
|     | |   | |   | |     |     | |   |         | | |     | |   |   |   |   |   | | |   |   |     | |
+-+-+ + + +-+ +-+-+ + +-+-+ +-+-+ + +-+ +-+-+-+ + + +-+-+-+ +-+-+ + + +-+-+ +-+-+ + + +-+ +-+ +-+-+ +
|     | | | |   |   | |     |     |   | |     | | | |     |   |   | | |     |   | | | |   |   |     |
+ +-+-+ + + +-+ + +-+ + + +-+ +-+ +-+ +-+ +-+ + + + + +-+-+-+ + +-+-+ + +-+-+ + + +-+ +-+ + +-+-+ + +
|   |       |   |   | | | | |   |   |   | | | | | | |     |   |       | |     | |     |   |     | | |
+-+ +-+-+-+ + +-+ + + +-+ + +-+ +-+ +-+ + + + + + + + +-+ + +-+ +-+-+-+ + + +-+-+-+-+-+ +-+-+-+ +-+ +
| |       | | | | |   |   |   | | |   | | | | | | | | |   |   |   |   | | | |       |   |   |   |   |
+ +-+-+-+ +-+ + + +-+-+ +-+ +-+ + + + + + + + + + + + + + +-+ +-+ + + + + +-+ +-+ + + + + + + +-+ +-+
|       | |   |   |       | |   | | | |   |   |   | | | | |   |     | | |       | | | | | |   |     |
+ +-+-+ + + +-+ +-+-+-+-+ + + +-+ + +-+-+-+ +-+ +-+ +-+ +-+ +-+-+-+-+-+ + +-+-+-+ +-+ + + +-+-+-+-+ +
|   | | |   |   |         | |     |         |     | |   |   |           |   | |   |   | | |         |
+ + + + +-+-+ +-+ +-+-+-+-+ +-+-+ +-+-+-+-+-+-+-+-+ + +-+ +-+ + +-+-+-+-+-+ + + + + +-+ + +-+ +-+-+ +
| | |     |   |     |           |     |     |       |   | |   | |   |     |   | | |   | |   | |     |
+ + +-+-+-+ +-+ +-+ +-+ +-+-+-+ +-+-+ + +-+ + +-+-+-+ + + +-+-+ + + + +-+ +-+-+ +-+-+ + +-+ + +-+ +-+
| | |     | |     |   |     |       | |   |   |     | | |   |   | |     | |   |       |   | |   |   |
+ + + +-+ + +-+-+-+-+ + +-+-+ +-+-+ + + + +-+-+-+-+ + + +-+ + +-+ +-+-+-+ + + +-+-+-+-+ +-+ + + +-+-+
| |     | |         | | |   |     | | | | |       |   | |   |   |     |   | |         |   | | |     |
+ +-+-+-+ +-+-+-+-+ + + + + +-+ + + + +-+ + +-+-+ +-+-+ + +-+ + +-+-+ + +-+ +-+-+-+-+ +-+ + +-+-+-+ +
| | |       |     | | | | |   | | | | |   | |   | |   | | |   |       | |   |       | |   |       | |
+ + + +-+ +-+ +-+ + + + + +-+ +-+ +-+ + +-+ + +-+ + + + + +-+-+-+-+-+-+ +-+ + +-+-+-+ + + +-+-+-+ + +
|   |   | |   |   |   | | |       |   | |   |       |   |     |         |   |     |   | | |     |   |
+-+-+-+ + + +-+ + +-+-+ + + +-+-+-+ +-+ + + +-+-+-+-+-+ +-+-+ + +-+-+-+-+ +-+-+-+ + +-+ + +-+ +-+-+ +
|       | | | | |   |   | | |     | |   | |     |           |   |     |     |     |     |     |     |
+ +-+ +-+-+ + + +-+ + +-+ +-+ +-+ + + +-+-+ +-+ +-+-+-+-+-+ +-+-+ + + + +-+ + +-+-+-+ +-+-+-+-+ +-+-+
|   | |   |   |   | | | |   |   | | | |   | | |   |     |       | | | | | | |       | |         |   |
+ + +-+ + +-+ +-+ +-+ + +-+ + +-+ + + + + + + +-+ + +-+ +-+-+-+ + + + + + + +-+ +-+ + + +-+-+-+-+ + +
| |     |   |   |     |   |   |   | |   | |     | | | | |   |   | | | | | |   |   |   |           | |
+-+-+-+-+-+ +-+ +-+-+-+ +-+-+-+ + + + +-+ +-+-+ + + + + + + +-+-+ + +-+ + +-+ +-+ +-+-+-+-+-+-+-+-+ +
|         |   |     |       |   | | |   |   |   |   | |   |       |   |   |   |   |       |     |   |
+ +-+-+-+ +-+ +-+-+ +-+-+-+ + +-+-+ +-+ +-+ + +-+-+-+ +-+-+-+-+-+-+-+ +-+ + +-+ +-+ +-+ + +-+-+ + +-+
| |     |         |     |   |   |   |     | | |           |         |     | |   |     | | |     | | |
+ +-+ +-+ +-+-+-+ +-+-+ + + +-+ + +-+ +-+-+ + + + +-+-+-+ + + +-+-+ +-+-+-+ + +-+ +-+-+ + + +-+-+ + +
|   | |   |   | | |   | | |   | | |   |     | | |       | | | |   |         |   | |     |   |     | |
+ + + + +-+ + + + + + + + + +-+ + + +-+ +-+-+ +-+-+-+-+ + + + + + +-+-+-+-+-+-+ + + +-+-+ +-+ +-+-+ +
| | |     | | | |   | | | | |   | |   | |               | | | | |       |   | | | | |     |   |     |
+ + +-+-+-+ + + +-+-+ + + +-+ +-+ +-+-+ +-+-+-+-+-+-+-+-+ + +-+ +-+-+-+ + + + + +-+ + +-+-+ +-+ +-+ +
| | |       | |       | |   |   |     |           |     | |   | |     | | | | |     | |   |     | | |
+ + + +-+-+-+ +-+-+-+-+ +-+ +-+ +-+-+ +-+-+-+-+-+ +-+ +-+ +-+ + + +-+-+ + + + +-+-+-+ + +-+-+-+-+ + +
| |   |     |           |   |     |   |   |     | |   |   | |   |     |   | |   |     |       |     |
+ +-+-+-+ + +-+-+-+-+-+-+ + + +-+ + +-+ + + +-+ + + +-+ +-+ +-+-+-+-+ +-+-+ + +-+ +-+-+-+-+ + + +-+-+
|       | | |   |         | | |   | |   | | | |   |     |             | |   |   |     |     | |   | |
+-+-+-+ + + + + +-+-+ +-+-+ + + +-+ + +-+ + + +-+-+ +-+-+ +-+-+-+ +-+ + + +-+-+ +-+-+ + +-+-+-+-+ + +
| |     | |   |     |     | | |   | |   |   |       | |   |       | |   | |   |   |   |   |       | |
+ + +-+-+ +-+-+-+-+ + +-+ + + +-+-+ + + +-+-+ +-+-+-+ + +-+ +-+-+-+ +-+ + + + +-+ + +-+-+ + +-+-+-+ +
|   |     |     |   |   | | |     | | |     | |   |   |   |   |     |   |   |   |         |   | |   |
+ +-+ +-+ + +-+ + +-+-+-+ + +-+-+ + + +-+-+ + + + +-+ +-+ +-+ + +-+-+ +-+-+-+-+ + +-+-+-+-+-+ + + + +
| | |   | | |   | |       | |   |   |   |   |   |   | |   | | | |     |   |     |   |       | |   | |
+ + + +-+ + + +-+ +-+ +-+-+ + + +-+-+-+ + +-+-+-+-+ + + +-+ + + + +-+-+ + + +-+-+-+-+ +-+ +-+ + +-+ +
| |   |   | |   |   | |       |   |   | | |     |   | | |   | | |     | | |     |     | |     | |   |
+ +-+-+ +-+ +-+ +-+ + +-+-+-+-+-+-+ + + + +-+-+ + +-+ + + + + + +-+-+ + +-+-+-+ + +-+-+ +-+-+-+ + +-+
| |     |   | |     |   |     |     |   |     | | |     | | | | |     |   |     | |       |     |   |
+ + +-+-+ +-+ +-+-+-+ + + +-+ + +-+-+-+-+-+-+ + + + +-+-+ +-+ + + +-+-+-+ + +-+ + +-+ +-+ +-+-+-+-+ +
|   |   | |   |     | |   | |   |     |   |   | | |       |   |   |       |   | |   |   |         | |
+-+-+ +-+ +-+ + + + + +-+-+ +-+-+-+ + +-+ + +-+ + +-+-+-+-+ +-+ +-+-+-+ + +-+ + +-+ + + + +-+-+-+ + +
| |     | |   | | | | |     |       | |   | |   |           |   |       | |   |   | | | | |     |   |
+ + +-+ + + +-+ + +-+ + + +-+ + +-+-+ + + + + +-+-+-+-+-+-+-+ +-+ +-+ +-+-+ +-+ +-+ + + +-+ +-+ +-+-+
| |   |   |     |   | | | |   |   |     | | |       | |     | |   |   |     |   |   | |     | |     |
+ +-+ +-+-+ +-+-+-+ + + + + +-+-+ + +-+-+-+ +-+-+ + + + + + + +-+ + +-+ +-+-+ +-+ +-+-+-+ +-+ +-+-+ +
|   |     |       |   | | |   | | | | |     |   | | | | | | | |   |   | |   | |   |     |   |   | | |
+ + +-+-+ +-+-+-+ +-+-+ + +-+ + + + + + +-+-+ + + + + + + +-+ + +-+-+-+ + + +-+ +-+ +-+ +-+ + + + + +
| |     | |       |     | |     | |   | |     | | |   | |   |   |       | |   | |   |   | |   | | | |
+-+-+ +-+ + +-+-+-+ +-+-+-+ +-+-+ +-+ + +-+-+ + + +-+-+ +-+ +-+ + +-+-+-+ +-+ + + +-+ +-+ +-+-+ + + +
|   | |   | |       |       |     | | | |     |   |     |   | | |       |   | | | |   |   |   | | | |
+ + + + +-+ +-+-+ +-+ +-+-+-+ +-+-+ + + + +-+-+-+-+ +-+-+ + + + +-+-+-+ + +-+ + + + +-+ +-+ + + + + +
| | | | |       |       |   |     |   | |     |     |   | |   | | |   |   |   | | | |       |     | |
+ + + + +-+-+-+ + +-+-+-+ + + +-+ +-+-+ +-+-+ + +-+-+-+ + +-+-+ + + + +-+-+ +-+ + + +-+-+-+-+ +-+-+ +
| |   |   | |   |   |   | | | | |   |   |     |       | |   |   |   |     | |   | |     |   | |   | |
+ + +-+-+ + + +-+-+ + + + + + + +-+ + +-+ +-+ +-+-+-+ + +-+ + +-+ +-+ +-+ + + +-+ +-+-+ + + + + + + +
| | |     |     |   | |   | |     | |   |   |   |   |   |   | |   |   |   |   |   |   |   | | | |   |
+ +-+ +-+-+-+-+ +-+-+ +-+-+ +-+-+-+ +-+ + + + +-+ + +-+ + +-+ +-+-+ + +-+-+-+-+-+ +-+ +-+-+ +-+ +-+ +
| |   |       |       |           |   | | | | |   | |   | |   |     | |           |       |     |   |
+ + +-+ +-+-+ +-+-+ +-+-+-+-+-+-+ + + + +-+ +-+ +-+ + +-+ + +-+ +-+-+ + +-+ +-+-+-+ +-+-+ +-+-+-+ +-+
| |     | |   |     |       |   | | | |   | |   | |   | |   |   |     | |   |       |   |   |   |   |
+ +-+-+-+ + +-+-+ +-+ +-+-+ + + + +-+ +-+ + + +-+ +-+-+ +-+-+-+ +-+-+-+ + +-+ +-+-+ + + +-+ +-+ +-+ +
|         |     | |   | |   | | | |   |   | | |         |     |         |   | |   | | |   | |   |   |
+ +-+-+-+ +-+-+ +-+ +-+ + +-+-+ + + +-+ +-+ + +-+-+ +-+ + +-+ +-+ +-+-+-+-+ + + + + + +-+ + + +-+ +-+
| |     |   | |   | |   | |   |     |   |   |     | |     | |   |   |     | | | | | |   | |   |   | |
+ + + +-+ + + +-+ + + + + + + +-+-+ + +-+ + +-+-+ + +-+-+-+ +-+ +-+ + +-+ + + + + +-+ +-+ +-+ + +-+ +
|   | |   |     |   | | |   |     | | |   |     | | |   | |   | |   | |     |   |     |   |   | |   |
+-+ +-+ +-+-+-+-+-+-+ +-+-+-+-+-+ +-+ + + +-+-+-+ + + + + + + + +-+ + +-+-+-+-+ +-+-+-+ +-+-+-+ + +-+
|   |   |           |           |   | | | |       |   | | | | |   | |     |   |     | | |       |   |
+-+-+ + + +-+-+-+-+ + +-+ +-+-+-+-+ + + + + +-+-+-+-+-+ + + + +-+ + +-+-+ + + +-+-+ + + + +-+-+-+-+ +
|     | | |       | | | |     |     | | | |       |   | |   |     |     |   | |   | | |   |       | |
+ +-+-+-+ + +-+-+ + + + +-+-+ + +-+-+ + + +-+-+-+ + + + + +-+-+-+-+-+-+-+ +-+ +-+ + + +-+-+ +-+-+ + +
|       | |     | |   |   |   |   |   | |         | |   | |             |   |   |   |   |     | | | |
+ +-+-+ + + +-+ + +-+-+-+ + +-+-+ + +-+ +-+-+-+-+-+ +-+-+ + + +-+-+-+-+ + +-+-+ + +-+ + + +-+ + + + +
| |   |   |   | |       | |     |   |   |       |     | | | |   |   |   | |   | |   | | | | | |   | |
+ +-+ +-+-+-+ + +-+-+-+ + +-+ +-+-+-+ +-+ + +-+-+ +-+ + + +-+ + + + + +-+-+ + + +-+ + + + + + + +-+ +
|   |         | | |     |   |   |     |   | |     | | |     | | | | |       | | | | | | | | | |     |
+-+ + +-+-+-+-+ + + +-+-+ +-+-+ + +-+-+-+-+ + +-+-+ + +-+-+ +-+ + + +-+-+-+-+ + + + +-+ + + + +-+-+ +
| | | |   |   | | |     |     |   |       | |   |   | |   |   |   | |     | |   |   |   | | |     | |
+ + +-+ + + + + + +-+-+ +-+ + +-+-+ + +-+ + +-+ +-+ + + + +-+ +-+-+ + +-+ + +-+-+ +-+ +-+ + +-+-+ + +
| |     |   |   | |   |   | |   |   |   | |   |     |   | |   |     |   |   |   |   |     |     | | |
+ +-+-+-+-+-+-+-+ + + +-+ + + + +-+-+ + + + + +-+-+ +-+-+ + +-+ +-+-+-+ +-+-+ + +-+ +-+ +-+-+ + + + +
| |     |       |   |     | | | |   | | | | |       |   | | |       |   |     |   |   |       | | | |
+ + + +-+ +-+-+ + +-+-+-+-+-+ + + + +-+ + +-+-+-+-+-+ + + + +-+-+-+ + +-+ +-+-+-+ +-+ +-+-+-+-+-+ + +
|   |         |               |   |     |             |   |         |           |                 | |
+-+-+-+-+-+-+-+-+-+-+-+-+-+-+-+-+-+-+-+-+-+-+-+-+-+-+-+-+-+-+-+-+-+-+-+-+-+-+-+-+-+-+-+-+-+-+-+-+-+-+