+-+-+-+-+-+-+-+-+-+-+-+-+-+-+-+-+-+-+-+-+-+-+-+-+-+-+-+-+-+-+-+-+-+-+-+-+-+-+-+-+-+-+
|     | |     | |   |       |           |   |   |   |   | |   | |   |   | |       | |
+-+-+ + +-+ +-+ +-+ + + + +-+-+ + +-+ +-+ + + +-+ +-+ +-+ +-+ + +-+ + +-+ + + + +-+ +
| |     |   | |   |   | |     | |   |   | | |             |   |   | | | |   | |   | |
+ +-+ +-+ +-+ +-+ +-+-+ +-+-+-+-+-+ +-+-+ +-+-+-+-+ +-+ + + +-+ +-+ + + +-+-+-+ + + +
|           |     |   |           |             | | |   |       | | |     |     | | |
+-+-+ +-+-+ +-+ +-+-+ +-+-+-+-+ + +-+-+-+ +-+-+-+ +-+ + +-+-+-+-+ + +-+-+ +-+-+ +-+ +
|         |   |       | |   | | |     |   |   |       | | |   |         |   |       |
+-+ + +-+-+-+-+-+-+-+ + +-+ + + +-+ +-+ +-+ +-+ + + +-+-+ + + + +-+ +-+ +-+ + + + +-+
|   |   |           | |     | |   |       |     | |   | |   | | |   |   |     | | | |
+ +-+-+ +-+ +-+ + +-+ +-+-+ + + + +-+-+-+-+-+-+ +-+ +-+ +-+ +-+ +-+-+ +-+-+ +-+-+ + +
|     |       | | |   | |   |   |   |   |   |   | | |       |     | | |   |     |   |
+-+-+-+ + +-+ +-+-+ + + +-+ + +-+ +-+-+ + +-+-+-+ + +-+-+ + + +-+ + +-+-+ + +-+ +-+-+
|   |   | |   |     |   |       | | |           | | |     |   | | | |   | | |     | |
+-+ + +-+-+-+ + +-+-+-+-+-+-+-+-+ + +-+ + + + +-+ + +-+ +-+ + + +-+ + + + + +-+-+ + +
|   | |       |     |     | |   | |     | | |   |         | |         | |     | |   |
+ +-+ +-+-+-+ + +-+-+-+ +-+ +-+ + +-+-+-+ +-+-+ + + +-+-+-+-+-+-+-+ +-+-+ +-+-+ +-+ +
|       | |         |   |             | |     |   | |   |   |     |       |   | | | |
+ +-+ +-+ +-+ +-+-+-+-+ +-+-+ + +-+ +-+ +-+ +-+-+ + +-+ +-+ + + +-+-+ +-+-+ + + + + +
| |     |   | | |   |   |     | |     |   |     | | |     |   | |     |     |   |   |
+-+-+-+-+ +-+ + + +-+ + +-+ +-+-+-+ + + + +-+-+ + + +-+ +-+ +-+-+ +-+-+ +-+ +-+-+-+-+
|     |       |       | |       | | |   |   |   | | |   |       |     |   |   | |   |
+ +-+ + +-+-+-+ +-+-+ + + +-+-+-+ +-+-+ + +-+-+-+-+ + + +-+ +-+ + +-+-+ +-+-+-+ + + +
| |       |       |   |         |   | | |   | |       | |   |       |   | |   | | | |
+-+ +-+-+ +-+-+ +-+ +-+-+-+-+-+ + + + + +-+ + +-+ + +-+ +-+-+ +-+-+ + + + + +-+ + +-+
|       | |       | |     | |     | |   |       | | |   |   | |     | |       | |   |
+ +-+ +-+-+-+ +-+ +-+-+-+ + +-+ +-+ +-+-+ +-+-+ +-+-+-+ +-+ +-+ +-+-+-+ +-+-+ + + + +
| |   |     |   | |   |           | |   |   |         | | | | |         | | |     | |
+ + + + +-+ + +-+-+-+ + + + + +-+ +-+-+ + +-+-+ +-+ +-+ + + + + +-+-+-+-+ + + + +-+-+
| | |   | |       |     | | | |   |     | |   |   |         | |   | |     |   |     |
+-+-+ +-+ +-+-+ +-+-+ + +-+-+-+ +-+-+-+ +-+ + + +-+-+-+ +-+-+ + +-+ +-+ + +-+-+-+-+ +
|       |     |     | |   | | |   |   |     | |     |         |     |   | |   |   | |
+-+-+ +-+-+ + +-+-+ +-+-+-+ + +-+ +-+ + + +-+-+-+ + +-+-+-+-+-+-+-+ + +-+-+ +-+ +-+-+
|   | |   | | |           | |     |   | |       | |     |     |       | |   |   |   |
+ +-+-+ +-+-+ + +-+ + +-+-+ +-+ + + +-+-+ + +-+ +-+ + +-+ +-+-+-+ + +-+ + +-+ +-+ +-+
| |         | |   | |     | |   |   |     | |       |     |     | | | |   |         |
+ +-+ +-+-+ + + +-+ +-+-+-+ + +-+ +-+ +-+ +-+-+ +-+ +-+-+ +-+ +-+ + + + +-+ + +-+-+-+
|     |     |   |   | | |   | | | |     | |     | | |   |   | |   |       | |   |   |
+-+ +-+ + +-+-+ + +-+ + + +-+-+ +-+ + +-+ +-+ +-+ +-+ +-+-+-+ +-+ +-+-+-+ + +-+ +-+ +
|     | | |     |   |     |       | |   |   |   |           | |   |       | |       |
+ + +-+ +-+ +-+ +-+ +-+ + +-+-+ + +-+-+-+-+ + + + + + +-+ + + + +-+ + + +-+ +-+-+ +-+
| |   | | | |     |   | |     | |       |   | | | | |   | | | | |   | | |   |   |   |
+ +-+ + + + +-+ + +-+ +-+ +-+-+-+-+ + +-+-+-+ +-+-+-+ +-+-+-+ +-+ + +-+-+ + + + +-+ +
| |   |     | | |   |     |   |     |   |               |     |   |       | | |     |
+-+-+-+ + +-+ +-+ +-+-+-+-+-+ +-+ + + +-+-+ +-+ + +-+ +-+ + +-+-+-+ +-+-+ +-+-+ +-+-+
|   |   |     |           | |     | | |   |   | | | | | | | |   |   |   |   | | |   |
+ +-+ +-+-+-+ +-+-+ +-+ + + + +-+-+ + +-+ +-+-+-+ + +-+ + + +-+ + + + +-+-+-+ +-+-+ +
|   |   |         |   | | | |   |   | |               |   |   |   | |     | | |     |
+ +-+-+ + +-+-+-+-+-+-+ +-+ + + +-+ + + + + +-+-+-+-+ + +-+-+ + +-+-+ +-+ + + +-+-+ +
|     | | |   | | |     |     | | | | | | |         |       | |   | |   |   | |   | |
+-+-+ +-+-+-+ + + + + +-+ +-+ + + + +-+ +-+-+ +-+-+-+ +-+ +-+-+ +-+ +-+-+ +-+ +-+ + +
| |           |     | |   | | |   |         | |     | |     |       |   | |         |
+ +-+ +-+ +-+-+ +-+-+-+-+-+ + +-+ +-+-+-+ +-+ + +-+ + +-+-+-+-+-+-+ + + + +-+ +-+-+ +
|       |     |         | |   |     |   |   |   | | |   | |       | | |     |   | | |
+-+-+ + + + +-+-+-+-+-+-+ + +-+-+-+-+-+ + + +-+-+ + +-+-+ +-+ +-+ +-+-+ +-+ + +-+ +-+
|     | | |   |   | |   |     |         | | | | | |           | |   |   | | |       |
+-+ + +-+ +-+-+ + + +-+ + +-+-+ + + +-+ +-+ + + + + + + +-+ + + +-+-+-+-+ + + +-+-+-+
|   | |   |   | | |   |   | |   | |   | | |       | | |   | | |     | |   |   |     |
+-+ +-+ + + + + +-+ + +-+-+ +-+-+-+-+-+ + + +-+-+ +-+-+-+-+-+ +-+ + + +-+ +-+ + + +-+
|     | |   |       | |         | |   |     | | | |   |     |   | |     |   |   | | |
+ + +-+-+-+ + +-+-+-+-+-+ +-+-+-+ + +-+-+-+ + + + +-+ + +-+ +-+-+ +-+ +-+-+ + +-+ + +
| |   | |   | |     |     | | |     |         | |       | | |     | |         | |   |
+-+ +-+ +-+ + + +-+-+ +-+ + + +-+ +-+-+-+ +-+ + +-+ + +-+ + + + +-+ +-+ +-+ +-+ +-+-+
| | |   | | | |         | |   |   | |       | |     |     | | |       |   |   | | | |
+ + + +-+ + +-+-+ + +-+-+-+ +-+ + + + +-+-+-+-+-+ +-+-+-+-+ +-+-+ +-+-+-+-+-+ + + + +
| |       | | | | |     |     | | | |   |   | | |   |     |       | |   |     | | | |
+ +-+-+-+-+ + + +-+-+-+ +-+ + + + + +-+-+ +-+ + + +-+ + + +-+ +-+-+ + + + + + + + + +
| | |   | | |   |     | |   |   | | | | |       | |   | |     |       |   | | |   | |
+ + +-+ + + + +-+ +-+ + + +-+-+-+-+ + + +-+-+ + + +-+ +-+ +-+-+-+ +-+-+-+ + +-+-+ + +
| | | |   |     | |   |   |   |     |   |     |   | | |     |     | |     | |   |   |
+ + + + + +-+-+ + +-+-+-+ + +-+-+ +-+-+ + +-+-+ + + +-+ +-+-+-+-+ + +-+ +-+ + + + + +
|   |   | |       |   |   |       |   |     | | |     | | | |       |   |     |   | |
+-+ +-+ +-+-+ + +-+ +-+ +-+-+-+-+ + +-+ + +-+ + + + +-+-+ + +-+-+ +-+-+ +-+-+ +-+-+ +
|   |     | | | | |   |   | |   |       |   |   | |         | |       | | | |   |   |
+ + + +-+ + +-+ + + + + +-+ + +-+ + +-+-+-+-+-+-+-+-+-+-+ +-+ +-+-+ + +-+ + +-+ + +-+
| | | | |         | |   |     | | | |   |             |   |       | |     |     |   |
+-+ + + + +-+-+ +-+ +-+-+ + +-+ + + + +-+-+-+ + +-+ +-+-+-+-+ + +-+-+ +-+-+ + + +-+ +
| | | |   |   |         | |       | |   |   | | | |     |   | |       | |   | |   | |
+ + + +-+ + +-+-+-+-+-+-+-+ +-+-+ +-+ + + + + +-+ +-+-+-+ + + +-+ +-+-+ + +-+-+-+ + +
|   |   |         |   |       |   |   | | | |         |   |   | |       | |     | | |
+ +-+ +-+ + + + +-+ +-+ +-+ +-+-+ +-+ +-+ + + + + +-+-+ +-+ +-+ + + +-+-+ + +-+ +-+ +
|     |   | | |         |   |             |   | |   | |   | | |   |     |   |   |   |
+-+ + +-+-+ + + + + +-+-+-+ +-+ +-+-+ + + +-+-+ +-+-+ +-+ +-+ + + +-+-+ +-+-+-+ + +-+
|   |     | | | | | |       |       | | |     |   |         |   | |     |       |   |
+-+-+-+-+-+-+-+-+-+-+-+-+-+-+-+-+-+-+-+-+-+-+-+-+-+-+-+-+-+-+-+-+-+-+-+-+-+-+-+-+-+-+