+-+-+-+-+-+-+-+
|             |
+ + + + + + + +
| | | | | | | |
+ +-+ +-+-+ +-+
|   |     |   |
+ + +-+-+-+ +-+
| |       |   |
+ +-+-+ + + +-+
|     | | |   |
+ +-+ +-+-+ + +
|   |     | | |
+ + + + + +-+-+
| | | | |     |
+-+-+-+-+-+-+-+