+-+-+-+-+-+-+-+
|   |   |     |
+-+ +-+ + + + +
| |   | | | | |
+ +-+ + + + +-+
|     | | |   |
+ +-+-+ + +-+ +
| | |     | | |
+ + + +-+-+ + +
| |         | |
+ +-+ +-+-+-+ +
|   | |       |
+-+ +-+ +-+-+ +
|       |     |
+-+-+-+-+-+-+-+