+-+-+-+-+-+-+-+-+-+-+-+-+-+-+-+-+-+-+-+-+-+-+-+-+-+-+-+-+-+-+-+-+-+-+-+-+-+-+-+-+-+-+-+-+-+-+-+-+-+-+
| | |           | |         |               |     |           |           |           |   |   |     |
+ + + + +-+-+-+ + + +-+-+-+ + + +-+ +-+-+-+ + +-+ + + +-+-+-+-+ +-+-+-+ + + +-+-+-+-+ + + + + + + + +
| |   |       |   | |     |   | |   |   |   | | | | |           |     | | | |     | |   |   |   | | |
+ +-+ +-+-+-+ +-+-+ + + +-+-+-+ +-+-+ + +-+-+ + + + +-+-+-+-+-+-+ +-+ + + + + +-+ + +-+-+-+-+-+-+ + +
|   |       | |     | |     |   |     | |       | | |           |   |   | |   | | |       |       | |
+-+ +-+-+-+ + + +-+-+-+-+-+ + +-+ +-+-+ + +-+-+-+ + +-+ +-+-+-+ +-+ +-+-+-+-+-+ + +-+-+-+ + +-+-+-+ +
|   |     | | |       |     |         |     |   | |   | |         | |           |       | |       | |
+ +-+ +-+ + + + +-+-+ + +-+-+-+-+-+-+-+-+-+-+ + + +-+ + + +-+-+-+ + + +-+ +-+-+ +-+-+-+ + +-+-+-+ +-+
| |   |   | |   |   |   |                     | |       | |     | | | | | |       |   |   |   | |   |
+ + +-+ +-+-+-+-+ + +-+-+ +-+-+-+-+-+-+-+-+-+-+ + +-+-+-+-+ +-+ + + + + + +-+-+-+ +-+ +-+ + + + +-+ +
|   |   |       | |       |     |       |       | | |       |   | |     |       | |   | | | | |   | |
+-+-+ +-+ + +-+ + +-+-+-+-+-+ +-+ +-+ +-+ +-+-+-+ + + +-+-+-+ +-+ +-+-+-+-+ +-+ + + + + + + + + + + +
|     |   | | |   |           |   | |   | |   |   | |     | |   | |       | |   |   |   |   | | | | |
+ +-+-+ +-+ + + +-+-+-+ +-+-+-+ +-+ +-+ + + +-+ +-+ +-+-+ + +-+ + + +-+-+ +-+ +-+-+-+ +-+-+-+ +-+ + +
|   |     | |   |     |             |   | |     |     |   | |   | | |   |   | | |     |     | |   | |
+-+ +-+-+ + +-+-+ +-+ + +-+-+-+-+-+-+ +-+ + +-+-+-+-+ + +-+ + +-+ + + + +-+ + + + +-+-+ +-+ + + +-+ +
| |     | |     | |   |         |     |   |         | | |   | |   | | |   | | |   |     |   | | |   |
+ +-+-+ + +-+-+ + + +-+-+-+-+-+-+ + +-+ +-+-+-+-+-+ + + +-+ + +-+-+ + +-+ + + +-+-+ +-+-+ +-+ + + + +
|     | | |   |   |       |       | |   | |       | | | |   | |     |   |   |   |     |   |   | | | |
+ +-+ + +-+ + +-+-+-+-+-+ + +-+-+-+ + +-+ + +-+ +-+ + + + +-+ + +-+-+-+ +-+-+-+ + +-+-+ + + +-+ + + +
|   | |     |       |     | | |   | |   | |   |       | | |   |       |   |     |   |   | |   | | | |
+-+ + +-+-+-+-+-+-+ + +-+-+ + + + + +-+ + + +-+-+-+-+-+ + + +-+-+-+-+ +-+ +-+ +-+-+ + +-+-+-+ + + +-+
|   |             |   |     |   |   |   |   |   |       | |   |       |     | |     |       | | |   |
+-+-+ +-+-+-+-+ +-+-+-+ +-+ +-+-+-+-+ +-+ +-+ + + +-+-+-+ +-+ + +-+-+-+-+-+ + + +-+-+-+-+ +-+ + +-+ +
|   |         |         | | |         |   |   | |   |       |   |       |     | |       |       |   |
+ + +-+-+-+-+-+-+ +-+-+ + + + +-+-+-+-+-+-+ +-+ + + + +-+-+-+ +-+ +-+-+ +-+-+-+ +-+-+ + +-+-+-+-+ + +
| |     |       | |   |   | |   |   |     |   | | | |         |   |   |               |       |   | |
+ +-+-+ + +-+-+ +-+ + +-+-+ +-+ + + + + + +-+ + +-+ +-+-+-+-+ + +-+-+ +-+-+-+-+-+-+-+-+-+-+-+-+ +-+ +
| |       |       | |         | | | | | |     |     |       | | |       |     |     |           |   |
+ +-+ +-+-+-+-+-+ + +-+-+-+-+-+ + +-+ + +-+-+-+-+-+-+ +-+-+ +-+ + +-+-+ +-+ +-+ +-+ + +-+-+-+-+-+ +-+
|   |   |     | |   |           |     | |   |       | |   | |     |   |     |   |   |       |   | | |
+ + +-+ + +-+ + +-+ + +-+-+-+-+-+ +-+-+ + + + +-+-+ + +-+ + + +-+-+ + +-+-+-+ +-+ +-+-+-+-+ + +-+ + +
| | |   | | | |   | |     |     |     |   |   |     |     |   |     |   |   |   |           |     | |
+-+ +-+-+ + + + + + +-+-+ + +-+ +-+-+ +-+-+-+-+ +-+ +-+-+ +-+-+ +-+-+-+ + + +-+ +-+-+-+-+-+-+ +-+-+ +
|   |       | | |       | | |       | | |     | |     |   |   | |     | | | |   |   |       |     | |
+ +-+ +-+-+-+ + +-+-+-+-+ + +-+-+-+-+ + + +-+ + +-+-+-+ +-+ + + + +-+ + + + + +-+ + + + +-+-+-+-+ + +
| |   | |     |   | |     |         |   |   |   |       |   | | |   |   | |   |   | | |       |   | |
+ + +-+ + +-+-+-+ + + +-+-+-+-+ +-+ +-+ +-+ +-+ + +-+-+-+ +-+ + +-+ +-+-+ +-+-+ +-+-+ +-+-+ +-+ +-+ +
| | |   | |   |     | | |     | | |   |   | | | |   |     | | | | | |     |               | |   |   |
+ + + +-+ +-+ + +-+-+ + + + + + + + + +-+ + + + +-+ +-+ +-+ + + + + + + +-+-+ +-+-+ +-+-+ + + +-+ + +
|   |   |   |   |     |   | | |   | | |   | | | |   |   |     | | | | |     | |   | |   | |   |   | |
+ +-+-+ +-+ +-+-+ +-+-+-+-+ + +-+ + +-+ +-+ + + + +-+ +-+ +-+-+ + + +-+ +-+ +-+ + +-+ + + +-+-+ +-+ +
|         |       |       | |   | |     | | |   | |   |   | |   | |   | | |     |     | |       |   |
+-+-+-+-+ +-+-+-+-+ +-+-+ + +-+ + +-+-+-+ + +-+-+ + +-+ +-+ + +-+ +-+ + + +-+-+-+-+-+-+ +-+-+-+-+ +-+
|     | | |         |   |   | | |       | |       | | | |   |   |   | |           | |   |       |   |
+ +-+ + + +-+-+ + +-+-+ +-+-+ + +-+-+-+ + +-+-+-+-+ + + +-+ +-+ + + + +-+-+-+-+-+ + + +-+ +-+-+-+-+ +
| |     | |   | | |   |       | |   |   |         | |       |   | | |     |     |   |   |   |     | |
+ +-+-+-+ + + + +-+ + +-+-+-+ + + +-+ +-+-+-+ +-+ + +-+-+-+ + +-+-+ +-+-+ + + +-+-+ +-+ +-+ + +-+ + +
| |   |   | |   |   |       |   | |   |     | |     |   |   | |         | | |   |   |   |   | | | | |
+ + + + +-+ +-+-+ +-+-+-+-+ + +-+ + +-+ +-+ + +-+-+ + + +-+-+ + + +-+ +-+ +-+-+ + +-+ +-+ + + + + + +
| | | | | |       |   |     | |       |   |   |   | | |       | | |   |   |     | | |   | | | | |   |
+ + + + + + +-+-+-+ + + +-+-+ + +-+-+ +-+ + +-+ + +-+ +-+-+-+-+-+ + +-+ +-+ +-+-+ + +-+ + + + + +-+-+
| | |   | |   |     |   |   | | |   |     | |   |   |   |         | |   | |       |   | | | | |   | |
+ + +-+-+ +-+ + +-+-+-+-+ + + +-+ + +-+-+-+ + +-+-+ + + + + +-+-+-+-+ +-+ + +-+-+-+ +-+ + +-+ + + + +
| |   |       |   |       | |     |     |   | |   | | | | |           |   |   |     |   |       |   |
+ +-+ +-+-+ +-+-+ + +-+ +-+-+-+-+-+-+-+ +-+-+ + +-+ +-+ + +-+-+-+-+-+-+-+ +-+ + +-+ + +-+-+-+-+-+-+-+
|   | |   |   | | |   |       |   |   |   |   |         | |       |         | |   | |       |       |
+ + + + + +-+ + + +-+-+ +-+ + + + + + +-+ + + +-+-+-+-+-+ + +-+-+ + +-+-+ +-+ +-+ + +-+-+-+ + +-+-+ +
| | |   |   | | |     | |   |   | | | |   | | |       | | |     | |   |   |   |   | |     | | |   | |
+ + +-+-+-+ + + +-+-+ +-+ +-+-+-+ +-+ + +-+ +-+ +-+-+ + + + +-+ + +-+ +-+-+ +-+-+-+ + +-+ + + + +-+ +
| |       | |   |     |   |       |   |   |   |   |   |   | |   |   |       |       | | |   |   |   |
+ +-+-+ + + +-+-+ +-+-+ +-+ +-+-+-+ + +-+ +-+ +-+ + +-+ +-+-+ +-+-+ + +-+-+-+-+ +-+ + + +-+ +-+ + + +
|   |   | | |     |     |   |   |   |   |   |     | | |       | |   | |         | | | |     |   | | |
+-+-+ +-+ + + +-+-+ + +-+ +-+ + + +-+-+-+-+ +-+ +-+ + +-+-+-+-+ + +-+ + +-+-+-+-+ + + +-+-+-+ +-+ + +
|     | | |   |     |   |     | |         |   |   | |         | | | | |   |     | | |         |   | |
+ +-+-+ + +-+-+ +-+-+-+ +-+-+-+ +-+-+-+ + +-+ +-+ + +-+ +-+-+ + + + + +-+ + +-+ + + +-+-+-+-+-+ +-+-+
|   |   | |   |     | |     |       |   | |   | | |   | |       | | |   | | |   |   |         |     |
+ + +-+ + + +-+-+-+ + +-+-+ +-+-+-+ + +-+-+ +-+ + +-+ + +-+-+-+ + + +-+ + + +-+ +-+ + +-+ +-+-+-+-+ +
| |   | | |       |     |   |   | | | |     |       | |   |   | | |       |   |   |   | | |   |   | |
+-+-+ + + +-+ +-+ +-+-+ + +-+ + + + + + +-+-+ +-+-+-+ + + + + +-+ +-+-+-+-+-+ +-+ +-+-+ + + + + + + +
|     | |   | |   |     |   | | |   | | |     |       | |   |           |   |   |   |   | | |   |   |
+ +-+-+ +-+ +-+ + + +-+-+-+ + + + +-+ + +-+-+-+ +-+-+-+ +-+-+-+-+-+-+-+ + + +-+ +-+ + +-+ + +-+ +-+-+
| |             | | |     |   | |     | |       |     |   |     | |     | |   | | | |     |   | |   |
+ + +-+-+-+-+-+-+-+ + + +-+-+-+ +-+-+ + + +-+-+ + +-+ +-+-+ +-+ + + +-+-+ +-+ + + + +-+ +-+-+ +-+ + +
| | |         |     | |       |   | | | |     | |   |   |   |   | |       |   | | |   |     |     | |
+ +-+ +-+-+-+ + +-+-+-+-+-+ + +-+ + + + + +-+ +-+-+ +-+ + +-+ +-+ +-+-+-+-+ +-+ + +-+ + +-+-+-+-+-+ +
|     |     |   |         | | |   | | | |   |       | |   | |   |         |     | |   | |           |
+ +-+-+ +-+-+-+-+-+ +-+-+ +-+ + +-+ + + +-+ +-+-+-+-+ +-+-+ +-+ + + +-+-+-+-+-+-+ + +-+-+ +-+-+-+-+ +
| |   |     |       | |       | |     |   |           |     |   | |         |     |     |     |   | |
+ +-+ + +-+ + +-+ +-+ + +-+-+-+ +-+-+-+-+ +-+-+-+-+-+ + + +-+ +-+-+ +-+-+ + + +-+-+-+-+ +-+-+ +-+ + +
|   |     |   | | |     |     |   |       | |   |     | | |   |   |   | | |   |       | |     |   | |
+-+ +-+-+-+-+ + + +-+ +-+ +-+ +-+ + +-+-+-+ + + + +-+-+ + + +-+ + +-+ + + +-+-+ + +-+-+ + +-+-+ + + +
| |   |     |   |   | |   |       | |   |   | |       | | | |   |   |   |   |   | |     |   |   | | |
+ +-+ + +-+ +-+-+ + + + +-+ +-+-+-+ + +-+ + + +-+-+-+ +-+ + + + +-+ +-+-+-+ + +-+ + +-+-+-+ + +-+ + +
|   |   |   |   | | | |   | |       | |   |     |   |     | | | |           |   |   |       |   | | |
+ +-+-+-+ +-+ + +-+ +-+-+ + + +-+-+-+ + +-+-+-+-+ + +-+-+-+ +-+ +-+-+-+-+-+ +-+ +-+-+ +-+-+-+ + +-+ +
|     |   |   |     |     | |   |       |   |     | |     | |   |       |   |   |     | |     | |   |
+ +-+ + +-+-+ + +-+-+ + +-+-+-+ + +-+-+-+-+ + +-+-+ + +-+ + + +-+ +-+-+ + +-+ +-+-+ +-+ + +-+-+ + +-+
| | |   |     | |     | |       |   |       |     | |   |   |   | |   | |   | |     |   | |   |   | |
+ + +-+-+ +-+-+ + + +-+-+ +-+-+-+-+ + + +-+-+-+-+ + + + +-+-+-+ + + + + + +-+ + +-+-+ +-+ + +-+-+-+ +
| |   |       | | | |     |       | | |     |     | | | |     | | | | | | |   | |       | |         |
+ + + +-+-+-+ +-+ + + +-+-+-+-+ + + +-+-+-+ + +-+-+ +-+ + + + + + + + + + + +-+ +-+-+-+ + + + +-+-+ +
|   |     |   |   | |   |     | | |   |     |     |     | | |   | | | | | | |         | | | | |     |
+-+-+-+-+ + + + +-+ +-+ + +-+ + +-+-+ + +-+-+ +-+ +-+-+-+-+ + +-+ +-+ + +-+ + +-+-+-+ + + + + +-+ +-+
|     |     | | | |   |   |   |     | | |   |   | |         | |   |   |     |     | | | | | |   |   |
+ + +-+ +-+-+-+ + +-+ +-+-+ +-+-+ +-+ + + + + +-+ + +-+-+-+-+-+ +-+ + +-+-+-+-+-+ + + + + + +-+ +-+ +
| | |   | |     |         |     |       | | | |   | |       |   |   |     |     |   | | | |   | |   |
+ +-+ +-+ + +-+-+-+-+-+-+-+-+-+ +-+-+-+-+ + +-+ +-+ + +-+-+ + +-+ +-+-+-+ + +-+ +-+-+ + + +-+-+ + +-+
|         |                               |     |         |       |         |         |         |   |
+-+-+-+-+-+-+-+-+-+-+-+-+-+-+-+-+-+-+-+-+-+-+-+-+-+-+-+-+-+-+-+-+-+-+-+-+-+-+-+-+-+-+-+-+-+-+-+-+-+-+