+-+-+-+-+-+-+-+
| |     |     |
+ + +-+ + +-+ +
| | | | | |   |
+ + + + + + +-+
| | | |   |   |
+ + + +-+-+-+ +
|   | |       |
+-+-+ + +-+-+-+
|     | |   | |
+ + + + + + + +
| | | | | | | |
+ + +-+ + + + +
| |       |   |
+-+-+-+-+-+-+-+