+-+-+-+-+-+-+-+
|             |
+ +-+-+ + +-+-+
|     | |     |
+ + +-+ +-+ + +
| |   |   | | |
+ +-+ +-+ + +-+
|   |   | |   |
+ +-+-+-+ +-+-+
|       |     |
+ + +-+ + + +-+
| |   | | |   |
+ + +-+ + + +-+
| |   | | |   |
+-+-+-+-+-+-+-+