+-+-+-+-+-+-+-+-+-+-+-+-+-+-+-+-+-+-+-+
|                                     |
+ + +-+ + + +-+-+-+-+ + + +-+ +-+ + +-+
| |   | | |         | | |   |   | |   |
+ + + +-+-+-+-+ + + +-+ + + + +-+ + + +
| | |         | | |   | | | |   | | | |
+ + +-+ +-+-+-+ + +-+ +-+-+ + +-+ + + +
| |   |       | |   |     | |   | | | |
+ +-+-+ +-+-+-+-+ +-+-+-+ + + +-+-+-+ +
|     |         |       | | |       | |
+ + + +-+ + +-+-+ + + + +-+-+-+ + +-+ +
| | |   | |     | | | |       | |   | |
+ +-+ +-+ +-+ + +-+-+ + +-+ + + + +-+-+
|   |   |   | |     | |   | | | |     |
+ +-+ + + +-+ + +-+-+ +-+-+-+-+-+ +-+ +
|   | | |   | |     |           |   | |
+ + +-+-+-+ + +-+-+-+-+-+ +-+ +-+-+-+-+
| |       | |           |   |         |
+ +-+ + +-+-+-+ +-+ +-+ + +-+ +-+ +-+-+
|   | |       |   |   | |   |   |     |
+ +-+ +-+-+ +-+-+ + + +-+-+ +-+ +-+ + +
|   |     |     | | |     |   |   | | |
+ + + +-+ +-+ +-+-+-+ +-+ + + + + + +-+
| | |   |   |       |   | | | | | |   |
+ +-+ +-+ +-+-+ +-+-+-+-+ +-+ +-+-+ + +
|   |   |     |         |   |     | | |
+ + +-+ +-+-+-+ +-+ +-+-+-+-+-+ +-+ +-+
| |   |       |   |           |   |   |
+ + +-+-+ +-+ +-+ + + +-+-+-+-+ + + + +
| |     |   |   | | |         | | | | |
+ +-+-+ + + + + + + +-+ +-+ +-+ + +-+ +
|     | | | | | | |   |   |   | |   | |
+ + +-+-+-+-+-+ + + +-+-+-+ +-+ +-+-+-+
| |           | | |       |   |       |
+ + +-+ + +-+ + + + + + +-+ +-+ +-+-+-+
| |   | |   | | | | | |   |   |       |
+ + + +-+ +-+-+-+ + +-+-+ + + + +-+-+ +
| | |   |       | |     | | | |     | |
+-+-+-+-+-+-+-+-+-+-+-+-+-+-+-+-+-+-+-+