+-+-+-+-+-+-+-+
|             |
+-+-+ +-+ + + +
|       | | | |
+ + +-+ +-+ + +
| | |   |   | |
+ + + + + + + +
| | | | | | | |
+ + + + + +-+ +
| | | | |   | |
+ + + +-+-+ + +
| | |   |   | |
+ + + + + + + +
| | | | | | | |
+-+-+-+-+-+-+-+