+-+-+-+-+-+-+-+-+-+-+-+-+-+-+-+-+-+-+-+-+-+-+-+-+-+-+-+-+-+-+-+-+-+-+-+-+-+-+-+-+-+-+-+-+-+-+-+-+-+-+
| | |   | | |   |   | |   | |       |     | |       | |       | |         |   |   |   |   |         |
+ + +-+ + + +-+ +-+ + +-+ + + +-+-+-+-+ +-+ + +-+-+ + +-+-+-+ + + +-+-+-+-+-+ + +-+ + + +-+ + +-+-+-+
|     |   |   | | |   |             | |           |   |         |     |     | |     | |     | |   | |
+ +-+-+-+ + +-+ + +-+ +-+ +-+ +-+-+ + +-+ + +-+-+-+ + +-+-+ + + + +-+ +-+ + + +-+-+-+ +-+ +-+-+-+ + +
|     |   | |         |     | |     |   | |   |   | |   |   | | | | | | | |   |   |       | |       |
+ +-+ +-+ + +-+-+-+-+ +-+-+-+-+-+-+ + + + + +-+ +-+-+-+ + +-+ + +-+ + + + +-+ + + + + +-+-+ + +-+ +-+
| |   |   |   | |   | |       | |   | | | | |     | | | | | | |     |   |   | | |   |     | | |     |
+ + +-+-+ +-+ + + + + + +-+ + + +-+ + +-+ +-+-+ +-+ + +-+-+ +-+ +-+-+-+ +-+ +-+ +-+-+-+-+-+ +-+-+-+ +
| | |         |   |       | | |   |     |   |       |   |     |     |             | |   |         | |
+ + +-+ +-+-+-+-+ + +-+ + +-+-+ + +-+ +-+-+ +-+ +-+ + + + + + + +-+ +-+-+-+ +-+ + + + +-+ +-+ + +-+ +
| |     |     |   | | | |     | | | |       |   | |   | | | |   |         | | | |   |   | | | |     |
+-+ +-+-+ +-+-+-+-+ + +-+ +-+-+-+ + + +-+-+ +-+ + +-+-+-+-+ +-+-+-+-+ +-+ + + + + + + + + + +-+-+ + +
|     |       |     |     | |       |   |           |   |       | | |   | |   | | |   | |   | | | | |
+-+ +-+-+ +-+-+-+ +-+ + +-+ +-+ +-+ +-+-+ + +-+ +-+ + + +-+ +-+ + + + +-+ +-+-+-+-+-+-+ +-+ + + +-+ +
| |     |       |   | |           | |     | |   |   | |   | |   |     | |   | |   |   |   | |       |
+ + + + + +-+-+-+-+ + + + + +-+-+ +-+ +-+-+-+ +-+-+ +-+-+ + +-+-+-+-+-+ + +-+ +-+ +-+ + +-+-+-+ +-+ +
| | | | |           | | | |   |       |       |   |   |     | |     |       |     | |       |     | |
+ + +-+-+-+ +-+ +-+-+ + + +-+-+-+-+-+ +-+-+-+ +-+ + + +-+-+ + + +-+-+-+-+-+ + +-+ + +-+-+ +-+-+-+-+ +
| |     | | | |   | | | |     |   |   | | | |     | | |   |           | |   | | | | |   |       |   |
+ + + +-+ +-+ + +-+ +-+-+-+ + + +-+-+-+ + + +-+ + +-+-+ +-+ + + +-+-+ + +-+-+ + + + +-+ + +-+-+-+-+ +
|   |   |     |       | |   | |     | |     | | | |   |     | | | |     |     |                   | |
+ +-+-+-+ + + + +-+ +-+ + + +-+ +-+-+ +-+ +-+ +-+-+-+ + +-+ +-+-+ +-+-+ + + +-+ +-+ +-+ + +-+-+-+ + +
|       | | |   |       | |     | | | | | |     |       |   |   |   |     | |   | | | | | |       | |
+ +-+ +-+-+ +-+ +-+ +-+-+-+ +-+ + + + + + + +-+-+-+ + +-+ + + + + + + + +-+-+-+-+ + + + + +-+ +-+-+ +
| | |     |   |   |       | |     |     |   |   |   | | | | | | | | | |         | | |   |   |   |   |
+ + +-+-+ + +-+-+ +-+ +-+-+-+-+ +-+-+ +-+-+ +-+ + + +-+ +-+-+ +-+ + + +-+-+ +-+ + + +-+ +-+-+ + +-+ +
|     |     |   |   | | |         |     |   |   | |   | |         | |     |   | | |   | |   | | |   |
+-+ +-+-+ +-+-+ + + + + + + + + +-+ +-+ + + + + +-+ +-+ +-+-+ + +-+-+-+ + +-+-+ + +-+ +-+-+ +-+ +-+ +
|       | | | | | | | | | | | |   |   |   | | |   |       | | |     |   | |     |   | |         |   |
+ +-+-+-+ + + + +-+ +-+ +-+ +-+-+-+-+-+-+ + + + + +-+ + + + + +-+-+-+ +-+ +-+-+-+ +-+ + + + +-+ +-+ +
|   |           |   | |   |         |     |   | |     | | | |   |   | |   |   | | | | | | | |   |   |
+-+ +-+-+-+ + +-+-+ + +-+ +-+ + + +-+ + +-+-+ + + +-+-+ +-+ +-+ + +-+-+-+-+ +-+ + + +-+ + +-+-+-+ + +
|   | |     | |     |     | | | | | | |     | | |     |         |       |   | | |       |   |     | |
+ +-+ + +-+ + +-+-+ + +-+ + +-+ + + + + + + +-+ + +-+ +-+-+-+-+-+-+-+ +-+ +-+ + +-+-+-+-+-+ + +-+-+ +
|     |   | |     |     |     | |   | | | | | | | |   |     |       |       |       |       |     | |
+-+ +-+-+-+ +-+-+ +-+-+-+-+-+ + + + +-+ +-+-+ +-+-+ +-+ + + +-+ +-+-+-+-+ +-+ +-+-+-+-+ +-+ + +-+-+-+
|   |     | |   |   |       | | | |   |     |   | | |   | |   | |     |                   |     | | |
+-+ + +-+-+-+ + + + + + +-+ +-+-+-+-+-+ +-+-+ + + + +-+ + +-+-+ + +-+-+ +-+-+-+-+ + + +-+ +-+ +-+ + +
|       |     |   | | |   | |   | | | |   | | |   | |   |           | |   |       | |   |   |       |
+-+-+-+ +-+-+ +-+-+-+-+-+ + + +-+ + + +-+ + + +-+ +-+-+-+ +-+-+ +-+-+ +-+-+ + + +-+ +-+-+ + +-+-+ +-+
|         | |       | | | |   | | |         | |   | | |       |       | |   | | | |   | | | | |     |
+ + +-+ + + +-+-+-+-+ + + +-+-+ + + + + +-+ +-+ + + + +-+ +-+-+-+-+ +-+ +-+ + + + +-+-+ +-+-+ +-+-+ +
| |   | |     |           |         | | | |   | |           |           |   | |   |   |         | | |
+-+ +-+ +-+-+-+ +-+ +-+-+ + + +-+-+-+ +-+ + +-+-+-+-+-+-+-+-+-+-+-+ +-+-+-+-+-+ +-+-+ + +-+-+-+ + + +
|     |   | |   | |     |   |     |   |   | |   | |     | |     |   |   | | |   |   |       |   | | |
+-+-+ + +-+ +-+ + +-+ + +-+-+-+ + +-+ + +-+ + +-+ + +-+ + + + +-+ +-+-+ + + + +-+-+ + +-+-+-+ +-+ + +
| |   |     |       | |       | | |   |   | | |     | | |   |               |   | | | |     | | | | |
+ + +-+ +-+-+-+-+-+ +-+ + + +-+ +-+-+-+ + + + +-+ + + +-+-+-+-+-+ +-+ +-+-+-+-+-+ + + + + +-+ + + + +
|   |   |       |   | | | | | | | |   | |   |   | | | | | |         | |   |   |   |     | |       | |
+-+-+-+ + +-+ + + +-+ + +-+-+ + + +-+ + +-+-+ +-+ + + + + +-+ +-+ +-+-+-+ + + + + +-+ +-+ +-+-+ +-+ +
|   |     |   |   |     |   |       |   |     |   | | | | | | |   |   |     | | | |   | |   |       |
+-+ +-+-+-+-+ +-+ + + + +-+ + +-+ +-+-+-+ + +-+-+ +-+ + + + +-+-+ + + +-+ + + + + +-+ + + +-+-+-+-+ +
| | |   |   | |   | | |     | | | | |     |       | |         |   | | | | | |   | |   | | |         |
+ + + +-+-+ +-+-+-+ + +-+-+-+ + + + + +-+-+-+-+ + + + +-+-+ +-+ +-+ + + +-+-+ + +-+ +-+ + + +-+ +-+-+
|       |       | | |   | |   | |       | |   | |   |     | |       | | |     | |   |   | | | | |   |
+ +-+ +-+ + +-+-+ + +-+ + + +-+ + +-+-+ + + + + +-+ + + +-+ + + +-+-+-+ + +-+ +-+ +-+ +-+-+ + + + +-+
| |     | | | |   | | | |     |   |   |   | |   | |   | | |   |   |       |   | | |     |     |     |
+ +-+ +-+-+ + +-+ +-+ +-+-+ + +-+-+ + +-+-+-+ +-+ + + +-+ +-+-+ +-+-+ + +-+-+-+ + + +-+-+ +-+-+ +-+-+
| | |   |       |       |   |   |   | |     | |     | |       |   | | |     | | | |       |     |   |
+-+ +-+ + +-+-+ + +-+-+-+-+-+ +-+-+ + + +-+-+ +-+ +-+ + +-+-+ +-+ + +-+ +-+-+ + +-+-+-+ + +-+ +-+ +-+
|       | |         |     |         |   | |     |   | |   |       |         |       |   | |   | |   |
+ + +-+-+-+-+ +-+ + + +-+ + +-+-+-+ +-+-+ +-+-+-+-+-+ +-+-+-+-+ +-+ +-+ +-+-+ +-+ + +-+-+ + + + + +-+
| | | |       |   |   |       |     | |       | |   | |       |   |   |   | | |   | |     | | |     |
+ + + + +-+ + +-+-+ +-+-+-+ + +-+-+ + +-+-+ + + + +-+ + + +-+-+ + +-+-+-+ + +-+-+-+ +-+-+-+-+ +-+ + +
| | | |   | |     | |       |     |         | |       | | | |   |   |         | |     |           | |
+-+ + +-+ +-+ +-+-+-+-+-+-+-+-+-+-+ +-+-+ +-+-+ +-+-+ +-+ + + +-+-+-+-+-+ +-+-+ + + +-+ + + +-+-+-+ +
|   |   |   |   | |         |       |     |     |   | |       |   |   |   | | | | | |   | | |   | | |
+ + +-+ +-+ +-+-+ +-+ +-+-+ +-+ +-+-+-+-+-+ + +-+ + +-+ +-+ +-+ +-+-+ +-+ + + + + +-+ +-+-+-+ +-+ +-+
| | |         |     |   | | | |   |   | |   | |   |     | | |   | |     |     |   |       |         |
+-+ + +-+ +-+-+-+ +-+-+-+ + + +-+ +-+ + +-+-+-+ + + + + + +-+-+ + +-+ + + +-+-+ +-+-+ +-+ +-+-+-+ +-+
|     | | | |   |   |         |   |     | |     | | | |         | |   | |       | | | | |   |   |   |
+-+ +-+ +-+ + +-+ + +-+ +-+ + + +-+-+ +-+ + +-+-+-+-+ + +-+-+ +-+ + + +-+ +-+-+ + + + + + +-+ +-+-+ +
|           |     | | |   | |   | |   | |     | |     |     | |   | | |   |     | | | | |   |   |   |
+-+-+-+-+ +-+-+ + +-+ +-+ + +-+-+ +-+ + +-+-+-+ +-+-+ + +-+ +-+ +-+-+ + + +-+-+-+ + +-+ + +-+ +-+ + +
|     |   |     | |   |   | |           | |     | |   |   |     |     | | | |   |   | |       |   | |
+-+ + + + +-+ +-+ +-+ +-+ +-+ + +-+-+ +-+ +-+ + + +-+ +-+ +-+ +-+ + +-+ + + +-+ + +-+ + + + +-+ +-+-+
|   |   |   | |     |       | |   | |   | | | |   | |   |   |   | |     | |   |   |   | | |     |   |
+-+-+ + +-+-+ +-+ +-+-+-+-+-+ +-+-+ + + + + + +-+-+ + +-+-+ +-+-+-+ +-+-+-+-+ +-+ +-+ +-+ +-+-+ +-+ +
| |   | | | | | |   |   |     |   |   |     | |   |   | |   | | | |   |     |   |   |         | | | |
+ + + + + + + + +-+ + +-+-+-+ +-+ + +-+-+ +-+ + + +-+-+ +-+ + + + +-+ +-+ +-+-+ + + + +-+ + +-+ + + +
|   | |     | | |   |     |       | |   | |   | |     |   | |   |     |           |   | | | |       |
+-+ +-+-+-+-+ + +-+-+ +-+ + +-+ +-+ +-+ + + + +-+ +-+-+ +-+ + + +-+ +-+-+-+-+-+-+-+-+ + +-+-+-+ +-+ +
| | |     |         | | | | | | |   | |   | |   |     |     | |   | |   | |     | |     |       | | |
+ + +-+ + +-+ +-+ + + + +-+ + +-+-+-+ + +-+ +-+ + +-+-+ + +-+ +-+-+ + + + + + +-+ + + +-+-+-+-+-+ + +
| | | | |     |   | |       |       |   | |   |   | |   |   |         |   | |       | |   |     |   |
+ +-+ +-+-+-+ + + +-+-+ +-+-+ +-+-+-+-+ + +-+ +-+ + + + +-+-+-+-+-+ +-+ +-+ +-+-+ + +-+ +-+ +-+ + +-+
| |         | | | | |           |   |           |   | | | |     |     |   |   |   |     |     | |   |
+ +-+-+-+ +-+-+-+ + + +-+ +-+-+ + +-+ +-+-+ +-+ +-+ + +-+ + + +-+ +-+ + + +-+-+ +-+-+-+ + +-+ +-+ + +
| |   |         | | | |   |   | | | | |     |   |     |   | | |     | | | | |       | |   |   |   | |
+ + +-+ +-+-+ + + + +-+ +-+ +-+-+ + + +-+-+-+-+-+ +-+-+-+ + + + +-+ +-+ + + + + +-+ + + +-+ +-+ +-+ +
| | |   |   | | |   | | | |   |           |     |   |   | | | | | | | | | | | |   | | | |   |   |   |
+ + +-+ + + +-+ + + + + + + +-+-+-+ +-+ +-+-+-+ +-+-+ +-+ +-+ +-+ + + +-+-+ + +-+ +-+ +-+-+ + +-+-+-+
| |       |   | | |   |     | |   | |     |   |     |     |   |   |     |   | | | | |   |   | |     |
+ +-+ +-+-+-+ +-+ + +-+-+-+ + +-+ + + +-+ + +-+-+ + +-+ +-+-+ + + + +-+-+ +-+ + +-+ +-+ + + + + +-+ +
|       | | |   | |     |     |   | |   | |   |   |   |     |   | |     |   | | | |   |   | |   |   |
+-+-+ + + + + +-+ +-+-+ +-+ + + + + + +-+-+-+ + +-+-+ + + +-+-+-+ +-+ +-+ + + + + + +-+ +-+ +-+-+-+-+
|   | |   | |         |     | | |   | |         |       |       | |       | |       |   |     |   | |
+ +-+ +-+ + + + +-+ +-+ +-+ +-+-+ +-+ + + +-+-+ + + +-+-+-+-+ +-+ +-+ +-+ + + +-+-+ +-+ +-+ +-+-+ + +
|       |   | | |   |   |     |     |   | |     | |       |         | |   |   |       |   |         |
+-+-+-+-+-+-+-+-+-+-+-+-+-+-+-+-+-+-+-+-+-+-+-+-+-+-+-+-+-+-+-+-+-+-+-+-+-+-+-+-+-+-+-+-+-+-+-+-+-+-+