+-+-+-+-+-+-+-+-+-+-+-+-+-+-+-+-+-+-+-+-+-+-+-+-+-+-+-+-+-+-+
| |       |       |     |                         |     |   |
+ +-+ +-+ + +-+-+ + +-+ + +-+-+-+-+-+ +-+ +-+-+-+ + +-+ + +-+
|   |   |   |   |   |   |   |       |   | |     |   | | |   |
+-+ +-+ +-+-+-+ +-+-+ +-+ +-+ +-+-+ +-+ + + +-+ +-+-+ + +-+ +
| |   | |       |   | |   |   |   | |   |   |   |   |   |   |
+ +-+ + + +-+-+ + + + + +-+ +-+ +-+ +-+-+-+-+ +-+ +-+ +-+ + +
|   |   | |   |   | | | |   |       |       | |       |   | |
+ + +-+-+ + + +-+-+ + +-+ +-+ +-+-+-+ +-+-+ + +-+ +-+-+ +-+-+
| |   |   | | |   | |     | |   |     |   | |   |   |   |   |
+ +-+-+ + + + +-+ + +-+-+-+ +-+ +-+-+ + +-+ + + +-+ +-+ + + +
|       |   |   |   |         | |   | | |   | |   |     | | |
+ +-+-+-+ +-+-+ + +-+-+-+-+ + + + + + + + +-+ +-+ +-+-+-+ + +
| |     | |     |         | | |   |   | | |   |   |       | |
+ + +-+ +-+ +-+-+-+-+-+-+ +-+ +-+-+-+-+ + +-+ + +-+ +-+-+-+ +
| | |   |   |             |   | |       |   | |   | |     | |
+-+ + +-+ +-+ +-+-+-+-+ +-+ + + + +-+ + +-+ +-+-+ + + + +-+ +
|   |   |   | |       |     | | | | | |   |     |   | | |   |
+ +-+-+ +-+ +-+ +-+-+ +-+-+-+ + + + + +-+-+-+-+ + +-+-+ + +-+
| |   |   |   |   | |       |   | | |           | |     |   |
+ + + +-+ +-+ +-+ + +-+-+ + +-+ + + +-+-+-+-+-+-+ + +-+-+-+ +
| | | |     |       |   | |   | | |       | |   |   |     | |
+ + + +-+-+ +-+-+-+-+ + +-+-+ + + +-+ +-+ + + + +-+ + +-+ + +
| | |   |     |       |     | | |     |   |   |     |   |   |
+ + +-+ +-+-+ + +-+ +-+-+-+ + + +-+-+-+ +-+ +-+-+-+-+-+ +-+ +
| |   |   | | | | | |     |   |     | |   |           | |   |
+ + +-+-+ + + + + + + +-+ +-+-+-+-+ + +-+ +-+-+-+-+-+-+ +-+-+
|   |     | |   |   | |   |     |       | |           |     |
+ +-+ +-+-+ +-+-+ +-+ + +-+-+ + + +-+-+-+ + +-+-+-+-+ +-+-+ +
| |   |   |   |     | |     | |   |     | |         |     | |
+ + +-+ + + + + +-+-+ +-+-+ + +-+-+ +-+ + + +-+-+-+ +-+-+ + +
| | |   |   | | |     | |   | | |   | |   | |   |   |   | | |
+ + + +-+-+-+-+ + +-+-+ + +-+ + + +-+ +-+-+ + +-+ +-+ +-+ + +
| | |     |   | |     | | |   | | |       |   |   | |   | | |
+ + +-+ + + + + +-+-+ + + +-+ + + +-+ + +-+-+ + +-+ + + + + +
| |   | |   |   |   | | |   |   |   | |       | |   | |     |
+ +-+ +-+-+-+ +-+ + + + +-+ +-+-+-+ +-+-+-+ +-+ + + + +-+-+ +
| | | |     |   | |     |   |     |       | |   | | | |   | |
+ + + + +-+ +-+-+ +-+-+-+ +-+ + +-+-+-+-+ +-+ +-+ +-+ + + + +
| | |   | |       | |     |   |         |   | |       | | | |
+ + +-+-+ +-+-+-+-+ + +-+-+ +-+-+-+-+-+ +-+ + +-+ +-+-+ + + +
|   |     |         |     | |         |     |   | |   | | | |
+-+ +-+ + +-+ +-+ +-+-+-+ + + + + +-+-+-+-+-+-+ + + +-+ + +-+
| |     |   | | |       |   | | | |     |       |   |   |   |
+ +-+-+-+-+ + + +-+-+-+ +-+-+ + + + +-+ + +-+ +-+-+-+ +-+-+ +
|         | |       |     |   | | |   |   | | |   |       | |
+-+-+-+ +-+ + +-+-+-+ + +-+ +-+ +-+-+ +-+-+ + + + + +-+-+-+ +
|       |   | |     | | |   | |     |   |   |   |   |     | |
+ + +-+-+ +-+ + +-+ + +-+ +-+ +-+-+ +-+ + +-+-+-+-+-+ +-+ + +
| | |   |   | |   |   |   |       | |   |     |     |   |   |
+ + + + +-+ + +-+ +-+ + +-+ +-+-+ + + +-+-+-+ + +-+ +-+ +-+ +
| | | |   | | |   |   |     |   | |   |       |   |     | | |
+ +-+ + +-+ + + + +-+-+-+ +-+ + + +-+-+ + +-+-+-+ +-+-+-+ + +
|     |     | | | |       |   | |   |   | |     |   |     | |
+ +-+-+-+-+-+ + +-+ +-+-+-+ +-+ +-+ +-+-+ + +-+ + + + +-+ + +
|   |     |   |       |   | |   |         | | | | | |   | | |
+-+ + +-+ +-+-+-+-+ +-+ + + + +-+-+-+-+ +-+ + + + + + + +-+ +
| |   |   |   |   | |   |   | |     |   |   |   | | | |     |
+ +-+-+ +-+ + + + +-+ +-+-+-+ + +-+ +-+-+ +-+ +-+-+ + +-+-+-+
|           |   |     |         |         |         |       |
+-+-+-+-+-+-+-+-+-+-+-+-+-+-+-+-+-+-+-+-+-+-+-+-+-+-+-+-+-+-+