+-+-+-+-+-+-+-+
|       |     |
+-+-+-+ +-+ + +
|     |     | |
+ +-+ +-+-+-+ +
|   | |     | |
+ + +-+ +-+ + +
| |   |   | | |
+ +-+ +-+ + + +
|   |     |   |
+-+ +-+-+-+-+-+
| | |     |   |
+ + + +-+ +-+ +
|     |       |
+-+-+-+-+-+-+-+