+-+-+-+-+-+-+-+-+-+-+-+-+-+-+-+-+-+-+-+-+-+-+-+-+-+-+-+-+-+-+-+-+-+-+-+-+-+-+-+-+-+-+-+-+-+-+-+-+-+-+
| |         |     |           | |       |               |     |         |               |       |   |
+ +-+ +-+-+ +-+ + +-+-+ +-+-+ + + +-+ +-+ + +-+-+-+-+-+ +-+ + +-+-+-+ + +-+ +-+ +-+-+-+ +-+-+ + +-+ +
|   |     |     | |     |   | |     |     |   |   |   |   | |       | |   | | | |   |   |   | | |   |
+-+ +-+-+ +-+-+-+ + +-+-+ +-+ +-+-+-+-+-+-+-+ + + +-+ +-+ + +-+-+-+ + +-+ + + + +-+ + +-+ + + + + +-+
|   |     |     |   |   |   |   |           | | |   | |   |   |   | | | | |   |   |   |   |   | |   |
+ +-+ +-+-+-+ + +-+-+ + + + +-+ + +-+-+-+-+ + + +-+ + + +-+-+ + + + + + + +-+ +-+ + +-+-+ +-+-+ +-+ +
|     | |     | |     |   |   | | |       |   | | |   |       | | | | | | |   | | |     | |         |
+-+-+-+ + + +-+ +-+-+-+-+-+-+ + + +-+ +-+ +-+-+ + +-+ +-+-+-+-+-+ + + + + + +-+ + +-+-+ + +-+-+-+-+ +
|         | |                 |   |   |         |   |   |   |   | |   | | |     |     | |       |   |
+ +-+-+-+-+ + +-+-+-+-+-+-+-+-+-+-+ +-+-+-+-+-+-+ +-+-+ + + + + + +-+-+ + +-+-+ +-+-+ + +-+ +-+ + +-+
| |   |     |   |   |       |     |       |     |     |   | | |   |       |   | | |   |   | | | | | |
+ + +-+ +-+-+-+ + + + +-+-+ + +-+ + +-+-+ + +-+ + +-+ +-+-+ + + +-+ +-+-+-+ + + + + +-+-+ + + + + + +
|   |   | |     | |   |   |   |   |   | |     | | |     | | | | |   |     | | |   |     | |   | | | |
+-+-+ +-+ + +-+-+ +-+-+ + +-+-+ + +-+ + +-+-+-+ +-+ +-+ + + + + + +-+-+ + + +-+ +-+-+-+ + +-+-+ + + +
|     |     |   |       |   |   |   |     |     |   | | | |   | | |     |   |   |     | |     | |   |
+ +-+ +-+-+-+ + +-+-+-+-+-+ + +-+-+-+-+ +-+ +-+-+ +-+ + + +-+-+ + + + +-+-+-+ +-+ +-+ + +-+-+ + +-+-+
|   | |       |       | |   |     |     |   |   |   | | | |     | | |     |   |   | | | |     |     |
+-+ +-+ +-+-+-+ +-+-+ + + +-+-+-+ + +-+-+ +-+ + +-+ + + + + +-+-+ + +-+-+ + +-+ +-+ + + + +-+-+-+-+ +
|   |   |     | |   |   |   |   |   |     |   |     |     | |     |     | | | |   |     |     |     |
+ + + +-+-+-+ + + + +-+-+-+ + + +-+-+ +-+-+ + +-+-+-+-+-+ + + +-+-+-+-+ + + + +-+ +-+-+-+-+-+ + +-+ +
| | |     |   |   | |     | | |     | |     |           | | | |     |   |   |   |   |   |     | | | |
+ + +-+-+ + + +-+-+ + +-+ + + +-+ +-+ +-+-+-+-+ +-+-+-+ +-+ + + +-+ + +-+-+-+-+ +-+ + + + +-+-+ + + +
| |     |   |     |   | |   |   |   | |       |       |     |   |   |     |     | | | |   |     | | |
+ +-+-+ +-+-+-+-+ +-+-+ +-+-+-+-+-+ + + +-+-+ +-+-+-+ +-+-+-+-+-+ +-+-+-+ +-+ + + + +-+ +-+-+ +-+ + +
| |   | |     |   |     |   |       |   |   |     | | |   |     |   |         |   |   |       |     |
+ + + + +-+ + + +-+ +-+ + + + +-+-+ +-+-+ + +-+-+ + + + + + +-+ +-+ +-+ +-+-+-+-+ +-+ +-+-+ +-+-+-+ +
|   | | |   | | |   | |   | |     |   | | |     | |   | |   |     |   |   |     |   | | |   |     | |
+ +-+ + + +-+ + +-+ + +-+-+ + +-+ +-+ + + + +-+-+ +-+ + +-+-+ +-+-+-+ +-+-+ +-+ + +-+ + + +-+ +-+ +-+
|   | |   |   |     |     | |   |   | | | |     |   | |   | | |   |   |   | | | | |   |     | | |   |
+ +-+ +-+-+-+ +-+-+-+-+ +-+ +-+ +-+ + + + +-+-+ +-+ +-+-+ + + + + + +-+ + + + + +-+ +-+-+-+-+ + +-+ +
| |   |     | |         |   |   | | | | |   | |   |         | | |   |   |   | |   | |             | |
+ + + + +-+ +-+ +-+ +-+-+ +-+ +-+ + + + +-+ + + +-+-+-+-+-+-+ + +-+-+-+ +-+-+ +-+ + + +-+-+-+-+-+-+ +
| | | |   |     |   |   |   |     | |     | | |     |   |     |   |   |     |   |   | |   |     |   |
+ + + +-+ +-+-+-+ +-+ + +-+ +-+ +-+ + +-+-+ + +-+-+ + + + +-+-+-+ + + +-+-+ + +-+-+ + + + + +-+ + + +
| | |   |     |   |   |   |   | |   | |           | | |   |     |   | |     |   |   |   | |   | | | |
+ + +-+-+-+-+ + + + +-+ + +-+ + + +-+-+ +-+-+-+-+-+ + +-+-+ +-+ +-+-+ + +-+-+ + + +-+-+-+ +-+ + + + +
| |           | | | |   |   | | | |   |   |       | |   |     | |   | | |   | | | |   | |   | | | | |
+ +-+-+-+-+-+ + + + + +-+-+-+ +-+ + + + +-+ +-+-+ + +-+ + +-+-+ + + + + + +-+ + + + + + +-+ + + + + +
|   |       | | | | |       |   |   |   |   |   |     | | |     | |   | |   | |   | |   |   | |   | |
+-+ + +-+-+ +-+ +-+ +-+-+-+ +-+ + +-+-+-+ +-+ +-+-+-+ + + + +-+-+ +-+-+ + + + +-+-+ +-+ + +-+ +-+-+ +
| | |   | |   | |   |     |   | |     |   | |         |   | |     |     | | | |     |   | | |   |   |
+ + +-+ + +-+ + + +-+ +-+ +-+ + +-+-+ + +-+ + +-+-+-+-+-+-+ + +-+-+-+-+ + + + + +-+-+-+-+ + +-+ + +-+
| |   | |     | | | |   | | |   |   | |   | |   |         | | |       | | |     |     |     |   | | |
+ + +-+ + +-+-+ + + + + + + +-+-+ + +-+-+ + +-+ + +-+ +-+ + + + +-+ + + + +-+-+-+ +-+ + +-+-+ +-+ + +
| | |   |       | |   | |     |   |   |   | |   | |   | | |   | |   | | |   |     | |     |   |     |
+ + + + +-+-+-+ + +-+ + +-+-+-+ + +-+ + +-+ + +-+ + +-+ + +-+-+-+ +-+ + + +-+ +-+-+ +-+-+-+ +-+-+-+ +
|   | | |     | |   | | |       | |     |   | | | | |   | |       | | | | |   |     |     |     |   |
+ +-+ + + +-+ +-+-+ + + + +-+-+-+ +-+-+-+-+ + + + + + + + + +-+ +-+ + + +-+ +-+ +-+-+ +-+ + +-+ + +-+
|   | | | | |       | |       | |   |       | |   | | |   |   |   |   |   | |       | |   |   | |   |
+-+ + +-+ + +-+-+-+-+-+-+-+-+ + +-+ + +-+-+ + + +-+ + +-+-+-+-+ + + +-+ + + + +-+-+ + + +-+-+ + +-+ +
|   |   |     |         |   |     | | |   | | | |   | |       | | |   | | | |   |   | | |     |   | |
+-+-+ + +-+-+ + +-+-+-+ + + +-+-+ + + +-+ + + + + +-+ + +-+-+ + + +-+ + + + +-+-+ +-+ + +-+-+-+-+ + +
|   | | |   | | |     | | | |     | |   |   | | | | | | | |   | |   | | |   |   |   | |     |     | |
+ + +-+ + + + + + +-+-+ + + + +-+-+ +-+ + +-+ +-+ + + + + + +-+-+-+ + + +-+-+ + +-+ + +-+-+ + +-+-+ +
| |     | | | | |     | | | | |   | |   |   |     | |   | | |       | |       |     |   |   |     | |
+ +-+-+-+ + + + +-+ + + + +-+ + + + + +-+-+-+-+-+-+ +-+-+ + + +-+-+-+ + +-+-+-+-+-+-+-+ + +-+ +-+ + +
| |       | | |   | | | |     | |   |     |           |   |   |   |   | |   |         | | |     | | |
+ + +-+-+-+ + +-+ + + + + +-+-+ +-+-+ +-+ + +-+-+-+ + +-+ +-+-+ +-+ +-+-+ + + +-+-+-+ + + +-+-+-+ +-+
|   |     |   |   | | | |     | |   |   |   |     | |   |       |   |     |   |     |   |   |   |   |
+ +-+ +-+ +-+-+ +-+-+ + + +-+-+ + + +-+ +-+-+ +-+ + +-+ +-+ +-+ + +-+ + +-+-+-+ +-+-+-+-+-+ + + + + +
|     |   |     |     | | |     | |   | |     | | | |     | |   | | | | |           |     |   | | | |
+-+-+-+ +-+-+ +-+-+ + + +-+ +-+-+ +-+ + +-+ +-+ + + +-+-+ + +-+-+ + + + + +-+-+-+-+ + +-+ +-+-+ + + +
| |     |     |     | | |   |     |   |   |   |   |   | |   |     |   | |   |     |   |       | | | |
+ + +-+-+ + +-+-+ +-+ + + +-+-+-+ + + +-+ +-+ + +-+-+ + +-+ + +-+-+-+-+ +-+ + +-+ +-+-+ +-+-+ + +-+ +
| | |     | |   |   | |   |     | | |   |     | |   | |     |     |     |   | | |     |   | | |   | |
+ + +-+ +-+-+ + +-+ +-+-+-+ + + +-+ +-+ +-+-+-+ + + + +-+ +-+-+-+ + +-+-+ +-+ + +-+-+ +-+ + + +-+ + +
|   |   |     |   | |   |   | |     | |       |   | |   | |     | |   | | |   | |     |   | |   | | |
+ +-+ +-+ +-+-+-+ + + + + +-+ +-+-+-+ +-+-+-+ +-+-+ +-+ +-+ + +-+ +-+ + + + +-+ + +-+-+ +-+ +-+ + + +
|   |     |       |   |     |     | |   |       |   | |     |   |     |   | |   |   |   |       | | |
+-+ + +-+-+ +-+-+-+-+-+-+-+-+ +-+ + + + + +-+-+-+ +-+ +-+-+-+-+ +-+-+-+-+-+ + +-+-+ + + +-+-+ +-+ + +
|   |   | | |       |       |   | |   |     |     |     |         |         |     | | | |   | |   | |
+ +-+-+ + + + +-+-+ + +-+-+ +-+ + + +-+-+-+ + +-+-+ +-+ + +-+-+-+ + +-+-+-+-+ + + + + + + + +-+ +-+ +
|     |   | |   | | |   | | |   | | |     | | |     |   |     | | | |       | | | |   | | |     |   |
+-+-+ + +-+ +-+ + + +-+ + + + +-+ +-+ +-+ + + + +-+-+ +-+-+-+ + + + + +-+-+ +-+ + +-+-+ + +-+-+-+-+ +
|     | |     | | |     | | |   |   |   | | | |     |   |   | |     | | |   |   |   |   |   |       |
+ +-+-+ + +-+-+ + +-+-+-+ + +-+-+-+ + +-+ + + +-+-+-+-+ + + + +-+-+ + + + +-+ + +-+-+ +-+-+ +-+-+ + +
|   |   |     | |         |       |   |   | |   |     |   | |     | | | |   | | |         |       | |
+-+ + +-+-+-+ + + +-+-+ +-+-+ +-+ + +-+ +-+-+-+ + +-+ +-+-+ +-+-+ +-+ + +-+ + +-+ +-+-+-+-+-+-+-+-+ +
|   |   |     |   |   | |   | |   | |   |     | | | |       |   | |     |   | |   | |       |       |
+ +-+-+ + +-+-+-+ + + + + + +-+ +-+-+ +-+ + +-+ + + +-+-+-+ + + + + +-+-+ +-+ + +-+ + +-+-+ + +-+-+-+
|     | |         | | | | | |   |     |   |     | | |     |   | | | |     |   |     |     |   |     |
+-+-+ +-+-+ +-+-+-+ + +-+ + + +-+ + +-+ +-+-+-+-+ + + +-+ +-+-+ + + + +-+-+ +-+-+-+ +-+-+ +-+-+-+-+ +
|   |     | |       |   | |   |   |     |         | | | |       |   | |     |       |   | |       | |
+ + +-+-+ +-+ +-+-+-+-+ + +-+-+-+-+ +-+-+ +-+-+-+-+ + + +-+-+-+-+-+-+ + +-+-+ +-+-+-+-+ + +-+ +-+ + +
| |     | |   |       | |         | |     |       | |   |           | |       |         | |   | | | |
+-+-+ + + + +-+ +-+-+ + + +-+-+-+ + +-+ +-+-+ + + + +-+ +-+ +-+-+-+-+ + +-+-+-+ +-+-+-+ + + +-+ + + +
|   | | | | |     |   | | |     | |   |     | | |     |   |     |     |     |     |     |   |   |   |
+ + +-+ + + +-+-+-+ +-+ + + +-+ + +-+ +-+-+ + + +-+-+-+-+ + +-+ + +-+-+-+-+ +-+-+ +-+-+ +-+-+ + +-+ +
| |   | | | |       |   | | | |   | |       | |     |   | | |   | |       |     | |   |     | | |   |
+ +-+ + + + + +-+-+-+ +-+ + + +-+-+ +-+-+-+-+ +-+-+ + + + + + + + + +-+-+ +-+-+ + + + +-+-+-+ + + +-+
| | | | | | |       |   | | |         |     | |   |   | | | | | |   |   |     |   | | |       |   | |
+ + + + + + +-+ +-+ +-+ + + +-+ +-+-+-+ + +-+ + + +-+-+ + + + +-+-+-+ +-+-+-+ +-+-+ + + +-+-+-+-+-+ +
| |   | | |   | |     | | |   |   |   | |   |   |     |   | |       |   |   |   |   |   |       |   |
+ + +-+ + +-+ +-+ +-+-+ +-+-+ + + + + + +-+ +-+-+-+-+ +-+-+ +-+-+ + + + + + +-+ + +-+-+-+-+ +-+ +-+ +
| |     |   |   | |     |     | |   |   | |   |     | |   | |   | |   |   |   |   |     |   | | |   |
+ +-+-+-+-+ + + + + +-+-+ +-+-+ +-+-+-+-+ +-+ + +-+ + + + +-+ + +-+-+ +-+-+ + +-+-+ +-+ + +-+ + + +-+
|     |     | | |   |     |   | |       |   | | |   | | |     |     | |     | |     | | |   | | |   |
+ +-+ + +-+-+-+ + +-+ +-+-+ +-+ +-+ +-+ +-+ + + + +-+ + +-+-+-+-+-+ +-+ +-+-+ + +-+-+ + +-+ + + +-+ +
|   |           |     |             |       |   |       |               |       |           |       |
+-+-+-+-+-+-+-+-+-+-+-+-+-+-+-+-+-+-+-+-+-+-+-+-+-+-+-+-+-+-+-+-+-+-+-+-+-+-+-+-+-+-+-+-+-+-+-+-+-+-+