+-+-+-+-+-+
|     |   |
+-+-+ +-+ +
| | |     |
+ + + +-+ +
|   | |   |
+ +-+ + +-+
|     |   |
+-+ + +-+ +
|   | |   |
+-+-+-+-+-+