+-+-+-+-+-+-+-+-+-+-+-+-+-+-+-+-+-+-+-+-+-+-+-+-+-+-+-+-+
|                                                       |
+ +-+ + +-+ + +-+ + +-+-+ + + + +-+ + +-+ + +-+-+-+ + + +
|   | |   | |   | |     | | | |   | |   | |       | | | |
+ + +-+-+-+ + + +-+-+-+-+ +-+ + + +-+-+-+ + +-+ + + + + +
| |       | | |         |   | | |       | |   | | | | | |
+ + + + + + + +-+-+ + + + +-+ +-+ +-+ + + +-+ +-+-+ +-+ +
| | | | | | |     | | | |   |   |   | | |   |     |   | |
+ + +-+ + + +-+ +-+ + + +-+ +-+-+-+-+-+-+ +-+-+-+-+-+-+ +
| |   | | |   |   | | |   |             |             | |
+ + +-+-+-+-+-+ +-+-+-+-+ + + +-+ +-+ + +-+ +-+-+ + + +-+
| |           |         | | |   |   | |   |     | | |   |
+ +-+ + + + + +-+ +-+-+ + + + +-+ +-+ +-+ +-+-+ +-+-+ + +
|   | | | | |   |     | | | |   |   |   |     |     | | |
+ +-+ +-+-+-+ +-+-+-+-+ +-+ +-+ + +-+-+-+ +-+ +-+ + + + +
|   |       |         |   |   | |       |   |   | | | | |
+ + +-+ + + +-+ + +-+-+-+ +-+-+-+ + + +-+ + +-+-+-+-+-+-+
| |   | | |   | |       |       | | |   | |             |
+ +-+-+-+-+ +-+ + +-+ +-+-+-+ + +-+ + +-+-+ +-+ + +-+-+ +
|         |   | |   |       | |   | |     |   | |     | |
+ + +-+ +-+-+ +-+-+-+ +-+-+-+-+-+-+-+ + +-+ +-+-+ +-+ +-+
| |   |     |       |               | |   |     |   |   |
+ +-+ + + + + +-+-+-+ +-+ +-+-+-+-+-+-+-+ +-+-+-+-+ +-+ +
|   | | | | |       |   |               |         |   | |
+ + +-+-+-+ + + + +-+ + + + + +-+-+ +-+-+ + + + + + + + +
| |       | | | |   | | | | |     |     | | | | | | | | |
+ + +-+ +-+ + +-+ +-+-+-+-+ +-+-+ +-+ +-+-+-+-+ + + + + +
| |   |   | |   |         |     |   |         | | | | | |
+ +-+-+ + +-+ + +-+ + + + +-+ +-+-+-+-+ +-+ +-+-+ + +-+ +
|     | |   | |   | | | |   |         |   |     | |   | |
+ +-+ +-+ + +-+-+-+-+ + + + +-+ +-+-+ +-+-+ + +-+-+ + + +
|   |   | |         | | | |   |     |     | |     | | | |
+ +-+ +-+ + +-+-+-+-+-+ +-+-+-+-+-+ + + +-+ +-+-+-+ + +-+
|   |   | |           |           | | |   |       | |   |
+ +-+-+ +-+-+ + + + + + + +-+ +-+-+ +-+ +-+ +-+-+ + +-+ +
|     |     | | | | | | |   |     |   |   |     | |   | |
+ + + + + +-+-+ + + +-+-+-+-+-+-+-+-+-+-+ + +-+ +-+ + +-+
| | | | |     | | |                     | |   |   | |   |
+ +-+-+-+ +-+-+-+-+ +-+ + +-+-+ +-+-+ +-+-+-+-+-+ +-+ + +
|       |         |   | |     |     |           |   | | |
+ +-+-+ + +-+-+ + +-+-+-+-+ + +-+ + + + + +-+-+-+-+ + +-+
|     | |     | |         | |   | | | | |         | |   |
+ + + +-+-+ + + + +-+-+-+-+ +-+-+ +-+-+ + + +-+-+-+-+-+-+
| | |     | | | |         |     |     | | |             |
+ + + +-+-+ + + +-+-+ +-+-+ +-+-+ +-+-+ + +-+-+ + +-+-+-+
| | |     | | |     |     |     |     | |     | |       |
+ + + +-+-+ + +-+-+-+-+ +-+ + +-+ +-+ +-+-+ + + +-+-+ + +
| | |     | |         |   | |   |   |     | | |     | | |
+ + +-+ + +-+-+-+-+ +-+ + + + + + + + + +-+ + + + + +-+ +
| |   | |         |   | | | | | | | | |   | | | | |   | |
+ +-+-+ + + +-+-+-+ + +-+-+-+ +-+ +-+-+ +-+ +-+ + +-+-+ +
|     | | |       | |       |   |     |   |   | |     | |
+ + + +-+-+-+ +-+-+-+-+-+-+ + + + + +-+ +-+ + + +-+ + +-+
| | |       |             | | | | |   |   | | |   | |   |
+ +-+-+-+ + + +-+-+-+ +-+ +-+ +-+ + + +-+-+-+-+ + +-+-+-+
|       | | |       |   |   |   | | |         | |       |
+-+-+-+-+-+-+-+-+-+-+-+-+-+-+-+-+-+-+-+-+-+-+-+-+-+-+-+-+