+-+-+-+-+-+-+-+-+-+-+-+-+-+-+-+-+-+-+-+-+-+-+-+-+-+-+-+-+-+-+-+-+-+-+-+-+-+-+-+-+-+-+-+-+-+-+-+-+-+-+
|                                                                                                   |
+ + + +-+ + + + + +-+ +-+ +-+ + + + + +-+ +-+-+ + + + +-+ + + + + + + + + +-+ + + + +-+ + +-+ + + + +
| | | |   | | | | |   |   |   | | | | |   |     | | | |   | | | | | | | |   | | | |   | | |   | | | |
+ + + + + + + + + + +-+ + + + +-+ + + +-+ + + +-+ + + + + +-+ +-+-+-+-+ +-+ +-+ +-+-+-+ +-+ +-+ + + +
| | | | | | | | | | |   | | | |   | |   | | |   | | | | | |           | |   |       |     | |   | | |
+ + + + + +-+ +-+-+ + + + +-+-+ + + + + + + +-+ + + +-+-+-+-+ + + +-+ + + + +-+ + + + +-+ +-+-+-+ +-+
| | | | | |     |   | | | |     | | | | | |   | | |         | | |   | | | |   | | | | |   |         |
+ +-+ + +-+ + + + + +-+ + +-+ + + +-+ + + +-+-+-+ + +-+-+-+ +-+ + +-+-+ +-+ + + + +-+-+-+ + + +-+-+ +
| |   |   | | | | |   | |   | | |   | | |     |   | |         | | |       | | | | |       | |     | |
+ +-+ + +-+ + + + + +-+-+ +-+ + + + + + + +-+ + +-+ +-+ +-+ +-+-+-+ + + +-+-+-+ + + + + + + +-+ +-+-+
| |   | |   | | | |     |   | | | | | | |   | |   | |     |       | | |   |     | | | | | | |       |
+ + + +-+ + + + +-+-+-+ + + +-+ +-+ +-+ +-+ + +-+-+-+ + +-+ +-+-+-+ +-+ + + + +-+-+ + +-+ +-+ + + + +
| | | |   | | |   |     | | |     | |   |   |     |   |   |       |   | | | |     | | |   |   | | | |
+ + + + + + +-+ +-+ + +-+ + + + + +-+ + + + +-+ + + + + +-+-+ +-+ +-+ + + +-+-+ +-+ + + + + +-+-+ + +
| | | | | | |     | | |   | | | |   | | | |   | | | | |   |     | |   | |   |     | | | | | |     | |
+ +-+-+ + + + +-+ + + + +-+ + + +-+ + + + + +-+ +-+ + + + + +-+ +-+ + +-+-+-+ +-+ +-+ + + +-+ +-+ + +
|     | | | | |   | | |   | | | |   | | | | |     | | | | | |   |   |   |       | |   | |   | |   | |
+-+ + + + +-+ +-+ + + +-+ +-+-+-+ + + + +-+ +-+ +-+ + +-+-+ +-+-+ + +-+ +-+-+ + +-+ + +-+-+-+-+ + + +
|   | | |   |   | | | |       |   | | | |   |   |   | |     |     | |   |     |   | | |         | | |
+ + + +-+ + + + +-+-+ + + + + +-+ + +-+ +-+-+ + + + + +-+ + +-+ +-+-+ + + +-+-+ + + + +-+-+ + + + + +
| | | |   | | |   |   | | | | |   | |   |     | | | | |   |   | |     | |   |   | | |     | | | | | |
+ + + + +-+ + + + + + +-+ + + + + +-+ + + + + +-+ + +-+-+ +-+-+-+ +-+ + + + + + + + + +-+ +-+ + +-+ +
| | | | |   | | | | |   | | | | | |   | | | | |   |   |         | |   | | | | | | | |   |   | | |   |
+ +-+-+ + +-+ + +-+-+ + +-+ +-+-+ + + +-+-+ + + + +-+ + + + + + +-+ +-+ +-+ + + + + + + +-+ + + + + +
|   |   | |   |   |   | |   |     | |   |   | | | |   | | | | |   |   | |   | | | | | | |   | | | | |
+ + + +-+-+ +-+ + + +-+ + + + + + + + +-+ + + +-+ +-+ + +-+-+ +-+ + + + + + +-+-+ + + +-+ +-+-+ + + +
| | | |       | | | |   | | | | | | | |   | |   | |   |     | |   | | | | |     | | |   | |     | | |
+ + + +-+ + +-+ + + + +-+ + + +-+ + +-+ + + + + + + + + +-+-+ +-+-+ + + + +-+ +-+ +-+ + + +-+ +-+ + +
| | | |   |   | | | |   | | | |   |   | | | | | | | | |     |     | | | |   | |     | | |   |   | | |
+ + + +-+-+-+-+ + + + + +-+ +-+ + +-+ + +-+ +-+-+ +-+ + +-+ + + + + + + +-+ +-+ +-+ + + +-+ + + +-+-+
| | |         | | | | | |     | |   | |   | |     |   | |   | | | | | |   | |     | | |   | | |     |
+ + +-+ + + + + + + + + +-+ +-+ + + + +-+-+-+ +-+ +-+ + + +-+ +-+ +-+ + + +-+-+ +-+ + + +-+ + +-+ + +
| | |   | | | | | | | |   | |   | | | |       |     | | |   | |     | | |     | |   | | |   | |   | |
+ + +-+ + +-+-+-+ +-+-+-+-+-+ + + +-+ + +-+ + + +-+ + + +-+-+ + + + +-+-+-+ + + + + + +-+-+ +-+ + + +
| |   | |       |         |   | |   | | |   | | |   | | |     | | | |       | | | | |   |   |   | | |
+ + + +-+ + + +-+-+ +-+ + + +-+ + + +-+ +-+ + +-+ + +-+-+ + + + +-+ + + +-+ + + + + + +-+ + +-+ + + +
| | | |   | | |       | | | |   | | |   |   | |   | |     | | | |   | |   | | | | | | |   |   | | | |
+ + +-+-+ + + +-+-+ +-+-+ + +-+ +-+ +-+-+-+ + +-+ +-+ + + + + + +-+ + + + + + +-+ + + +-+ + +-+ + + +
| |     | | | |         | |   |   |       | | |   |   | | | | | |   | | | | | |   | | |   |   | | | |
+-+ + + +-+-+ + + +-+ + +-+ + + + + +-+-+ + + + + + +-+ + +-+ +-+ + + +-+ +-+ +-+-+ + +-+-+-+ + + + +
|   | | |     | |   | |   | | | | |   |   | | | | |   | | |     | | |   | |       | | |       | | | |
+ +-+-+-+-+-+ + + + +-+-+ + +-+ +-+ +-+ + + + + + +-+ +-+-+-+-+ + +-+ + + + +-+ +-+-+-+ + + + +-+ + +
|           | | | |     | |   |   |   | | | | | |   |     |     | |   | | | |     |     | | |   | | |
+ + + + + + +-+ +-+ + +-+-+ +-+-+ +-+ +-+ + + + +-+ + +-+ + + + + +-+ + + + +-+ + +-+-+ + +-+-+ + + +
| | | | | | |     | |   |     |     | |   | | | |   | |   | | | | |   | | |   | | |     | |     | | |
+-+-+-+ +-+ + +-+ + + + + + + + + + +-+ +-+ + + + + + + + +-+ + +-+-+ + + +-+ + +-+ + + + + + + + + +
|         | |   | | | | | | | | | | |     | | | | | | | |   | | |     | | |   |   | | | | | | | | | |
+ + + + + + +-+ + + + + +-+ + + + + + +-+ + + + + + + +-+ +-+ + + + + + + + +-+ + + +-+-+ + +-+ +-+ +
| | | | | |   | | | | |   | | | | | |   | | | | | | |   | |   | | | | | | | |   | |   |   | |   |   |
+-+-+-+-+-+ +-+ + +-+ +-+ + + +-+-+-+-+-+-+ +-+ +-+-+ +-+-+-+ + + + +-+-+ + + + + + + + +-+ +-+ + +-+
|             | | |   |   | |         |       | |     |       | | |   |   | | | | | | |   | |   |   |
+ + +-+-+ + + + + + + + + + + +-+-+-+-+ +-+ +-+ +-+ + + +-+ + +-+ +-+ + +-+ + + + + +-+ + +-+ +-+-+ +
| |   |   | | | | | | | | | | |           | |   |   | |   | | |     | | |   | | | |   | |   | |     |
+ + + + +-+-+-+ + + +-+ + + + + + + +-+ + + + + +-+ + +-+ + + + + + +-+-+-+-+ +-+ + +-+-+ + + + +-+ +
| | | |       | | | |   | | | | | | |   | | | | |   |   | | | | | | |           | |     | | | |   | |
+ + + + +-+ +-+ + +-+ +-+ +-+ +-+ + +-+ + + +-+ + +-+ + + +-+ + + + +-+-+-+-+ +-+ + + + + +-+ +-+-+ +
| | | |   | |   |   | |   |   |   | |   | |   | | |   | |   | | | |         |   | | | | | |       | |
+ + + +-+ + + + + + +-+ + + + +-+ + + + + + + +-+ + +-+ + + +-+-+ +-+-+ + +-+ +-+-+-+ + +-+-+-+ +-+ +
| | | |   | | | | | |   | | | |   | | | | | | |   | |   | |   |   |     | |         | |       |   | |
+ +-+ +-+ + +-+ +-+-+-+-+-+ + +-+ + +-+-+-+ + +-+ +-+-+ +-+ +-+ + + + + + +-+-+-+ +-+-+ +-+ +-+-+ + +
|   | |   | |         |     |   | |     |   |   |   |   |   |   | | | | |     |       | |       | | |
+ + + + + +-+ + + + + + + + +-+ +-+ + +-+ + + +-+ +-+-+ + + + + + + + +-+ + +-+ +-+-+-+-+-+ +-+ + +-+
| | | | | |   | | | | | | | |   |   |   | | |   | |     | | | | | | |   | | |           |     | |   |
+-+ + + + + +-+ + + + +-+ +-+-+ + + +-+ +-+ +-+-+-+ + + + + +-+ +-+ +-+ + + +-+ + + + + + + + +-+-+ +
|   | | | | |   | | | |       | | | |     |     |   | | | |   |   | |   | |   | | | | | | | | |     |
+ + +-+-+ +-+-+ +-+ + + + +-+ + +-+ + +-+ + + + + + + + +-+ + + + + +-+-+ + + + + + +-+-+-+-+ + +-+ +
| |     |   |   |   | | | |   |   | | |   | | | | | | |   | | | | |   |   | | | | |   |       | |   |
+ +-+-+ + + +-+ + +-+ + + +-+-+ +-+ + + + + +-+ + + + + +-+ + +-+-+-+ +-+-+ + +-+ + + +-+-+ + + + + +
| |     | |   | | |   | |   |     | | | | | |   | | | |   | |   |         | |   | | | |     | | | | |
+ +-+ + + + +-+ + + +-+ + + +-+ + + + + +-+-+-+ +-+ + +-+-+ +-+ + + +-+ +-+ +-+ + + + + +-+ + + + + +
|   | | | | |   | |   | | |   | | | | |     |     | |     |   | | |   | |     | | | | | |   | | | | |
+ + + + +-+ +-+ + + +-+ + + + + + +-+ + + + + + + + + + + + + + + + +-+ + +-+-+-+ +-+ + + +-+ + + + +
| | | |   |   | | | |   | | | | | |   | | | | | | | | | | | | | | |   | |     |     | | |   | | | | |
+ + +-+ +-+ +-+-+ +-+ +-+ + + + + +-+-+-+ + +-+ +-+ +-+ +-+-+ + + + + + + + +-+ + +-+ + + +-+-+ +-+-+
| | |     | |       | |   | | | |     |   |   | |   |   |     | | | | | | |   | | |   | |     |     |
+ + +-+ + +-+ + +-+-+ + + +-+ + + +-+ + +-+ + + + + +-+ + + + + +-+ + + + +-+-+ + +-+ +-+ + + + + + +
| | |   |   | | |     | |   | | | |   |   | | | | | |   | | | | |   | | |   |   |   |   | | | | | | |
+ + + +-+ + +-+ + + +-+ +-+ + + +-+ +-+-+ + +-+ +-+ +-+ + +-+ + + +-+-+ +-+ + + +-+ + + + +-+ +-+-+ +
| | |   | |   | | | |   |   | |   | |     |   | |   |   |   | | |   |   |   | |   | | | | |   |     |
+ + + + + + + + +-+ +-+ +-+ + +-+-+ + +-+ + + + + + + + + +-+-+ +-+-+ +-+ + + + + + + +-+ + + + +-+ +
| | | | | | | | |   |   |   |     | |   | | | | | | | | | |         |   | | | | | | |   | | | |   | |
+-+-+ + + + + + + + + + + + + + + + + + + +-+ + +-+-+ + +-+ +-+ +-+ + + + + + + +-+ + + +-+ + +-+ + +
|     | | | | | | | | | | | | | | | | | |   | | |     |   | |     | | | | | | | |   | | |   |   | | |
+ + + + + +-+ +-+ + + +-+ + + +-+ +-+ + +-+ +-+-+-+ + +-+-+ + + +-+ +-+ + + +-+ + +-+-+ + + + + + + +
| | | | | |     | | | |   | | |   |   | |     |     |     | | | |   |   | |   | |   |   | | | | | | |
+ + +-+-+-+ + + +-+ + + + + +-+ + + +-+-+-+-+ +-+-+ + + + + + +-+ + + + + + + + +-+ + + + + + + + +-+
| | |       | |   | | | | | |   | |         |   |   | | | | | |   | | | | | | |   | | | | | | | |   |
+-+ +-+ +-+ + + + + + + + +-+ + +-+ + + +-+-+-+ +-+ +-+-+-+ + + + + +-+ +-+ + + +-+ + +-+ + + + + + +
|     | |   | | | | | | | |   | |   | |     |   |   |       | | | |   |   | | |   | | |   | | | | | |
+ + + + +-+ + +-+ +-+ +-+ +-+ + + +-+ +-+-+-+ + + + + + + + +-+-+-+ + +-+ +-+ + +-+ + + + + +-+-+ + +
| | | | |   |   |   |   | |   | | |   |       | | | | | | |       | |   | |   | |   | | | | |     | |
+ +-+-+ + + + +-+ +-+ +-+-+ + + + + +-+ + + +-+ + +-+ +-+-+ + + + + +-+-+ +-+ + +-+-+ +-+ + +-+-+ + +
|     | | | | |   |     |   | | | | |   | | |   |   |   |   | | | |   |     | |   |     | |   |   | |
+ +-+ + +-+ + + + + + + + +-+ + + + + + + + +-+-+ + + + +-+ + + + +-+ + + +-+ + +-+ + +-+ +-+-+ + + +
|   | |   | | | | | | | |   | | | | | | | |   |   | | | |   | | |   | | | |   | |   |   |     | | | |
+ + + + + +-+ +-+-+ + + + + + + + + + + +-+-+ +-+-+ +-+-+-+ + + + + + +-+-+ +-+ + + + +-+ + + +-+ +-+
| | | | |   |     | | | | | | | | | | | |       |   |       | | | | |     | |   | | | |   | |   |   |
+ + + + + + + + + + +-+ +-+ + + + + + + + + + + + + +-+ + +-+ + + +-+ +-+ + + + +-+ + + + +-+ + + + +
| | | | | | | | | | |     | | | | | | | | | | | | | |   |   | | |   | |   | | | |   | | | |   | | | |
+-+-+-+-+-+-+-+-+-+-+-+-+-+-+-+-+-+-+-+-+-+-+-+-+-+-+-+-+-+-+-+-+-+-+-+-+-+-+-+-+-+-+-+-+-+-+-+-+-+-+