+-+-+-+-+-+-+-+-+-+-+-+-+-+-+-+-+-+-+-+-+-+-+-+-+-+-+-+-+-+-+-+-+-+-+-+-+-+-+-+-+-+-+-+-+-+-+-+-+-+
|                                                                                                 |
+-+ + +-+ +-+-+ + + + + +-+ +-+ +-+-+-+-+ + + + + + + + + + + + + + +-+ + + +-+ +-+ + +-+ +-+-+-+ +
|   | |   |     | | | |   | |     |       | | | | | | | | | | | | |   | | | |     | | |       |   |
+ +-+ +-+ + + + + + + +-+ + + + + + +-+ + + +-+ + + + +-+ +-+ + +-+-+ +-+ + + +-+ +-+ + + + + + + +
|   | |   | | | | | |   | | | | | | |   | |   | | | | |     | | |     |   | |   | |   | | | | | | |
+ + +-+ + + +-+-+-+-+-+ +-+ + + + +-+ + + +-+ +-+ +-+-+ + + + + + + +-+ + +-+ + + + + + + + +-+ + +
| | |   | |       |     |   | | |   | | | |     | |     | | | | | | |   |   | | | | | | | |   | | |
+ + + +-+-+ + +-+-+-+ + + +-+-+ + + +-+ + + + + +-+ + + +-+ + +-+ +-+ + + + +-+-+ +-+ + + + +-+ + +
| | |     | | |       | |   |   | | |   | | | | |   | | |   | |   |   | | |     | |   | | |   | | |
+ + + +-+ +-+-+ +-+ + +-+-+ +-+ + + +-+-+ + + + + +-+ + + + + +-+ + +-+ + + + +-+ + + +-+ +-+ +-+ +
| | |   | |     |   |     | |   | |     | | | | | |   | | | |   | |   | | | |   | | | |     | |   |
+ + + + + + +-+ + + +-+ + +-+ + + +-+ + + +-+-+-+ + + +-+-+ + +-+ + + + +-+ +-+ +-+ + + +-+ + + + +
| | | | | | |   | | |   |   | | | |   | |   |     | | |     | |   | | |   |   |   | | |   | | | | |
+ + +-+ +-+ + +-+-+ + +-+-+-+-+ + + +-+ + +-+ + + + +-+ + + + + + + +-+ + +-+-+ + + +-+ + + + + + +
| | |     | |     | |       |   | |   | |   | | | | |   | | | | | |   | |     | | | |   | | | | | |
+-+-+ + + + + +-+ + + + +-+ +-+-+ +-+ + +-+ +-+-+ +-+-+ +-+ +-+-+ + +-+ +-+ +-+-+-+-+ + +-+-+ +-+ +
|     | | | |   | | | |   | |       | | |     |       | |       | |   | |   |         | |       | |
+ +-+ + + + +-+-+-+ + +-+ + + + + +-+-+ + + + + + + +-+ + +-+-+ + + + +-+ + +-+ + +-+ +-+-+ + + + +
|   | | | | |       | |   | | | |   |   | | | | | |   | | |     | | |   | | |   |   |   |   | | | |
+ + + + + + +-+ + + + +-+ + + +-+ +-+ +-+ +-+-+ +-+ + + + + +-+-+ + +-+-+ +-+ +-+ +-+ + +-+ + + + +
| | | | | | |   | | |   | | | |   |     |     |   | | | | | |     |     |   |   |   | | |   | | | |
+ + +-+ + + + +-+-+ + + +-+ + + +-+ +-+-+ + + + + +-+ + + + + + +-+-+ +-+ +-+ + + + + + + +-+-+ +-+
| | |   | | | |     | | |   | | |       | | | | |   | | | | | |   |     |   | | | | | | |   |     |
+ + +-+-+-+-+ + + +-+ + + + +-+ +-+-+ + + + + +-+-+ + +-+-+ + + +-+ + +-+-+ +-+ + + + + +-+-+-+-+ +
| |   |       | | |   | | |   | |     | | | | |     | |     | | |   |     | |   | | | |       |   |
+ + + + + + + +-+-+ + + + + + + +-+ + + +-+-+-+-+-+ + + + +-+ + + + + + +-+ +-+ +-+ + + + +-+ + + +
| | | | | | |   |   | | | | | |   | | |   |         | | | |   | | | | |   |   | |   | | | |   | | |
+ +-+-+ +-+ + +-+ + + + +-+ +-+ + + + +-+ + + + + + +-+-+-+-+ + + + + + + + + + + + +-+ +-+ +-+ + +
|     |   | |   | | | |   | |   | | |   | | | | | | |         | | | | | | | | | | |   | |     | | |
+ + + +-+-+-+ + +-+-+-+ + +-+-+ + +-+-+ +-+ + + + + + + +-+ +-+ +-+ +-+ + + + + +-+ + +-+-+ + + + +
| | |     |   |     |   |     | | |     |   | | | | | | |     |   | |   | | | |   | | |     | | | |
+ +-+-+ + + +-+ + + +-+-+-+ + + + + + +-+ +-+-+ + + +-+-+ +-+ +-+-+ +-+ + +-+ +-+ + + + + + + +-+-+
|     | | | |   | |     |   | | | | | |       | | | |       | |       | | |     | | | | | | |     |
+ + +-+ +-+-+ +-+ + +-+-+ + + + + +-+ + + + +-+ +-+ +-+ + + + + + + + + + + + + + + +-+ + + + + + +
| | |     |     | |   |   | | | |   | | | |   |   |   | | | | | | | | | | | | | | | |   | | | | | |
+ + + + +-+ + + +-+ + + + + + + + + +-+ + + + + +-+ + +-+-+-+ +-+ + + + + + +-+ + + +-+ +-+ +-+ + +
| | | |   | | |   | | | | | | | | |   | | | | |   | |     |     | | | | | |   | | |   | |     | | |
+ + + + + + +-+ +-+ + + +-+-+ +-+ + + +-+ + +-+ +-+-+ + + + +-+ + +-+ + +-+-+ + + + +-+ +-+-+ +-+ +
| | | | | | |   |   | | |       | | | |   | |     |   | | |   | |   | | |     | | |   |   |     | |
+ + +-+ + + + +-+ +-+ + + + +-+-+ + + + +-+-+ + + +-+ + + + + +-+-+ + + +-+-+ +-+-+-+-+ + + + + + +
| |   | | | | |     | | | |     | | | | |     | | |   | | | |     | | | |             | | | | | | |
+-+ + + +-+ +-+-+ + +-+ +-+ + +-+ + + + +-+-+-+ +-+ + + +-+ +-+ + +-+-+ + +-+-+ + +-+ + + + + + + +
|   | | |   |     | |     | |   | | | |   |       | | |   | |   |     | |   |   |   | | | | | | | |
+ +-+ + + +-+-+ + + + + + +-+ +-+-+ + + +-+ + + + + + + + + + + + + + + + + + + + + +-+ + + +-+ + +
|   | | |   |   | | | | |   | |     | | |   | | | | | | | | | | | | | | | | | | | | |   | | |   | |
+ + + + +-+-+ + +-+-+-+-+ + +-+-+ + + + + +-+ + + +-+ +-+ + + +-+-+ + + + + + + + + + +-+ +-+-+-+ +
| | | |   |   |     |     |     | | | | | |   | |   | |   | | |     | | | | | | | | | |   |       |
+ +-+ + + + + + + + + + + + + +-+ + + +-+-+ +-+ +-+-+-+-+-+ + + + +-+ +-+ + + + + + +-+-+ + + +-+ +
|   | | | | | | | | | | | | | |   | |     |   | |           | | | |     | | | | | |   |   | | |   |
+ +-+-+-+-+-+ + + + + + + + + + +-+ +-+ + +-+ + +-+ + + +-+ +-+ +-+ + +-+ + +-+-+-+ +-+ +-+-+ +-+-+
|       |     | | | | | | | | | |     | |   | |   | | | |     |   | | |   |       | |   |         |
+ + +-+ + + +-+ +-+ + +-+ + + +-+ + + +-+ + + + +-+ + + + +-+ + + +-+-+-+ +-+ + +-+-+-+ + + + + +-+
| | |   | | |     | |   | | |   | | | |   | | |   | | | |   | | |   |     |   | |       | | | |   |
+ + + +-+ + + + + +-+ + + + + + + + +-+ + + + + + +-+ + + + + +-+ +-+ + +-+-+ + +-+-+-+ + + + + +-+
| | | |   | | | |   | | | | | | | | |   | | | | |   | | | | | |     | |     | |       | | | | |   |
+-+ + + +-+-+ +-+ +-+ + +-+ + +-+ +-+ +-+ + +-+ +-+ +-+-+-+ + + + + +-+-+ + + +-+-+-+-+-+ + +-+-+ +
|   | | |     |   |   |   | |   |   |   | | |   |   |       | | | |     | | |           | |     | |
+ + + +-+-+ +-+ + + +-+ + +-+ + + + + +-+-+ + + + + + +-+ +-+-+-+-+-+ + +-+ +-+ +-+ +-+ + +-+-+ + +
| | | |     |   | |   | |   | | | | |     | | | | | | |     |         | |     |   |   | |   |   | |
+-+ + +-+ +-+-+-+ +-+ + + + + + +-+ + + + +-+ + + + +-+ +-+ +-+ +-+ +-+ +-+-+ + + + + + + + +-+-+ +
|   |   |       |   | | | | | | |   | | |   | | | |   | |   |     |   |     | | | | | | | |     | |
+-+ + + + + + + + +-+-+-+ +-+ + +-+ + + + + + + +-+ +-+ + + +-+-+-+-+ +-+-+ + + +-+ + +-+ + + +-+ +
|   | | | | | | |   |     |   | |   | | | | | | |   |   | |         |     | | | |   | |   | | |   |
+ +-+ +-+ + + + + +-+ + + + + + +-+ + +-+-+ + + + + + +-+-+-+ +-+ + + +-+-+ +-+ +-+ + + + +-+ +-+ +
| |     | | | | |   | | | | | | |   | |     | | | | |       | |   | |   |     | |   | | |   | |   |
+ + +-+-+-+-+-+-+-+ +-+-+-+ +-+ + +-+ + + +-+ + + + +-+-+-+-+-+ +-+-+-+-+-+-+ + +-+ + +-+ +-+ + + +
| | |                 |       | | |   | | |   | | |           |           |   | |   | |     | | | |
+ +-+-+ +-+ + + + +-+ + + + + +-+ + + + +-+-+-+-+ + + +-+ + +-+-+-+-+ + + + + + +-+ + + + +-+ + + +
|     | |   | | |   | | | | | |   | | |         | | |   | | |         | | | | | |   | | | |   | | |
+ + +-+-+-+-+ +-+ + + + + + + + + + + + +-+-+ + +-+-+ + + + + +-+ +-+ + + + +-+ + +-+ + + + + + + +
| |         |   | | | | | | | | | | | | |     | |     | | | |   | |   | | | |   |   | | | | | | | |
+ + +-+ + + + + + + + +-+ + + + + +-+ +-+ + +-+ + +-+-+ + + +-+-+ + +-+-+-+ + + +-+ + + + + + + + +
| | |   | | | | | | |   | | | | | |   |   | |   | |     | |     | |     |   | | |   | | | | | | | |
+ + + + + +-+ + +-+ +-+ + + + + + + + + + +-+-+-+ +-+-+ + + + +-+ +-+-+ +-+ +-+ + + + + + + + +-+ +
| | | | |   | |   | |   | | | | | | | | | |       |     | | |   |   |     |   | | | | | | | | |   |
+ + + + + +-+ + + +-+-+ + + + +-+-+ +-+ + + +-+ + + +-+-+ + + + + + +-+ +-+ + + +-+ + + +-+-+ + + +
| | | | |   | | |   |   | | |   |     | | | |   | |     | | | | | |   | |   | |   | | |   |   | | |
+ + + + + + +-+ + + + + + +-+ + + +-+ + + +-+-+-+-+ + + +-+ +-+-+-+ + + + + + + +-+-+ + + +-+-+-+ +
| | | | | | |   | | | | | |   | | |   | |       |   | | |         | | | | | | |     | | | |       |
+ + + +-+ + + + + + + +-+ + +-+ + + +-+-+ +-+ + + +-+ +-+-+ +-+-+ +-+ +-+ + + +-+ + +-+ + + +-+ +-+
| | |   | | | | | | | |   |   | | | |       | | | |       | |     |   |   | | |   |   | | | |     |
+ +-+ + + + + +-+ + + +-+ +-+ + + + + + +-+-+-+-+ +-+-+-+ + +-+ + + + + + + + +-+-+ + +-+ +-+ + + +
|   | | | | | |   | | |     | | | | | |         |     |   | |   | | | | | | | |     |   |   | | | |
+ + + + + +-+ + +-+-+ + +-+ + + + +-+-+-+ + +-+-+ +-+-+-+ + + + +-+-+ +-+ +-+ +-+ + +-+ +-+ +-+-+ +
| | | | |   | |     | | |   | | | |       | |       |     | | | |       | |     | | |   |       | |
+ + +-+ + + + + + + + +-+ + + + +-+-+-+-+ +-+ + + + +-+ + +-+ +-+-+-+ +-+ + + + +-+ + + + + + +-+ +
| | |   | | | | | | | |   | | | |           | | | | |   |   |   |       | | | | |   | | | | |   | |
+ + + +-+ +-+ + + + +-+-+ + + + +-+ +-+ + + + + + + + +-+-+-+-+-+ + +-+-+ + +-+ + + + +-+ + +-+ +-+
| | |   | |   | | | |     | | | |     | | | | | | | |   |         |     | | |   | | | |   | |     |
+-+-+ +-+ + +-+ +-+-+ + + + + +-+ + + +-+ +-+-+ +-+-+ + +-+-+ + +-+ +-+-+ + +-+ + + + + + +-+ + + +
|     |   | |   |     | | | |   | | |   | |         | |   |   |   | |     | |   | | | | |   | | | |
+-+ +-+ +-+ + + + + + + + +-+-+ + + +-+ +-+ + +-+-+ + +-+-+ +-+ + + + + +-+-+ + + +-+-+-+ + +-+ +-+
|     |   | | | | | | | |     | | |   |   | |   |   | |       | | | | |     | | |       | |   |   |
+ +-+-+-+-+-+ +-+ + +-+ + + + + + +-+-+-+-+ +-+ + +-+-+ +-+-+-+ +-+-+ +-+ +-+ + + + + + +-+-+ + + +
|     |         | |   | | | | | |       |     | |     |     |   |       | |   | | | | | |     | | |
+ + + + + + +-+ + + + + + + + + +-+-+-+ +-+ + + +-+ +-+ +-+-+-+-+ + + + + +-+ +-+ +-+ + + +-+ +-+ +
| | | | | |   | | | | | | | | |       | |   | | |   |           | | | | |   |   |   | | |   | |   |
+-+-+-+-+-+-+-+-+-+-+-+-+-+-+-+-+-+-+-+-+-+-+-+-+-+-+-+-+-+-+-+-+-+-+-+-+-+-+-+-+-+-+-+-+-+-+-+-+-+