+-+-+-+-+-+
| | |     |
+ + +-+ + +
|   |   | |
+ +-+ +-+-+
| |     | |
+ +-+ +-+ +
| |   |   |
+ + + + +-+
|   |     |
+-+-+-+-+-+