+-+-+-+-+-+-+-+-+-+-+-+-+-+-+-+-+-+-+-+-+-+-+-+-+-+-+-+-+-+-+-+-+-+-+-+-+-+-+-+-+-+-+-+-+-+-+-+-+
|                                                                                               |
+-+ +-+-+ +-+-+-+ + +-+ +-+ + +-+ + + +-+-+-+-+-+-+-+ + + + + + +-+ +-+-+ +-+-+ + +-+ + + + + + +
|     |   |       |   |   | | |   | |     |           | | | | | |   |         | |   | | | | | | |
+ +-+ + + + + +-+ +-+-+-+ +-+ + + + + + + +-+-+ + + +-+ + + +-+ + +-+ + +-+ + +-+-+-+-+ + +-+ + +
|   | | | | | |     |       | | | | | | | |     | |   | | |   | | |   | |   |     |     |   | | |
+ + +-+ + + + + +-+ +-+ +-+ + + +-+ + + + +-+ + + + +-+ +-+-+ + + +-+-+ +-+ +-+-+ + + + + +-+ + +
| |   | | | | | |     | |   | | |   | | | |   | | | |   |     | | |       |     | | | | |   | | |
+ +-+-+ + +-+ + + +-+ +-+ + + + + + + + +-+ + + + + + + + + + + + + + +-+ + + + + +-+ +-+ +-+-+ +
|   |   | |   | |   | |   | | | | | | | |   | | | | | | | | | | | | | |   | | | | |     |     | |
+ + + +-+-+ + + + + + + + + + +-+-+ + +-+ +-+ +-+ + +-+ +-+ + +-+-+ +-+ + + +-+ +-+-+ + + + + + +
| | |   |   | | | | | | | | |     | |   | |     | | |     | | |       | | |   | |     | | | | | |
+ + + + +-+ +-+-+-+ + + + + + +-+ + + + + + + + + +-+ +-+ + + +-+ + + +-+ +-+ +-+ + + + +-+ + + +
| | | | |         | | | | | |   | | | | | | | | |   | |   | |   | | |   |   | |   | | |   | | | |
+ + +-+ + + + + +-+-+ +-+ + + + + +-+ + + +-+ + + +-+-+-+ + + +-+-+ +-+-+ + +-+-+-+-+ + + + +-+ +
| |   | | | | |   |   |   | | | |   | | |   | | | |       | |   |       | |     |     | | |   | |
+ + +-+ +-+-+ +-+ + + + + + +-+-+-+-+-+ + + +-+ + + + + + + + +-+ + + + + + + + + +-+ + +-+ +-+ +
| | |   |     |   | | | | | |           | |   | | | | | | | |   | | | | | | | | |   | |   |   | |
+-+-+ +-+ +-+-+ + + +-+ +-+-+ + + + + + + + + + + +-+ +-+ + +-+ + + +-+ + + + + + + + + +-+ + + +
|     |   |     | | |       | | | | | | | | | | | |     | |   | | |   | | | | | | | | |   | | | |
+-+ +-+-+ + + + + +-+ + +-+ + + + + + +-+-+ +-+ + + + + + +-+-+ + +-+ +-+ + + +-+-+ +-+-+ + + + +
|     |   | | | |   | | |   | | | | |   |   |   | | | | |     | | |     | | |     |     | | | | |
+-+ + + +-+-+ + +-+ + + + +-+ +-+-+ +-+ + + +-+-+ + +-+ + +-+ +-+-+ + + + + +-+-+ +-+ + +-+ +-+ +
|   | |   |   | |   | | | |   |       | | | |     | |   |   |   |   | | | |   |     | |   | |   |
+ + +-+ +-+ + + + + + +-+-+ + + +-+-+ + + + + + + + + +-+-+ + + + +-+ + +-+ + + + + +-+-+ +-+-+ +
| | |     | | | | | |     | | | |     | | | | | | | | |     | | |   | |   | | | | | |     |     |
+-+ +-+-+-+-+-+ +-+ +-+ +-+ +-+ + + + + +-+ +-+ +-+ + + + + + + + + +-+-+ +-+ + + +-+ +-+-+ + + +
|             | |     |   |   | | | | | |   |   |   | | | | | | | | |     |   | |   | |     | | |
+ + +-+-+ + + +-+ + + +-+ + + +-+-+ +-+-+ +-+-+ +-+-+ +-+ + + + +-+ + +-+-+-+-+ + + + +-+-+ + + +
| |     | | |   | | | |   | |   |   |     |     |       | | | |   | |   |       | | |     | | | |
+ + + +-+ + +-+ +-+ + +-+-+ + + +-+-+ + + +-+ + + + +-+-+ +-+-+ + + + + +-+-+ +-+ + +-+ +-+ + + +
| | | |   |   |   | |   |   | | |     | | |   | | |   |   |     | | | | |     |   |   |   | | | |
+ +-+ + + + + +-+-+ +-+ + + + +-+ + + + +-+ + + +-+ + +-+ + + +-+ +-+-+-+ + + + +-+ +-+-+ +-+ + +
|   | | | | |     |   | | | | |   | | |   | | |   | |   | | |   |       | | | | |       |   | | |
+ +-+ + +-+ + + +-+-+ + + + +-+ +-+-+ + +-+-+ + + + +-+ + + + + + +-+ + + + + + +-+-+ + + +-+-+ +
|   | |   | | |     | | | | |       | |   |   | | |   | | | | | |   | | | | | | |     | |     | |
+ + +-+-+ + +-+ + + +-+ + + + + + + +-+-+-+ + + +-+ +-+ +-+ +-+ + + + +-+ + + + + + +-+ + + +-+ +
| | |     | |   | |   | | | | | | | |       | |   |   |   |   | | | |   | | | | | |   | | |   | |
+ +-+ + +-+ + +-+-+-+ + +-+ + + + + +-+-+-+ +-+-+-+ + + +-+ + + +-+ + + +-+-+ +-+-+-+-+-+ +-+-+ +
| |   |   | | |       | |   | | | |   |           | | |   | | |   | | | |             |   |     |
+ + +-+ +-+-+ +-+ + +-+-+-+ +-+-+ +-+ + + + +-+-+ + + + +-+ + + +-+ + +-+ +-+ + + + + + + + + + +
| |   | |     |   |   |       |   |   | | |   |   | | | |   | | |   | |     | | | | | | | | | | |
+ + +-+-+ + +-+ +-+ + + +-+ +-+ +-+ + + + + + + +-+ +-+ + + +-+ + + + + + + +-+ + +-+ + + +-+ + +
| | |     | |   |   | |   | |   |   | | | | | |   | |   | | |   | | | | | |   | | |   | |   | | |
+ + + + + + + + + + + +-+ + + + +-+ + +-+ + +-+-+ + + + +-+ +-+ + + + + +-+-+ + + + +-+-+ + +-+ +
| | | | | | | | | | | |   | | |   | |   | | |     | | | |   |   | | | | |     | | |   |   | |   |
+ + + +-+-+-+ + +-+ +-+ + + + + + +-+ + +-+ +-+ +-+ + + + + + + + +-+-+ +-+ + + + + +-+ + +-+-+ +
| | |     |   |   |   | | | | | |   | |   |   | |   | | | | | | |     | |   | | | |   | |     | |
+ +-+-+ + + + + +-+ + + +-+ +-+ +-+ + + +-+ + + + + + + + + + +-+-+ + +-+-+-+ + +-+ + +-+ +-+ + +
| |     | | | | |   | |   |   | |   | | |   | | | | | | | | |     | |     |   | |   | |   |   | |
+ +-+ + + +-+ +-+ +-+ +-+-+ +-+-+ + + + + +-+ + + + + + + + +-+ + +-+-+ +-+ +-+-+ + + + +-+ +-+ +
|   | | | |     | |       |     | | | | | |   | | | | | | |   | |     | |       | | | | |   |   |
+ + +-+ + +-+ +-+ +-+ +-+ + +-+-+ + + + + + + + + + + +-+ + +-+-+ +-+-+-+ +-+-+ + + + + + +-+ + +
| | |   | |     | |   |   | |     | | | | | | | | | |   | | |         |     |   | | | | | |   | |
+ + + + +-+ + + + + +-+ +-+-+ +-+ + + + + + +-+-+-+-+-+ + +-+ + + + + + +-+-+ + + + + +-+-+ + +-+
| | | |   | | | | | |     |   |   | | | | | |           | |   | | | | |     | | | | | |     |   |
+ +-+ + +-+ + + + +-+-+-+ + +-+ + + +-+ + + + + + + + + +-+ +-+-+-+ +-+-+-+ +-+-+ + + +-+ + + + +
| |   | |   | | | |       |   | | | |   | | | | | | | |   | |       |           | | |   | | | | |
+ + +-+ + + + +-+ + + + + +-+ + + + + + +-+-+ +-+-+ + +-+ +-+ + + +-+ +-+-+ + +-+ + +-+-+ + + + +
| | |   | | | |   | | | |   | | | | | | |       |   |   |   | | | |   |     |   | |   |   | | | |
+ + +-+-+-+ +-+-+-+ + +-+-+ + + + + + + + + + +-+ + +-+ + + + +-+-+ + + + + + +-+-+ + + + + + + +
| | |       |       | |     | | | | | | | | |   | |   | | | |   |   | | | | | |     | | | | | | |
+ + + + +-+ +-+ + +-+-+-+ +-+ + + +-+ + + +-+-+ +-+ +-+-+-+ + + + +-+-+ +-+ +-+-+-+ + + + +-+-+ +
| | | | |   |   |       | |   | | |   | |     | |       |   | | | |       |       | | | |   |   |
+ + + +-+-+ +-+ +-+-+-+-+-+-+ + + + + + + + +-+ + + +-+ +-+-+-+ + + +-+ + + + + + +-+ +-+ +-+ +-+
| | | |     |   |             | | | | | | | |   | | |     |     | |   | | | | | |   | |   |     |
+ + + + +-+ +-+ + + + + +-+ + +-+-+-+-+-+ + + +-+-+ +-+ + + + + +-+-+-+ + + + + + +-+ + + + +-+ +
| | | |   |   | | | | | |   |       |     | |     | |   | | | |   |     | | | | |   | | | | |   |
+ + + + +-+-+ +-+-+-+ + +-+-+ +-+ + + +-+ + + +-+-+-+ + + + + +-+ + + +-+ + +-+-+ + +-+-+ + + +-+
| | | |     |     |   |   |     | | |   | | |   |     | | | |   | | |   | |     | |     | | |   |
+ +-+ +-+ + + + + + + + + + + + + + + + +-+-+ +-+ + + + +-+ + + + + + + + + +-+ +-+ + + + + + +-+
| |     | | | | | | | | | | | | | | | | |     |   | | |   | | | | | | | | |   | |   | | | | |   |
+-+ +-+ +-+ + + +-+ + + + +-+ + + +-+-+ + + + +-+-+ +-+-+-+ + + + + +-+ + + + +-+ + + + +-+-+ +-+
|   |     | | | |   | | |   | | | |     | | |   |         | | | | |   | | | |   | | | | |       |
+ +-+ +-+ + + +-+ + + + +-+ +-+ +-+ +-+ + +-+-+ + + + + + +-+ +-+-+-+-+-+ + + + + + +-+ +-+ + + +
| |     | | | |   | | | |   |     | |   | |     | | | | | |           |   | | | | | |     | | | |
+ + + +-+ +-+ + + +-+-+ +-+ + + + + +-+ +-+ +-+ + + + + + + + +-+ + +-+ + + + + +-+ +-+-+-+ + + +
| | | |     | | |   |     | | | | | |   |     | | | | | | | |   | | |   | | | | |   |       | | |
+ +-+ +-+ +-+ +-+ +-+ + + +-+ + + +-+ +-+ + +-+-+ + +-+ + + +-+ +-+ + + + +-+ + + + + +-+-+ +-+ +
|   |   |   |   |   | | | |   | | |     | | |     |   | | |   |   | | | | |   | | | | |       | |
+ + +-+ + + +-+ + + + + + +-+-+ +-+-+-+ + + +-+-+ + + +-+ + + + + +-+ + +-+ + + + +-+ +-+ + + + +
| | |   | | |   | | | | |   |         | | |   |   | |   | | | | |   | | |   | | |   | |   | | | |
+ + +-+ +-+ +-+ + + + + + + + + + + +-+ + +-+-+ +-+ +-+-+ + + +-+ + + +-+ + + + + + + + + +-+ + +
| | |   |     | | | | | | | | | | | |   | |     |   |     | | |   | |   | | | | | | | | |   | | |
+ + +-+-+ + +-+-+ + + + + + + + + +-+ +-+-+ + + + + + + + + + + + + + + + +-+-+ + +-+-+ + + +-+ +
| | |     |   |   | | | | | | | |   | |     | | | | | | | | | | | | | | |     | |     | | | |   |
+ + + + + + + + +-+-+ + +-+ + + + + +-+ + +-+ + +-+ + + + +-+ + + +-+ +-+ + + + + +-+-+ +-+ + +-+
| | | | | | | |     | |   | | | | | |   |   | |   | | | | |   | | |   |   | | | | |     |   |   |
+ + + +-+-+-+ + + + + + + + +-+-+ + +-+-+ + + + + + + + +-+-+ +-+-+ + + +-+ + +-+ + + + + + +-+ +
| | |   |     | | | | | | |     | |     | | | | | | | | |         | | | |   |   | | | | | |   | |
+ +-+-+ +-+-+ + +-+-+ + + +-+ + + +-+ + + + +-+ + + +-+ + + +-+ + + +-+ +-+ + + + +-+ + + + + +-+
|     | |     |     | | |   | | |   | | | |   | | | |   | |   | | | |   |   | | | |   | | | |   |
+-+-+-+ +-+ + + +-+-+-+ +-+ +-+-+ +-+ + + + + + + + + +-+ + +-+ +-+ + +-+-+ +-+ + + + + +-+ + + +
|       |   | |       | |       |   | | | | | | | | | |   |   |   | | |     |   | | | |   | | | |
+ +-+ + +-+ + + + +-+ + + +-+ + + + + + +-+ +-+ + + +-+ + + + + + + + + + + + +-+-+ +-+-+-+ + + +
| |   | |   | | |   | | |   | | | | | | |     | | |   | | | | | | | | | | | |     |     |   | | |
+-+-+-+-+-+-+-+-+-+-+-+-+-+-+-+-+-+-+-+-+-+-+-+-+-+-+-+-+-+-+-+-+-+-+-+-+-+-+-+-+-+-+-+-+-+-+-+-+