+-+-+-+-+-+-+-+-+-+-+-+-+-+-+-+-+
| |           | |       |   |   |
+ + +-+-+-+ + + + +-+-+ + + + + +
| |   |   | |   | |   | | |   | |
+ +-+-+ + + +-+ + +-+ + + +-+-+ +
|       | | |   | |   |   |     |
+-+-+-+-+ + +-+ + + + +-+-+ +-+-+
| |     | |   | |   | |   |     |
+ + + +-+ + + +-+-+-+ + +-+-+-+ +
|   | |   | | |     | | |     | |
+ +-+ + +-+-+ + + +-+ + + +-+ + +
|   | | |     | |     |   |   | |
+-+-+ + + +-+-+ +-+-+-+-+-+ +-+ +
|     | |     |   |   |     |   |
+ +-+-+ + +-+ +-+ + + + +-+-+ + +
| |     |   |     | | |   |   | |
+ + +-+-+-+ +-+-+-+ + +-+ + +-+ +
| | |     |     |   |     |   | |
+ + + +-+ +-+-+ + +-+-+ +-+-+ +-+
|   | |     | | |   |   |   |   |
+ +-+-+ +-+ + + +-+ + +-+ + +-+ +
| |   |   |   |     | |   |     |
+ + + +-+ +-+-+-+-+-+ + +-+-+-+ +
| | |   |           | | |     | |
+ + +-+ + +-+ +-+-+-+ + + +-+ + +
|   |   |   |         |     | | |
+-+-+ +-+ +-+-+-+-+-+-+-+-+ + +-+
| |   |   |           |   | |   |
+ + +-+ +-+ +-+-+-+-+ + + +-+-+ +
|   |     | | |     |   |   |   |
+ +-+-+-+-+ + + +-+ +-+-+-+ + + +
|           |     |           | |
+-+-+-+-+-+-+-+-+-+-+-+-+-+-+-+-+