+-+-+-+-+-+-+-+-+-+-+-+-+-+-+-+-+-+-+-+-+-+-+-+-+-+-+-+-+-+-+-+-+-+-+-+-+-+-+-+-+-+-+-+-+
|                                                                                       |
+ +-+ + + +-+ +-+-+-+-+-+-+-+-+ +-+ +-+ + + + +-+ +-+ + + +-+ +-+ + + +-+-+-+ + + +-+-+ +
|   | | |   |                 |   |   | | | |   |   | | |   |   | | |       | | |     | |
+ +-+ +-+ + +-+ +-+-+-+ + + + +-+-+-+ +-+-+-+ +-+ + +-+-+ + + +-+ + +-+-+ +-+-+-+ +-+ + +
|   |   | |   |       | | | |       |       |   | |     | | |   | |     |       |   | | |
+ +-+ + +-+-+-+-+-+-+ + + +-+ +-+-+-+ + + +-+ +-+-+-+-+ +-+-+ +-+-+-+-+-+ +-+-+ + +-+-+-+
|   | |             | | |   |       | | |   |         |     |           |     | |       |
+ +-+-+ +-+ + +-+-+-+-+ +-+ + +-+-+ + + + +-+ + + +-+ +-+-+ +-+-+ + +-+ +-+ + + + + +-+-+
|     |   | |         |   | |     | | | |   | | |   |     |     | |   |   | | | | |     |
+ +-+ +-+ + +-+ +-+ + +-+ + +-+-+ + + + +-+ +-+-+ +-+ +-+ +-+-+-+ + +-+-+ +-+-+-+ + + + +
|   |   | |   |   | |   | |     | | | |   |     |   |   |       | |     |       | | | | |
+ + + +-+-+ +-+ + +-+ +-+-+ +-+ +-+-+-+-+ +-+ +-+ + +-+-+-+-+ +-+ + + + +-+-+-+ +-+ + + +
| | |     |   | |   |     |   |         |   |   | |         |   | | | |       |   | | | |
+ + +-+ +-+-+-+-+ + + + +-+ + +-+-+ + +-+ +-+-+-+ + +-+ +-+-+-+ + +-+-+ +-+-+ +-+ + + +-+
| |   |         | | | |   | |     | |   |       | |   |       | |     |     |   | | |   |
+ + + +-+ + + +-+ +-+ +-+ +-+-+ +-+ +-+ + + +-+ +-+-+ + + +-+ +-+ +-+ + + +-+ +-+-+ +-+-+
| | |   | | |   |   |   |     |   |   | | |   |     | | |   |   |   | | |   |     |     |
+ +-+ +-+-+ +-+-+ + + + + +-+ +-+ + +-+-+-+ +-+-+-+-+-+ +-+ +-+ + +-+-+-+ + +-+-+-+ + + +
|   |     |     | | | | |   |   | |       |           |   |   | |       | |       | | | |
+ +-+ + + + + + +-+ + + +-+ +-+ + +-+-+-+ + + +-+ + +-+-+ + + + +-+ +-+-+-+-+-+ + +-+-+ +
|   | | | | | |   | | |   |   | |       | | |   | |     | | | |   |           | |     | |
+ +-+ + +-+-+ + +-+ +-+ + +-+ +-+ + + +-+ + + + +-+-+ +-+-+ + + + +-+-+-+ +-+ +-+-+-+ + +
|   | |     | |   |   | |   |   | | |   | | | |     |     | | | |       |   |       | | |
+ + + + +-+-+ + + + +-+-+-+-+-+ + +-+-+ +-+-+ +-+-+ + + +-+-+-+ + + + + +-+ +-+-+-+-+-+-+
| | | |     | | | |           | |     |     |     | | |       | | | | |   |             |
+ +-+-+-+ + +-+-+-+ + + + +-+ + + +-+ +-+ + +-+ +-+-+ +-+ + +-+-+ +-+-+-+ +-+ + + + +-+ +
|       | |       | | | |   | | |   |   | |   |     |   | |     |       |   | | | |   | |
+ +-+-+-+ + + +-+ +-+ +-+ +-+ +-+-+-+-+-+-+ +-+ +-+-+ + +-+-+ + +-+-+-+-+-+ + +-+ + + +-+
|       | | |   |   |   |   |             |   |     | |     | |           | |   | | |   |
+ + + + + +-+ + + + + +-+-+ + + +-+-+-+ + + + + + +-+ +-+ +-+-+ + + + +-+ + +-+-+-+ + + +
| | | | |   | | | | |     | | |       | | | | | |   |   |     | | | |   | |       | | | |
+ + + +-+ +-+-+-+ + + + + + + + +-+-+-+-+-+ +-+ + + +-+-+ +-+ + +-+-+-+ +-+-+ +-+-+ +-+ +
| | |   |       | | | | | | | |           |   | | |     |   | |       |     |     |   | |
+ +-+-+-+-+-+-+ + +-+-+ + +-+ +-+-+ +-+ + +-+-+-+-+-+ +-+-+-+-+ + +-+ +-+-+-+ + + + + + +
|             | |     | |   |     |   | |           |         | |   |       | | | | | | |
+ +-+-+-+-+-+-+-+ + +-+ + + +-+-+ +-+ + + +-+ + +-+-+-+-+ + + + +-+-+ +-+-+ + + + + + +-+
|               | |   | | |     |   | | |   | |         | | | |     |     | | | | | |   |
+ + +-+ + + + +-+-+-+-+-+-+-+ + + + +-+-+-+ +-+-+-+ + +-+-+-+ + +-+ +-+ + +-+ +-+ +-+-+ +
| |   | | | |               | | | |       |       | |       | |   |   | |   |   |     | |
+ +-+-+ +-+ + +-+-+-+ + +-+-+ + + + +-+ + +-+ +-+ + + + + +-+ + +-+-+ + +-+ + + +-+ +-+ +
|     |   | |       | |     | | | |   | |   |   | | | | |   | |     | |   | | |   |   | |
+ +-+ + +-+-+-+-+ +-+ + +-+-+ + + + +-+ +-+-+-+-+ +-+ + + +-+ +-+ +-+-+-+ +-+-+ + + + + +
|   | |         |   | |     | | | |   |         |   | | |   |   |       |     | | | | | |
+ + +-+-+ + +-+ +-+-+-+ + +-+ +-+-+-+ + + +-+-+-+-+-+-+-+ +-+-+ + + + + + + +-+-+-+ + +-+
| |     | |   |       | |   |       | | |               |     | | | | | | |       | |   |
+ +-+-+-+ + + +-+ +-+ + + + + +-+-+ + +-+-+ +-+ +-+-+-+ + + +-+-+ +-+ +-+-+ + +-+-+-+-+ +
|       | | |   |   | | | | |     | |     |   |       | | |     |   |     | |         | |
+ +-+ +-+-+ +-+ + + +-+ +-+-+ + + + +-+-+-+ + +-+-+-+-+ + +-+-+-+-+-+ +-+ +-+ +-+ +-+-+-+
|   |     |   | | |   |     | | | |       | |         | |           |   |   |   |       |
+ +-+-+ +-+-+ + +-+ + +-+ + +-+-+-+-+-+ + + + + + + + + + +-+-+ +-+-+-+ + + + +-+-+-+-+ +
|     |     | |   | |   | |           | | | | | | | | | |     |       | | | |         | |
+ + +-+ + + + + +-+-+ +-+-+-+ + + +-+-+-+-+ +-+-+ + +-+ +-+-+ + +-+-+ + +-+-+-+ + + + + +
| |   | | | | |     |       | | |         |     | |   |     | |     | |       | | | | | |
+ +-+ +-+-+ +-+ +-+-+-+ +-+ +-+ +-+-+ + + +-+ + + + +-+-+-+-+-+-+ +-+-+ +-+-+-+-+-+ + +-+
|   |     |   |       |   |   |     | | |   | | | |             |     |           | |   |
+ +-+ +-+-+ +-+ +-+ +-+-+ +-+-+-+ + + + + +-+-+-+-+-+-+-+ +-+-+ + +-+-+-+ + + +-+-+-+-+-+
|   |     |   |   |     |       | | | | |               |     | |       | | |           |
+ + + +-+-+ +-+-+-+-+-+ + + +-+-+ + + +-+-+-+-+ + + +-+-+-+ + + + + +-+ + + +-+ +-+ +-+ +
| | |     |           | | |     | | |         | | |       | | | | |   | | |   |   |   | |
+ + + + +-+ + +-+-+-+-+-+-+ +-+-+-+ + +-+-+ +-+-+ + +-+ +-+ +-+ + +-+ + + + +-+-+ + + +-+
| | | |   | |             |       | |     |     | |   |   |   | |   | | | |     | | |   |
+ + + + +-+ + + +-+-+ +-+-+-+ + +-+ +-+-+-+-+-+-+ +-+ + +-+-+ + + +-+ + + + +-+ + + + +-+
| | | |   | | |     |       | |   |             |   | |     | | |   | | | |   | | | |   |
+ +-+ +-+-+ + + + +-+-+-+ +-+ +-+ +-+ + +-+-+-+ + +-+-+ +-+-+ +-+ + +-+-+ +-+-+ +-+-+ + +
|   |     | | | |       |   |   |   | |       | |     |     |   | |     |     |     | | |
+ +-+-+-+-+-+-+ +-+ + + +-+ +-+-+ +-+ +-+ +-+-+-+ + +-+-+-+-+ +-+-+ +-+-+ +-+-+-+ +-+ +-+
|             |   | | |   |     |   |   |       | |         |     |     |       |   |   |
+ +-+-+ + +-+ +-+-+ + + +-+-+-+-+-+-+-+-+-+ +-+-+-+ +-+-+-+-+ + + + + +-+ + +-+ + + +-+-+
|     | |   |     | | |                   |       |         | | | | |   | |   | | |     |
+ +-+-+-+-+ +-+ +-+-+ +-+-+-+ +-+ + +-+-+ + + + +-+-+ + +-+-+ + + +-+-+ +-+ +-+-+ +-+ + +
|         |   |     |       |   | |     | | | |     | |     | | |     |   |     |   | | |
+ +-+ + + + + + + +-+-+ +-+ + + + + + +-+ +-+-+-+ + +-+-+ +-+ +-+-+-+-+-+-+-+ +-+-+-+-+-+
|   | | | | | | |     |   | | | | | |   |       | |     |   |               |           |
+ +-+-+ + +-+ +-+ +-+-+-+ +-+-+-+ +-+ +-+ +-+-+ +-+ + +-+-+ + + +-+-+ +-+ +-+ +-+-+-+-+ +
|     | |   |   |       |       |   |   |     |   | |     | | |     |   |   |         | |
+ + +-+-+-+-+-+-+ +-+ + +-+-+ + +-+ +-+-+-+-+ +-+-+-+-+-+ + + +-+-+ + +-+-+-+-+-+ + + + +
| |             |   | |     | |   |         |           | | |     | |           | | | | |
+ +-+ + +-+-+ +-+-+-+ +-+ +-+-+ + + + +-+ + +-+-+ + + + +-+-+-+-+ +-+-+-+-+-+-+ + + +-+-+
|   | |     |       |   |     | | | |   | |     | | | |         |             | | |     |
+ +-+-+-+-+-+-+-+-+ +-+ + +-+ + +-+-+-+-+-+-+ + + +-+-+ +-+ + +-+-+-+ + +-+ +-+-+ +-+ +-+
|                 |   | |   | |             | | |     |   | |       | |   |     |   |   |
+ +-+-+-+-+-+-+ + +-+ +-+-+-+-+-+-+-+-+-+-+-+ +-+-+ + +-+ + + + +-+-+-+ +-+-+-+-+ +-+ +-+
|             | |   |                       |     | |   | | | |       |         |   |   |
+ + +-+ + + + +-+-+-+ + + +-+ + + + +-+-+-+ +-+-+-+-+ +-+ + + +-+-+ + +-+-+ + + +-+-+ + +
| |   | | | |       | | |   | | | |       |         |   | | |     | |     | | |     | | |
+ +-+-+ +-+ +-+ +-+ +-+-+ + + +-+ +-+ +-+ + +-+-+ +-+-+-+-+ +-+-+ + +-+ + +-+ + +-+-+-+-+
|     |   |   |   |     | | |   |   |   | |     |         |     | |   | |   | |         |
+-+-+-+-+-+-+-+-+-+-+-+-+-+-+-+-+-+-+-+-+-+-+-+-+-+-+-+-+-+-+-+-+-+-+-+-+-+-+-+-+-+-+-+-+