+-+-+-+-+-+-+-+-+-+-+-+-+-+
| |       | |     |   |   |
+ +-+-+ +-+ + +-+-+-+ + +-+
|     | |   | |   | | |   |
+-+ + + +-+ + + + + + + +-+
| | |     | | | |       | |
+ +-+ +-+ + + +-+-+ + + + +
| |   | |           | |   |
+ + +-+ + +-+ +-+ + +-+-+-+
|     |   | | |   | |   | |
+-+-+ + +-+ + +-+ +-+ + + +
| | | | |   |   |     |   |
+ + +-+ + +-+ +-+ +-+ +-+-+
|     |     | |     |     |
+ + +-+ + +-+-+ +-+ +-+ +-+
| | | | | |   | |   |     |
+-+ + +-+ +-+ +-+-+ + +-+ +
|             | | | | |   |
+ +-+ + + +-+-+ + +-+ +-+-+
|   | | |   |   |       | |
+ +-+ + + +-+-+ + +-+ +-+ +
| |   | |   | |   | |     |
+ +-+ +-+ +-+ + + + + +-+ +
| |     |   | | | |     | |
+ + + +-+ +-+ +-+-+ +-+-+ +
| | | |       |     |     |
+-+-+-+-+-+-+-+-+-+-+-+-+-+