+-+-+-+-+-+-+-+
|   |     |   |
+-+ + +-+ +-+ +
| |   | |   | |
+ +-+-+ +-+ + +
|   |   |   | |
+ +-+ + + +-+ +
|   | |   |   |
+ + + +-+-+ +-+
| | | |       |
+ + + + +-+-+ +
| | | | |   | |
+ + + +-+ + + +
| |       |   |
+-+-+-+-+-+-+-+