+-+-+-+-+-+-+-+-+-+-+-+-+-+-+-+-+-+-+-+-+-+-+-+
|                                             |
+ + + + +-+ + +-+-+-+ + +-+-+-+-+ + +-+ + +-+ +
| | | |   | |       | |         | |   | |   | |
+ + + +-+ + +-+-+-+-+ + + +-+ + +-+-+-+-+-+-+-+
| | |   | |         | | |   | |               |
+ + + +-+ +-+ + +-+-+-+ + +-+-+-+ +-+-+-+-+ + +
| | |   |   | |       | |       |         | | |
+ + +-+-+ +-+-+ +-+ +-+-+ + +-+-+-+-+-+-+-+ + +
| |     |     |   |     | |               | | |
+ + +-+-+ +-+-+-+ + + +-+-+-+ +-+-+-+ +-+-+-+-+
| |     |       | | |       |       |         |
+ +-+-+ +-+-+-+ +-+ + + +-+-+ + +-+ +-+-+-+-+ +
|     |       |   | | |     | |   |         | |
+ + + +-+-+ +-+-+-+ +-+-+ + +-+-+ + +-+ +-+-+ +
| | |     |       |     | |     | |   |     | |
+ +-+ + +-+ + +-+ +-+-+ +-+ +-+ +-+-+ + + + + +
|   | |   | |   |     |   |   |     | | | | | |
+ +-+-+ + + + + + + + + + + +-+-+-+ +-+ + +-+-+
|     | | | | | | | | | | |       |   | |     |
+ + + +-+-+-+ + + +-+ +-+-+-+ + + + + + +-+ +-+
| | |       | | |   |       | | | | | |   |   |
+ +-+-+ +-+ +-+ +-+ + + + +-+-+-+-+-+ +-+-+-+ +
|     |   |   |   | | | |           |       | |
+ + +-+-+ + + + + +-+-+ +-+-+ + + +-+-+-+ +-+ +
| |     | | | | |     |     | | |       |   | |
+ +-+-+-+ + + + +-+ + + + + + +-+-+-+ + +-+ + +
|       | | | |   | | | | | |       | |   | | |
+ +-+ +-+ + + + +-+-+-+-+ + + +-+ + +-+ +-+ +-+
|   |   | | | |         | | |   | |   |   |   |
+ +-+-+-+-+ +-+ +-+-+-+-+ + +-+-+ + +-+ +-+ + +
|         |   |         | |     | |   |   | | |
+ +-+ +-+ + +-+ + + + + +-+ +-+-+ + +-+ + + +-+
|   |   | |   | | | | |   |     | |   | | |   |
+ + +-+-+-+-+ +-+-+ +-+-+-+-+ + + + +-+ +-+ +-+
| |         |     |         | | | |   |   |   |
+ +-+-+ +-+-+-+ + + +-+ + + +-+-+-+-+-+-+-+ + +
|     |       | | |   | | |               | | |
+ +-+ + + +-+-+ + + +-+-+-+-+-+-+-+ + + +-+ + +
|   | | |     | | |               | | |   | | |
+ +-+ + +-+-+ +-+-+-+ + + + + + + +-+ + + +-+-+
|   | |     |       | | | | | | |   | | |     |
+ + + + +-+ +-+-+-+-+ +-+ +-+-+ + +-+-+-+ +-+-+
| | | |   |         |   |     | |       |     |
+ +-+-+-+-+-+ +-+ +-+-+-+ +-+-+-+-+-+ +-+-+ +-+
|           |   |       |           |     |   |
+-+-+-+-+-+-+-+-+-+-+-+-+-+-+-+-+-+-+-+-+-+-+-+