+-+-+-+-+-+-+-+-+-+-+-+-+-+-+-+-+-+-+-+-+-+-+-+-+-+-+-+-+-+-+-+-+-+-+-+-+-+-+-+-+-+-+-+-+-+-+-+-+-+-+
|                                                                                                   |
+ + + + + + +-+ + +-+ + + + +-+-+-+ + + + + + +-+-+ + +-+ +-+-+-+ + + + + + + +-+ +-+ + +-+-+ + + + +
| | | | | |   | | |   | | |       | | | | | |     | | |   |       | | | | | |   |   | |     | | | | |
+ + + + + + + +-+ +-+ +-+-+ + +-+ + + +-+ + +-+ +-+ + +-+ + + +-+ +-+ +-+ + + +-+ + +-+-+-+-+-+ +-+ +
| | | | | | | |   |   |     |   | | |   | | |   |   | |   | |   | |     | | | |   |     |         | |
+ + +-+ + + + +-+ +-+ + + + + + +-+ + + + + + + + + +-+ + + +-+ +-+ + + +-+ +-+-+ + +-+-+-+ + + + +-+
| | |   | | | |   |   | | | | |   | | | | | | | | |   | | |   | |   | | |       | |   |     | | |   |
+ + + + + +-+ + + + +-+-+ +-+ + + + + + + + + +-+-+ +-+ + + + + + + +-+ +-+ +-+ +-+-+ + +-+-+ + + + +
| | | | | |   | | |     | |   | | | | | | | | |       | | | | | | | |     |   |   |   |     | | | | |
+ + +-+ + + +-+ + +-+ + + + +-+-+ + + + + + + + + + + + +-+ + +-+ + +-+ + +-+ +-+ +-+ +-+ + +-+ + + +
| |   | | |   | | |   | | |     | | | | | | | | | | | | |   |   | | |   |   | |     |   | |   | | | |
+ + +-+ + + +-+ + + + + +-+ + + + +-+ + + + + + + +-+-+ + +-+ + +-+ + + + + + + + +-+ + +-+-+-+ + +-+
| | |   | | |   | | | | |   | | |   | | | | | | | |     |   | | |   | | | | | | | |   |     |   |   |
+ + + +-+ + + + + +-+-+-+-+ + + +-+ +-+ + + +-+ +-+-+-+-+-+ + + + + + + + +-+ + + + + + + + + + +-+-+
| | | |   | | | | |         | |   |   | | | |             | | | | | | | | |   | | | | | | | | |     |
+ + + +-+ + + + + +-+ + +-+ + +-+ +-+-+ +-+-+ +-+-+-+ +-+-+ +-+ +-+ +-+ + + + + +-+ + + + + +-+-+ + +
| | | |   | | | |   | |   | |   |   |   |           |     |   | |     | | | | | |   | | | |   |   | |
+ + +-+ +-+-+-+ +-+ +-+ + + +-+ +-+ +-+ + +-+-+ + + +-+ + + + + +-+ +-+ + + + + + + + +-+ + + + + + +
| | |   |         | |   | |   | |     | |   |   | |   | | | | | |     | | | | | | | | |   | | | | | |
+ + + + + + + + +-+ +-+ + + +-+-+ + + + +-+ + + +-+ + + + + + + +-+ + +-+ + + + + + + + +-+-+-+-+ + +
| | | | | | | |   |   | | |     | | | | |   | | |   | | | | | |   | |   | | | | | | | | |         | |
+ + + + + +-+ + +-+ + +-+ + +-+ +-+-+-+-+-+ +-+ + +-+ +-+-+ + + + + + + + + +-+ +-+ +-+-+-+ +-+ +-+ +
| | | | |   | | |   |   | | |         |     |   | |       | | | | | | | | | |     |       |   | |   |
+ + + + +-+ + +-+ + + + + + + +-+-+ +-+ + + + + +-+ + + + + + + + + + + + + +-+ + +-+ + +-+ +-+ + + +
| | | |   | | |   | | | | | |   |   |   | | | | |   | | | | | | | | | | | | |   |   | |   | |   | | |
+-+ +-+-+ + + + +-+ +-+ + +-+-+-+-+ + + + + + + + +-+ + + + + + + + +-+ +-+ + +-+ +-+ + +-+-+-+-+ +-+
|       | | | | |     | |     |     | | | | | | |   | | | | | | | | |   |   | |     | |       |     |
+ +-+ +-+ +-+ +-+ + +-+ +-+ + + + +-+ +-+ + +-+ + +-+ + + + +-+ + +-+ + + + + + + + + + +-+ +-+-+-+ +
|   | |     | |   | |   |   | | | |   |   |   | |   | | | | |   | |   | | | | | | | | | |   |       |
+ +-+ + + + + + +-+ + + + + +-+-+-+ + + + + + + + + + +-+ + +-+ + + +-+ + + +-+ + + + + + + + + + +-+
| |   | | | | | |   | | | | |       | | | | | | | | |   | | |   | |   | | |   | | | | | | | | | |   |
+ + + + + + +-+ + + +-+ + + + +-+ + +-+ + +-+ +-+-+ +-+-+-+ + + + + + + + + + +-+ + + + + + +-+ + + +
| | | | | | |   | |   | | | | |   | |   | |     |       |   | | | | | | | | |   | | | | | | |   | | |
+ +-+ + + + +-+-+ +-+ + + +-+ + + + +-+ + +-+ + +-+ + +-+ + +-+ +-+ +-+ +-+ + + +-+-+ + +-+ + + +-+ +
| |   | | | |     |   | | |   | | | |   | |   |   | | |   | |   |     |   | | |   |   |   | | |   | |
+ + + + +-+ + + + +-+ +-+-+-+-+-+-+ + + +-+ + + + +-+ + + + + +-+ + + + +-+ + + + +-+ + + + + + + + +
| | | |   | | | |   |     |         | |   | | | | |   | | | | |   | | | |   | | | |   | | | | | | | |
+ +-+ +-+ + + + + + +-+ +-+ +-+-+-+-+-+ + + + + +-+ + + +-+ + + +-+ +-+-+ + + +-+ + + +-+ + + + + + +
| |   |   | | | | | |     | |           | | | | |   | | |   | | |     |   | |   | | | |   | | | | | |
+ + + +-+-+ +-+ + + + + +-+-+ + + +-+-+ + + +-+ + +-+ + +-+-+ + + +-+-+-+ + +-+ + + + + + + +-+-+-+ +
| | |     | |   | | | | |     | | |     | |   | |   | |     | | |   |     | |   | | | | | |   |     |
+ + +-+ + + + +-+ +-+ +-+ + +-+-+ + +-+ + + + + +-+-+ +-+ + + +-+ + + +-+-+ +-+-+ +-+ + + +-+ + + +-+
| |   | | | | |     | |   | |     | |   | | | |     | |   | |   | | | |       |     | | |   | | |   |
+ + +-+-+-+-+-+-+ +-+ + + +-+ + + +-+ +-+ + +-+-+-+-+-+ + + +-+ + +-+-+-+ +-+ + +-+ + +-+ +-+ + + + +
| |             | |   | | |   | | |   |   |           | | |   | |       |   | |   | |   | |   | | | |
+ + + + +-+ + +-+ + + + + +-+-+-+-+-+ + + + + + +-+ +-+-+ + +-+ + +-+ +-+ +-+-+-+ + + + + + +-+ + + +
| | | |   | |   | | | | |           | | | | | |   |   |   |   | | |   |         | | | | | |   | | | |
+-+ +-+ +-+ +-+-+-+-+-+ +-+ + +-+ + + +-+ +-+ + + + + + + + +-+ + + + + + + + + + + + + +-+ + +-+ + +
|     | |     |         |   |   | | |   | |   | | | | | | |   | | | | | | | | | | | | |   | |   | | |
+ +-+ + +-+ +-+-+ +-+-+-+-+ + +-+-+ +-+-+ + + + + +-+ + + +-+-+ +-+ + + +-+-+ +-+-+-+-+ + + + +-+ + +
|   | |   | |             | | |         | | | | | |   | |     | |   | |     |     |     | | |   | | |
+ +-+ + + + + +-+-+-+-+ + + + + + +-+ + + + +-+ + + +-+ +-+-+-+-+ + + +-+-+-+-+ + + + + + +-+ +-+ + +
|   | | | | |         | | | | | | |   | | | |   | | |           | | |         | | | | | |   | |   | |
+ + + + +-+ + + +-+ + + +-+ + + + + + + + + + +-+ + + + +-+-+-+-+ + + +-+ + + +-+-+ + + + + + +-+ + +
| | | |   | | | |   | |   | | | | | | | | | | |   | | |         | | | |   | |     | | | | | | |   | |
+ +-+ + + +-+-+ + + +-+ + +-+ +-+ +-+ + + +-+-+-+ + + + +-+ +-+-+ +-+ +-+ + +-+ +-+ + +-+ + + +-+-+ +
| |   | | |     | |   | |   | |     | | |       | | | | |   |       |   | | |   |   |   | | |     | |
+ + + + +-+ + + + +-+-+-+-+ +-+ + + + + + + + +-+-+ + + + +-+ + +-+-+ + + + + + + + +-+-+ + + + + + +
| | | | |   | | |     |     |   | | | | | | |   |   | | | |   |     | | | | | | | | |     | | | | | |
+ + +-+ + + +-+ + +-+ + + + + + +-+ + + +-+ + + + + +-+-+ + + + + + + + +-+ + + +-+ +-+ + + +-+ + + +
| |   | | | |   |   | | | | | | |   | |   | | | | |   |   | | | | | | |   | | |   | |   | | |   | | |
+ + + + + + +-+ + + + + +-+ +-+ + +-+-+ +-+ +-+ + + + +-+-+ + + + + + + + + + + + +-+ +-+ +-+ + + + +
| | | | | |   | | | | | |     | | |     |   |   | | | |     | | | | | | | | | | |   |   |   | | | | |
+ +-+-+-+-+ + +-+ +-+ + + + +-+ + + + + + +-+ +-+ +-+ + + + + +-+ + + + +-+ +-+-+ + + + + + +-+ + +-+
|   |       | |   |   | | | |   | | | | | |   |   |   | | | | |   | | |   |     | | | | | |   | |   |
+ + +-+-+ +-+ + + + + + + + + + +-+ + + +-+-+ + +-+ + + +-+-+ + + +-+-+ +-+ +-+-+ + +-+-+ + + + +-+ +
| |   |   |   | | | | | | | | | |   | |   |   | |   | |     | | |   |     |     | | |     | | | |   |
+ + + +-+ + + +-+-+ + + + + +-+-+ +-+-+ +-+ +-+ + + + + + + +-+ + +-+ + +-+-+ +-+ +-+ + + + + + +-+ +
| | | |   | | |     | | | |     | |       |   | | | | | | | |   |   | |     | |   |   | | | | | |   |
+ +-+ + + + +-+ +-+ + + + +-+ + + +-+-+ + + + + + + + + + + + + + +-+ +-+ + +-+ +-+ + + + +-+-+ + + +
|   | | | | |     | | | |   | | | |     | | | | | | | | | | | | | |   |   |   | |   | | |     | | | |
+ +-+ + +-+ + + + + +-+ + + + + + + + + +-+ +-+-+-+ + + + +-+ + + +-+ + + + + + + + + + +-+ + +-+ + +
|   | | |   | | | |   | | | | | | | | | |         | | | | |   | | |   | | | | | | | | |   | |   | | |
+ + + + + +-+ + + + + +-+ +-+ + + + + + + + + +-+ + + +-+ + + + +-+-+ +-+-+ + + +-+ + +-+ + +-+ +-+ +
| | | | | |   | | | | |     | | | | | | | | | |   | |   | | | | |       |   | | |   | |   | |   |   |
+ +-+-+-+-+ +-+-+-+ + +-+-+ +-+-+-+ + + + +-+ +-+ + + + + + +-+ +-+ + + +-+ + + +-+ + + + +-+ + + + +
|         |   |     | |           | | | | |     | | | | | | |   |   | |   | | | |   | | |   | | | | |
+ + + + +-+-+ + + + + + + + +-+-+ +-+-+ + +-+ +-+ + + +-+ +-+ + +-+-+-+-+-+ + +-+ + +-+-+-+ +-+-+ + +
| | | |     | | | | | | | |     |   |   | |   |   | | |     | | |           | |   |   |       |   | |
+ + +-+ + + + +-+ +-+ +-+ +-+ +-+ +-+-+ +-+-+-+-+ +-+ + + +-+ +-+-+-+-+ + + +-+-+ + + + +-+ + + + + +
| |   | | | | |   |   |   |     | |             |   | | | |           | | |     | | | |   | | | | | |
+-+-+-+ +-+-+-+-+-+ +-+ +-+ + +-+ +-+ + + +-+ + + +-+ + + +-+ + +-+ + + + + + + + + + + + + + + + + +
|               |   |   |   |   |   | | | |   | |   | | |   | | |   | | | | | | | | | | | | | | | | |
+ + + + + +-+ +-+-+ +-+-+ + + + + + +-+ + + + + +-+-+ +-+ + + + + + + + + + + + + +-+ + + + + +-+-+ +
| | | | |   |   |     |   | | | | | |   | | | |     | |   | | | | | | | | | | | | |   | | | |   |   |
+ + + + + +-+ + +-+ +-+-+-+ +-+ +-+ +-+ + + + + + +-+ + +-+ + +-+ + + +-+ + + + +-+ +-+ + + +-+-+ + +
| | | | |   | |   | |         | |   |   | | | | | |   | |   |   | | | |   | | | |     | | |   |   | |
+ + + + + +-+ + + + + + +-+-+ + +-+-+ +-+ +-+-+ + + + + + + + + +-+ + + + + +-+ + +-+ + + +-+-+ + + +
| | | | | |   | | | | | |     | |       |     | | | | | | | | | |   | | | |   | | |   | |     | | | |
+ + + + + +-+ + +-+-+ +-+-+ + + +-+-+-+ + +-+ + + +-+ +-+-+ +-+ + +-+ + + + + + + +-+ + + + + + +-+-+
| | | | | |   |     |   |   | |   |     | |   | | |   |       | |   | | | | | | |   | | | | | |     |
+ + + +-+ +-+ + + +-+ + +-+ +-+-+ + +-+ + + + + + + +-+-+ + +-+ + + +-+ + +-+-+ +-+ + +-+-+ + + + + +
| | | |   |   | |   | |   | |     | |   | | | | | | |     |   | | |   | | |     |   | |     | | | | |
+ +-+ +-+ + + + + + +-+ + + + +-+-+ + +-+ +-+ + +-+ + + + + + +-+ + +-+-+ + +-+ + + +-+-+ + +-+ + +-+
| |   |   | | | | |   | | | |     | |   |   | | |   | | | | | |   | |     |   | | |   |   |   | |   |
+ + + + + + +-+-+ +-+-+-+ + + +-+-+ +-+ + + + + +-+ + + +-+-+-+-+-+ + +-+-+-+ +-+ + +-+ + + + + + + +
| | | | | |     | |       | |   |   |   | | | | |   | |   |         |   |       | |   | | | | | | | |
+ + + + + + + + + +-+ + + +-+ + + + + + + +-+-+ + + + + +-+-+ + + + + + + + + +-+-+-+ +-+ +-+ +-+ + +
| | | | | | | | | |   | |   | | | | | | | |     | | | |     | | | | | | | | | |       |     |   | | |
+-+-+-+-+-+-+-+-+-+-+-+-+-+-+-+-+-+-+-+-+-+-+-+-+-+-+-+-+-+-+-+-+-+-+-+-+-+-+-+-+-+-+-+-+-+-+-+-+-+-+