+-+-+-+-+-+-+-+-+-+-+-+-+-+-+-+-+-+-+-+-+-+-+-+-+-+-+-+-+-+-+-+-+-+-+-+-+-+-+-+-+-+-+-+-+-+-+-+-+-+-+
|                                                                                                   |
+ +-+ + +-+ +-+ + + + +-+-+ + + + + + +-+ + + + +-+ + + + +-+ + +-+-+ + + +-+-+ +-+-+-+-+ +-+ + + +-+
|   | |   | |   | | | |     | | | | | |   | | |   | | | |   | |     | | | |             | |   | |   |
+ +-+ +-+ +-+ + +-+ + + + + + + + +-+ + + + + +-+-+ +-+ + +-+ + + +-+ + + + + + +-+-+ + + +-+-+ + + +
| |     | |   |   | | | | | | | |   | | | | |     |   | | |   | |   | | | | | |   |   | |     | | | |
+ +-+-+ + + + + + + + +-+ +-+ + + + + + + +-+ + + + +-+ + +-+-+-+ + +-+-+-+-+ +-+ + +-+ + +-+-+ + + +
|   |   | | | | | | | |   |   | | | | | |   | | | | |   |     |   | |           | |   | |     | | | |
+ + + + +-+ + + +-+ +-+ +-+ + + +-+ + +-+-+ + +-+ + + + + + + + +-+-+-+ + +-+-+ + +-+ + + + +-+ + + +
| | | | |   | |   | |     | | | |   |     | |   | | | | | | | |     |   | |     | |   | | | |   | | |
+ +-+ +-+-+ + +-+ +-+ +-+ + + + + + +-+-+-+ + + + + + + + +-+-+ + + + +-+ + + + + + + + + +-+ +-+ + +
|   |   |   |   |   | |   | | | | |       | | | | | | | |     | | | | |   | | | | | | | | |     | | |
+ + + +-+ + +-+-+-+ +-+-+ +-+ +-+-+ +-+-+-+-+ + + +-+-+ + + + + + + +-+-+-+-+-+ + + + + + + + + + + +
| | |   | |       |     | |   |             | | |   |   | | | | | | |           | | | | | | | | | | |
+-+ +-+-+ + + + +-+-+ + +-+ + + + + +-+-+ +-+-+-+-+ + + + +-+ + + + + + + +-+ +-+-+ + + + + + +-+-+ +
|   |     | | |     | |   | | | | |     |       |   | | | |   | | | | | | |     |   | | | | |   |   |
+ +-+ +-+ + + + +-+ + + +-+ + +-+-+ + + +-+ + + + +-+-+ + +-+ +-+ + + + +-+ + +-+ + + + + + + +-+ + +
|   |   | | | |   | | | |   | |     | | |   | | | |     |   |   | | | | |   |   | | | | | | | |   | |
+ +-+ + +-+ + + + + +-+ + +-+ +-+-+ + + +-+ + + + + + +-+ + +-+ + + +-+ + + + + + +-+ + +-+ + + +-+ +
|   | | |   | | | |   | |   | |     | |   | | | | | |   | |   | | |   | | | | | |   | | |   | |   | |
+ + +-+ + + + +-+-+ + + +-+-+ + + + + + + + +-+-+ + + + + + + +-+ +-+-+ + +-+ +-+-+ +-+ + + + + + + +
| |   | | | |     | | | |     | | | | | | |   |   | | | | | | |       | | |     |     | | | | | | | |
+ +-+ + +-+ + + +-+ + + + + + +-+-+ + +-+ + + + + + + +-+-+-+ +-+ +-+-+ +-+-+ + + + + + +-+ + + + + +
|   | | |   | | |   | | | | |     | | |   | | | | | |     |     | |         | | | | | |   | | | | | |
+ + + + + +-+ + +-+ +-+ +-+-+ +-+ +-+ +-+-+ + + + +-+-+ +-+ + + +-+ + + + +-+ + + +-+-+-+ + + + + +-+
| | | | |   | |   | |       |   | |       | | | |   |     | | |   | | | |   | | |     |   | | | |   |
+ + + + + + +-+-+ + + + +-+ + +-+-+ +-+-+ + + +-+ +-+-+-+-+ +-+ +-+ + +-+ + + + +-+ + +-+ + + + +-+ +
| | | | | |   |   | | |   | |     | |     | |   |     |       | |   |   | | | | |   |   | | | | |   |
+ +-+ +-+-+-+ +-+ +-+ +-+ +-+ +-+-+ + + +-+ +-+-+ + + + +-+ + +-+-+-+ + +-+-+-+ + + +-+-+-+-+ + + + +
|   |     |     |   | |     |     | | | |     |   | | |   | |     |   |       | | |         | | | | |
+ +-+ +-+ + +-+ + + + + +-+ +-+ +-+-+ +-+ + + + +-+-+ +-+ +-+ +-+ + + + + +-+ + + + +-+ + + +-+ +-+ +
| |     | |   | | | | | |   |     |   |   | | |   |     | |     | | | | | |   | | | |   | | |     | |
+ + +-+-+ +-+ + + +-+ + + + + +-+-+ +-+-+ + +-+ +-+ +-+-+ + + + + +-+ + + +-+-+-+ +-+ +-+ + + + + +-+
| |     | |   | | |   | | | | |     |     | |   |       | | | | |   | | |   |     |   |   | | | |   |
+-+-+-+ + + +-+ + +-+ + +-+ +-+ + + + +-+ + +-+ +-+-+-+ +-+-+ + + + + +-+ +-+ + + + + +-+-+ + + + + +
|       | |   | | |   | |     | | | | |   |   |   |         | | | | |   |   | | | | |   |   | | | | |
+ +-+-+-+-+ +-+-+-+-+-+-+ + + + +-+ + +-+ + + + +-+ + + +-+-+-+ + +-+ + +-+ +-+ + +-+ + + + +-+ + + +
| |                 |     | | | |   | |   | | | |   | | |       | |   |   | |   |   | | | |   | | | |
+ +-+ +-+-+-+-+ +-+ + + + + + + + + + + + + +-+-+ +-+-+-+-+ +-+ + +-+-+ +-+-+ +-+ + +-+ +-+ + + + + +
| |       |       | | | | | | | | | | | | | |       |       |   |     |     | |   | |   |   | | | | |
+ + +-+ +-+ + +-+ + +-+-+-+ +-+ + + +-+ + +-+-+-+ + + + +-+ + + + + + +-+-+ + + +-+ + + + +-+-+ +-+ +
| | |   |   |   | |   |       | | |   | | |       | | | |   | | | | |     | | |   | | | |   |     | |
+ + + + + + + + + + + +-+-+ + + + + + + + + +-+-+ + +-+ + + +-+-+ + +-+ + + +-+ + + + + + + + + + + +
| | | | | | | | | | | |     | | | | | | | |     | | |   | | |     | |   | |   | | | | | | | | | | | |
+-+ + + +-+-+ + + +-+-+ + + + + + + + +-+-+ + + +-+ + + + + + + + + +-+ +-+ + +-+ + + +-+-+-+ +-+ + +
|   | | |     | |   |   | | | | | | | |     | |   | | | | | | | | | |   |   |   | | | |         | | |
+ +-+ + + + +-+ + + +-+ +-+ + + + + +-+-+ + +-+ + +-+-+ + + +-+-+ + + + + + + + + + +-+ +-+ +-+ + + +
|   | | | | |   | |   |   | | | | |   |   |   | | |     | | |     | | | | | | | | |   |   |   | | | |
+ +-+ + + + + + +-+-+ + + + + + + +-+ +-+ + + + + +-+-+-+ + + + + + + +-+ + + + + + + +-+ +-+ +-+-+ +
|   | | | | | | |     | | | | | |   | |   | | | | |       | | | | | | |   | | | | | | |   |       | |
+ + + + +-+ + +-+-+-+ + +-+ +-+ + + + + +-+ +-+ + + + +-+ + + +-+-+-+ + +-+-+-+-+ + +-+-+-+-+-+-+ +-+
| | | | |   |     |   | |     | | | | |   |   | | | |   | | | |       |       |   |             |   |
+ + + + + + + + + +-+ + +-+ + + + +-+ + + + +-+ +-+-+ + + +-+-+ +-+-+-+ + +-+ + + + +-+-+ + + + + + +
| | | | | | | | | |   | |   | | |   | | | |   |   |   | | |           | | |   | | | |     | | | | | |
+-+-+ +-+ +-+ + + + + +-+-+-+-+-+ +-+-+ +-+ +-+-+ + + +-+ +-+ +-+-+ + +-+-+ + + + + +-+-+ + + + + +-+
|       |   | | | | | |             |     |   |   | |   | |   |     |   |   | | | |   |   | | | |   |
+ +-+ + + + +-+ +-+-+ +-+-+ + + + +-+-+-+ + + + + + + +-+ + + +-+ +-+-+-+ +-+ + + + + +-+-+-+ + +-+ +
| |   | | |   |     |     | | | |   |     | | | | | |   | | |   |       |   | | | | |       | |   | |
+ + + +-+ + + + + +-+-+ + +-+ + + + + +-+ + +-+ +-+ + + + +-+-+ +-+ +-+ + + + + +-+-+ +-+-+-+ +-+-+-+
| | |   | | | | |     | | |   | | | |   | |   |   | | | |   |     |   | | | | | |     |             |
+-+-+ +-+-+-+ +-+ + + +-+ +-+ + +-+ + +-+-+ + + +-+-+-+-+-+ + + +-+ + + + +-+-+-+ + +-+-+ + + + + + +
|       |     |   | |   | |   | |   |     | | |         |   | |   | | | | |       |     | | | | | | |
+ + + +-+-+ + +-+ + + + + +-+ + +-+-+ + + +-+ + +-+ +-+ +-+-+-+-+ +-+ + + + +-+ + +-+-+ +-+ +-+ +-+ +
| | | |     | |   | | | |   | | |     | | |   | |     |   |       |   | | |   | |     |   |   |   | |
+ + + + +-+ + + +-+ + + + +-+ + + +-+-+-+ +-+ + + + +-+-+-+-+-+ +-+ +-+ +-+-+ + +-+ + + +-+ +-+ + + +
| | | |   | | |   | | | | |   | |     |     | | | |           | |     |     | |   | | |   | |   | | |
+-+ +-+-+ +-+ + + +-+-+-+ + + + + +-+ + + + + + +-+ + +-+ +-+-+ + + +-+ + +-+ + +-+ +-+ +-+-+-+ +-+ +
|       | |   | | |       | | | |   | | | | | | |   | |     |   | |   | | |   |   |   |   |     |   |
+ +-+-+ + +-+-+ + + + + + +-+-+ + +-+-+ + + + +-+ + + + + + + + + + + +-+-+ +-+ + +-+ +-+ + + + + + +
|     | |   |   | | | | | |     |   |   | | | |   | | | | | | | | | |     | |   | |   |   | | | | | |
+-+-+ + + + + + +-+-+-+ +-+ + + + + + + + + + + + + + + + + + + + + + + + +-+-+ + + +-+ + +-+-+ + +-+
|     | | | | | |       |   | | | | | | | | | | | | | | | | | | | | | | | |     | | |   |   |   |   |
+ +-+-+-+ + + +-+ + + + + + +-+ + +-+-+-+ +-+-+-+ + + +-+-+ +-+ +-+ + + + + + + + + + +-+ + + +-+-+ +
| |       | |   | | | | | | |   |       |     |   | | |       |   | | | | | | | | | |   | | | |     |
+ +-+-+-+ + + + + + + + + + + + +-+ +-+ + +-+ + +-+ + +-+ + + +-+ + + + + + +-+-+ + +-+ +-+ +-+-+ +-+
| |       | | | | | | | | | | | |   |   | |   | |   |   | | | |   | | | | |     | |   | |     |     |
+ + + + +-+-+-+-+ + + +-+-+ + + + + + +-+ + +-+ +-+ + + +-+ + + +-+ +-+ + + + +-+ +-+ +-+-+-+ + + +-+
| | | |     |     | |   |   | | | | |   | | |     | | |   | | | |     | | | |   |   |     |   | |   |
+ + +-+-+-+ +-+-+ + + + + + +-+-+ +-+ + +-+ + +-+ + + + + + + + +-+ + +-+ +-+ +-+ + + + +-+ + + + + +
| |     |     |   | | | | | |     |   |   | |   | | | | | | | | |   | |     | |   | | | |   | | | | |
+ + +-+ + + + +-+ + + +-+ + + + + +-+-+-+ + +-+ + + +-+-+ +-+-+ +-+ + + + + +-+-+ + +-+ + +-+ + + + +
| |   | | | | |   | | |   | | | |     |   |   | | |   |       | |   | | | | |     | |   | |   | | | |
+ + + + + + + + + + +-+ + + + + +-+-+ +-+-+-+-+ + + + + + + + + + + +-+ + + +-+ + + + +-+ + + + +-+-+
| | | | | | | | | |   | | | | | |       |       | | | | | | | | | | |   | |   | | | |   | | | |     |
+ + + + +-+-+-+ + + + +-+ +-+ +-+-+-+ + + + +-+ + +-+ +-+ +-+ + + + + + + + + +-+-+ + + +-+ + + +-+ +
| | | |     |   | | |   | |       |   | | | |   |   | |     | | | | | | | | |   |   | | |   | |   | |
+ +-+ + + + + + + + + + + + + +-+ + + + + + + + +-+ + + + +-+-+-+ +-+ + + +-+ +-+ +-+ + + + +-+ + + +
| |   | | | | | | | | | | | | |   | | | | | | |   | | | |       |   | | |   |   |   | | | |   | | | |
+ + + + + +-+ +-+ +-+ + + + + + +-+-+-+-+ + + + + +-+-+-+ + + +-+ + +-+ +-+ + + + + +-+ + + + + + + +
| | | | | |     |   | | | | | | |         | | | |     |   | |   | |   | |   | | | | |   | | | | | | |
+ + + +-+ +-+-+ +-+ +-+ + + + + + +-+ +-+ + + + + + + + +-+ + + + +-+ + +-+ +-+ + + +-+ +-+ +-+ + + +
| | |   |     |   |   | | | | | |   |   | | | | | | | | |   | | |   | |   |   | | |   | |   |   | | |
+ + + +-+ + + + +-+ + + + + +-+ +-+-+ + + + + + +-+ +-+ + + + + + + +-+ + + + + + +-+-+-+-+ + + +-+ +
| | |   | | | | |   | | | | |       | | | | | | |     | | | | | | |   | | | | | | |         | | |   |
+-+ +-+-+-+ +-+ +-+-+ + +-+ + + +-+-+-+-+-+ + + + + + + +-+ + + +-+ + +-+ +-+-+ + + + + + +-+-+ + + +
|       |     |     | | |   | |           | | | | | | |   | | | |   |   |     | | | | | | |     | | |
+-+ + + +-+ + + + +-+ +-+-+-+ + + + + + +-+ + + + +-+ + +-+-+ +-+ + + +-+-+-+ + +-+-+ +-+-+ + + +-+ +
|   | |   | | | | |       |   | | | | |   | | | | |   | |       | | |   |     | |         | | | |   |
+ + +-+ + + +-+ + +-+ + +-+ + +-+ +-+ + + + +-+-+ + + + + +-+ + + +-+-+ + + + + + + + + + + + + +-+-+
| | |   | | |   | |   |   | | |     | | | | |     | | | |   | | | |     | | | | | | | | | | | |     |
+-+-+-+-+-+-+-+-+-+-+-+-+-+-+-+-+-+-+-+-+-+-+-+-+-+-+-+-+-+-+-+-+-+-+-+-+-+-+-+-+-+-+-+-+-+-+-+-+-+-+