+-+-+-+-+-+-+-+-+-+-+
| | |       |       |
+ + + +-+ +-+-+-+ +-+
|       | | |   | | |
+ +-+ + +-+ + +-+ + +
|   | |         | | |
+ +-+-+-+ + +-+-+ + +
|     | | |   |     |
+ +-+-+ + +-+ + + +-+
| |       | | | | | |
+ +-+ +-+ + +-+-+ + +
| | |   | |   | |   |
+-+ +-+ +-+-+ + + +-+
|   | |         | | |
+ + + +-+ +-+ + + + +
| | |     | | |     |
+-+ + +-+-+ +-+-+-+-+
| |                 |
+ + +-+-+-+-+-+-+ +-+
|             |     |
+-+-+-+-+-+-+-+-+-+-+