+-+-+-+-+-+-+-+
|             |
+ +-+ + + + +-+
|   | | | |   |
+ + +-+ +-+ +-+
| |   |   |   |
+ +-+-+ + + + +
|     | | | | |
+ +-+ + +-+-+ +
|   | |     | |
+ +-+ +-+ +-+-+
|   |   |     |
+ + + + + +-+ +
| | | | |   | |
+-+-+-+-+-+-+-+