+-+-+-+-+-+-+-+-+-+-+-+-+-+-+-+-+-+-+-+-+-+-+-+-+-+-+-+-+-+-+-+
|     |           |   |             |   |     | | |   |   | | |
+-+ +-+-+-+-+-+-+ + + +-+ +-+-+ +-+-+ + +-+ + + + + +-+ +-+ + +
| |   |             | |     |     | | | | | |       |       | |
+ +-+ +-+ +-+-+ + + +-+-+-+ +-+-+ + + +-+ +-+ +-+ + +-+-+ +-+ +
| |       | |   | |     | | |         |   | |   | |     |     |
+ + +-+-+-+ + + + +-+-+-+ +-+ +-+-+-+ +-+ + +-+-+-+-+ + + + + +
| |     | |   | | |   | | | | |         |   | | |     | | | | |
+ + +-+-+ + + +-+-+ +-+ + + +-+ +-+-+-+ + +-+ + + +-+-+-+ +-+ +
|     | |   | |     | |     |   |   |                   |   | |
+ +-+ + +-+-+ +-+-+ + +-+-+ +-+ +-+ + + +-+-+-+-+-+-+-+-+ + + +
|   | | |   |         |       | |   | |     | | |   |   | | | |
+ +-+-+ + + + +-+-+ +-+ +-+ + + +-+ +-+-+ +-+ + + +-+-+ + +-+ +
| | |     | |     | |   | | | |   |   | | |   |   |     | | | |
+-+ +-+ + + + +-+-+-+-+-+ +-+ + +-+ + + +-+ + +-+ + +-+ + + +-+
| |     | |     |     |         |   |   |   |     | |         |
+ +-+ +-+-+ + + + + + +-+-+ + +-+-+ +-+-+-+-+ +-+ +-+-+-+ + + +
| |   | |   | | | | | |     | |   |     |   | |       |   | | |
+ +-+ + +-+-+-+ +-+-+ + +-+ + +-+ + +-+ +-+ + +-+ + +-+-+ + + +
|     | | |   |     | | |   | |     |     |   |   |       | | |
+ + +-+ + + + + +-+-+ +-+ +-+ + +-+ +-+-+-+ + +-+-+ +-+-+-+ +-+
| |         | | |     | | |   |   |   |   | | | |   | |   |   |
+ +-+-+ +-+-+ +-+ +-+-+ + + +-+-+-+ +-+-+ + +-+ +-+ + + + + + +
| | | |     | | |     | | |               | |           | | | |
+-+ + + +-+-+-+ +-+ + + +-+-+ + + + +-+-+-+ +-+ + +-+ +-+-+ +-+
|     |     | |   | |     |   | | |           | | |     |     |
+-+-+ + +-+-+ +-+ +-+-+ + +-+ + +-+ +-+ + +-+ +-+-+-+ +-+-+-+ +
|           |       |   | |   |   |   | | |   | |   |   |   | |
+-+-+ + +-+ +-+ +-+ +-+-+ +-+-+-+-+-+-+-+ +-+ + + +-+-+ + +-+-+
|     |   |     |   |     |     |   | |   |     |       |     |
+-+ +-+ + +-+-+ +-+-+-+ + + + + + +-+ +-+-+-+ +-+ +-+ + +-+ + +
| |   | |     | |     | | | | |       | |       | |   | |   | |
+ + + + + +-+ +-+ +-+ + +-+-+-+ +-+ + + +-+ +-+-+ +-+ +-+ +-+-+
|   | | | |     | |       |   | |   |   |     | |   | |       |
+-+-+-+-+ +-+ +-+-+-+ +-+-+ +-+-+ +-+-+-+ +-+-+ + +-+ +-+-+-+ +
|   | |     | |   |           |   | | |     |     | |   |     |
+ +-+ +-+ + + + +-+-+-+-+ +-+-+ +-+ + +-+ + + +-+-+ + + +-+ +-+
|     |   | |   |   |   |   |     |   | | | | |     | | |   | |
+ + +-+-+-+-+ +-+ +-+ +-+-+ + +-+-+-+ + +-+-+ +-+-+ + +-+-+ + +
| |     |   | | |       |   |         |       |               |
+ +-+ +-+-+ + + +-+ +-+ + + + + + + + +-+-+-+-+ +-+-+-+-+ + +-+
|   |   |         | |     | | | | | | |       |         | | | |
+ +-+ +-+-+-+ +-+ +-+-+ +-+-+-+ +-+ +-+ +-+ + +-+ + +-+-+ +-+ +
| |     |     |   |       |       |       | |     | |   | |   |
+-+-+ +-+-+-+-+-+ +-+ +-+ + + +-+ +-+-+-+ +-+ +-+ +-+ + + + + +
| | |       |     |     |   | |     |   | |     |   | |     | |
+ + + +-+-+ +-+ + +-+-+ +-+ +-+ +-+-+ +-+ +-+ + +-+-+-+ +-+-+-+
|   | |   |     |   | | | | |       |   | | | |   | | |   |   |
+ +-+-+-+ + + + + +-+ + + +-+ + + + +-+ +-+ + + +-+ + +-+ +-+ +
|       | | | | | |       |   | | |   |     | | | |         | |
+ +-+-+ + +-+-+-+ +-+ +-+ +-+-+-+ +-+ + +-+-+ +-+ +-+-+ +-+-+ +
| | |             |     | | |     |     |     | | |   |   |   |
+-+ +-+-+-+-+ +-+ + +-+-+ + + +-+ + +-+-+-+ + + + +-+ + +-+ +-+
|     |   |   |   | | |   |   |   | | |   | |     |           |
+-+ +-+ +-+-+-+-+ + + + +-+ +-+-+ +-+ + +-+ +-+ +-+-+-+ +-+ +-+
|       |   |     | |     |     |     |   |   | |   |     |   |
+ + +-+ + +-+ +-+-+ +-+ +-+-+-+-+ +-+ + +-+-+-+ + + +-+-+-+ +-+
| | | |         |     | |         |       |   |   | |         |
+-+-+ + + +-+-+ +-+-+ + +-+-+-+-+-+-+ + +-+ +-+-+ +-+-+-+-+-+ +
|   |   |   | |       |       | |   | |       |       |   | | |
+-+ + +-+-+ + + +-+-+ +-+ + + + +-+ + +-+ +-+ +-+ + +-+ +-+ + +
|     |     |       |   | | |     |     | |     | |   |       |
+-+-+-+-+-+-+-+-+-+-+-+-+-+-+-+-+-+-+-+-+-+-+-+-+-+-+-+-+-+-+-+