+-+-+-+-+-+-+-+-+-+-+-+-+-+-+-+-+-+-+-+-+-+-+-+-+-+-+-+-+-+-+-+
|                                                             |
+ +-+-+ + +-+-+ +-+-+-+ +-+ + +-+ + +-+-+ +-+ +-+-+-+-+ +-+-+-+
|     | |     |       |   | |   | |     |   |         |       |
+ +-+ + +-+ + + +-+ + + +-+ +-+ + + +-+ +-+-+ +-+ +-+-+-+ + + +
|   | |   | | |   | | |   |   | | |   |     |   |       | | | |
+ + + +-+ + + +-+-+-+-+ +-+-+ + +-+-+-+ +-+ + + +-+-+-+-+-+ +-+
| | |   | | |         |     | |       |   | | |           |   |
+ + +-+ +-+ +-+ + + +-+-+-+ + +-+-+-+-+ +-+ + +-+-+ +-+ +-+ + +
| |   |   |   | | |       | |         |   | |     |   |   | | |
+ +-+ +-+-+-+-+ + +-+ + +-+-+ +-+-+-+ +-+ +-+ + + +-+ + +-+ +-+
|   |         | |   | |     |       |   |   | | |   | |   |   |
+ + +-+ + + +-+ +-+ +-+-+ + +-+-+ + +-+-+ + +-+ + +-+-+-+-+-+ +
| |   | | |   |   |     | |     | |     | |   | |           | |
+ +-+ + +-+ + +-+ +-+-+-+-+-+ + +-+-+ + + + +-+-+-+ + + +-+-+ +
|   | |   | |   |           | |     | | | |       | | |     | |
+ + + + + +-+-+ +-+-+-+-+-+ +-+ + +-+ + + + +-+-+-+-+-+-+ + + +
| | | | |     |           |   | |   | | | |             | | | |
+ +-+ +-+ + +-+-+-+ +-+ + +-+ + +-+ +-+-+ +-+ + +-+ + +-+ +-+-+
|   |   | |       |   | |   | |   |     |   | |   | |   |     |
+ +-+ + + +-+ +-+ + +-+-+ + + + + +-+-+ + +-+-+ +-+ + +-+-+-+ +
|   | | |   |   | |     | | | | |     | |     |   | |       | |
+ +-+ + +-+-+ + + + +-+ +-+-+-+ +-+ + +-+ +-+-+-+ +-+-+-+ +-+ +
|   | |     | | | |   |       |   | |   |       |       |   | |
+ +-+ +-+-+ +-+-+ +-+-+-+ +-+-+ +-+-+ + + +-+-+-+ + + +-+-+-+ +
|   |     |     |       |     |     | | |       | | |       | |
+ +-+-+-+-+ +-+ + +-+ +-+ + + +-+-+-+-+ +-+ +-+-+ +-+ +-+-+ + +
|         |   | |   |   | | |         |   |     |   |     | | |
+ + + +-+ + +-+-+-+ + +-+ +-+ + + +-+-+-+ +-+-+ + + + +-+-+ + +
| | |   | |       | |   |   | | |       |     | | | |     | | |
+ +-+-+ + +-+ + +-+-+-+ +-+-+ + + + +-+-+ + + + +-+-+-+-+-+-+ +
|     | |   | |       |     | | | |     | | | |             | |
+ +-+ + +-+-+-+-+ +-+ +-+-+-+ +-+ +-+-+-+-+-+-+ +-+-+-+-+ +-+-+
|   | |         |   |       |   |             |         |     |
+ + + +-+-+-+-+ +-+-+ +-+-+ + +-+ + + +-+-+-+ + +-+ +-+-+-+-+-+
| | |         |     |     | |   | | |       | |   |           |
+ +-+ + + + +-+ + + +-+ + +-+ +-+ + +-+ +-+ +-+ + +-+ +-+-+ + +
|   | | | |   | | |   | |   |   | |   |   |   | |   |     | | |
+ + +-+-+-+-+ + +-+-+-+ +-+-+ +-+ + + +-+ +-+-+ +-+-+-+ +-+-+-+
| |         | |       |     |   | | |   |     |       |       |
+ + + +-+-+-+-+-+ + + + +-+ + + + +-+-+ +-+-+-+-+-+ + + + + +-+
| | |           | | | |   | | | |     |           | | | | |   |
+ + + + +-+ + + +-+-+-+ +-+-+-+-+ +-+ +-+ + +-+-+-+ + + +-+-+-+
| | | |   | | |       |         |   |   | |       | | |       |
+ + + +-+-+ +-+ + + + +-+-+ + +-+-+ +-+-+-+-+ +-+ + + + +-+-+ +
| | |     |   | | | |     | |     |         |   | | | |     | |
+ +-+-+ + +-+-+-+-+-+ + + +-+-+ +-+-+-+ +-+ + + +-+-+-+-+-+-+-+
|     | |           | | |     |       |   | | |               |
+ +-+-+ + +-+-+-+ +-+-+ + + + + +-+-+-+ + + + + +-+-+ + +-+-+-+
|     | |       |     | | | | |       | | | | |     | |       |
+ +-+-+ +-+-+-+-+-+-+-+-+ +-+ +-+-+-+ + + +-+-+-+ +-+ +-+-+ +-+
|     |                 |   |       | | |       |   |     |   |
+ +-+-+ + +-+-+ +-+-+-+ + +-+ + +-+-+-+ +-+ +-+-+ + + +-+ +-+ +
|     | |     |       | |   | |       |   |     | | |   |   | |
+ +-+-+-+-+-+-+-+ +-+-+ + +-+-+-+ + +-+ + + +-+ +-+ + + +-+ +-+
|               |     | |       | |   | | |   |   | | |   |   |
+ +-+ + + +-+-+ +-+ + +-+ + + + + + + + +-+ + + + + +-+ +-+-+ +
|   | | |     |   | |   | | | | | | | |   | | | | |   |     | |
+ + +-+-+-+ +-+-+ + +-+-+-+-+ +-+-+-+-+ + + +-+ + +-+ +-+-+-+-+
| |       |     | |         |         | | |   | |   |         |
+ + +-+ +-+-+ +-+ +-+ +-+-+-+ +-+ + +-+ +-+ + + + +-+-+ +-+-+ +
| |   |     |   |   |       |   | |   |   | | | |     |     | |
+-+-+-+-+-+-+-+-+-+-+-+-+-+-+-+-+-+-+-+-+-+-+-+-+-+-+-+-+-+-+-+