+-+-+-+-+-+-+-+-+-+-+-+-+-+-+-+-+-+-+-+-+-+-+-+-+-+
|                                                 |
+ +-+-+ +-+ + + +-+-+-+ + + + + +-+ + +-+-+ + +-+ +
|     |   | | |       | | | | |   | |     | |   | |
+ +-+ +-+ +-+-+-+ +-+ +-+ + + +-+ + +-+ +-+ + + +-+
|   |   |       |   |   | | |   | |   |   | | |   |
+ + +-+-+ + +-+-+ +-+ +-+ +-+ +-+-+-+ +-+ +-+-+-+-+
| |     | |     |   |   |   |       |   |         |
+ +-+ +-+ +-+ + +-+ + + + +-+ +-+-+ + + +-+-+-+-+ +
|   |   |   | |   | | | |   |     | | |         | |
+ + +-+ + + +-+ + + + + + +-+ + + +-+-+ + + + +-+ +
| |   | | |   | | | | | |   | | |     | | | |   | |
+ + + + + +-+-+ + +-+ + + +-+-+-+-+ +-+ +-+-+ +-+-+
| | | | |     | |   | | |         |   |     |     |
+ +-+-+ + + +-+-+-+ +-+ + +-+-+-+-+ +-+-+-+-+ + +-+
|     | | |       |   | |         |         | |   |
+ +-+-+ + +-+ +-+-+ +-+-+ + + +-+-+ +-+-+ + +-+ +-+
|     | |   |     |     | | |     |     | |   |   |
+ +-+-+-+ + +-+ +-+-+-+ + +-+-+-+ +-+ + + + +-+-+-+
|       | |   |       | |       |   | | | |       |
+ +-+-+-+ +-+-+-+-+-+ +-+-+-+-+-+-+-+-+-+-+-+ + + +
|       |           |                       | | | |
+ + + + + +-+-+ + + +-+ + +-+-+ +-+-+ + +-+-+-+ + +
| | | | |     | | |   | |     |     | |       | | |
+ +-+-+ +-+-+ +-+ + +-+ +-+ + +-+ + + + +-+-+ +-+-+
|     |     |   | |   |   | |   | | | |     |     |
+ +-+-+-+-+-+-+-+-+-+ + + +-+ + + +-+-+-+ + + +-+ +
|                   | | |   | | |       | | |   | |
+ + + + +-+ + +-+ + +-+-+-+-+ + + +-+ + +-+ +-+ +-+
| | | |   | |   | |         | | |   | |   |   |   |
+ +-+ +-+ + + +-+ + +-+-+-+-+ +-+-+-+ +-+ +-+ +-+-+
|   |   | | |   | |         |       |   |   |     |
+ +-+ +-+ + + +-+-+-+-+ + + + +-+ + +-+-+-+-+ + + +
|   |   | | |         | | | |   | |         | | | |
+ + +-+-+-+-+-+-+-+ + +-+ +-+ + +-+-+ + +-+-+ +-+-+
| |               | |   |   | |     | |     |     |
+ + + + +-+-+-+-+-+-+ + + +-+-+-+-+-+-+-+ +-+-+-+ +
| | | |             | | |               |       | |
+ +-+ + +-+ +-+ +-+ + + +-+-+-+ +-+ + +-+ +-+ + +-+
|   | |   |   |   | | |       |   | |   |   | |   |
+ + +-+-+-+ + + + +-+ + + + +-+ +-+-+-+ +-+ +-+-+-+
| |       | | | |   | | | |   |       |   |       |
+ +-+-+ +-+-+ + +-+-+ +-+ +-+ +-+-+-+ + +-+-+-+-+ +
|     |     | |     |   |   |       | |         | |
+ +-+ +-+ +-+ +-+-+-+ + + + + + +-+ + +-+-+ + +-+ +
|   |   |   |       | | | | | |   | |     | |   | |
+ + +-+ + +-+-+ + +-+ + + +-+-+ + +-+-+ + +-+ + +-+
| |   | |     | |   | | |     | |     | |   | |   |
+ + + + +-+ +-+ + +-+ +-+ + + +-+-+ +-+-+ + +-+ +-+
| | | |   |   | |   |   | | |     |     | |   |   |
+-+-+-+-+-+-+-+-+-+-+-+-+-+-+-+-+-+-+-+-+-+-+-+-+-+