+-+-+-+-+-+-+-+
|             |
+ + + +-+-+-+-+
| | |         |
+ +-+-+-+ + + +
|       | | | |
+-+-+ + + +-+ +
|     | | |   |
+ +-+-+ + + + +
|     | | | | |
+-+-+-+ + +-+ +
|       | |   |
+ + + + +-+ + +
| | | | |   | |
+-+-+-+-+-+-+-+