+-+-+-+-+-+-+-+
|             |
+ +-+ + + +-+ +
|   | | |   | |
+ +-+ + + +-+-+
|   | | |     |
+ +-+ +-+ +-+ +
|   |   |   | |
+ + + + +-+ +-+
| | | |   |   |
+ +-+ + + +-+ +
|   | | |   | |
+ +-+-+-+ + +-+
|       | |   |
+-+-+-+-+-+-+-+