+-+-+-+-+-+-+-+-+-+-+-+-+-+-+-+-+-+-+
|                                   |
+ + +-+-+-+ +-+-+ +-+-+-+-+ +-+-+-+-+
| |       |     |         |         |
+ + +-+ + +-+ + +-+-+ +-+-+ + + + + +
| |   | |   | |     |     | | | | | |
+ + + + +-+ +-+-+-+ +-+-+-+-+-+ +-+-+
| | | |   |       |           |     |
+ +-+ +-+-+-+ + +-+ + +-+-+ +-+ +-+-+
|   |       | |   | |     |   |     |
+ + + + + +-+ + +-+-+ + +-+ + +-+-+-+
| | | | |   | |     | |   | |       |
+ + +-+-+ +-+-+ + +-+ + + +-+ +-+-+ +
| |     |     | |   | | |   |     | |
+ +-+-+-+ + + + + +-+ +-+-+ + +-+ +-+
|       | | | | |   |     | |   |   |
+ + + + + + +-+ +-+-+-+ +-+ + +-+ + +
| | | | | |   |       |   | |   | | |
+ +-+ + + + + +-+-+-+-+ +-+ +-+ +-+ +
|   | | | | |         |   |   |   | |
+ +-+-+-+ + +-+ +-+ + +-+ +-+-+-+ + +
|       | |   |   | |   |       | | |
+ + +-+-+ + + + + +-+-+-+ + +-+-+-+-+
| |     | | | | |       | |         |
+ + + + +-+-+ +-+-+-+-+-+-+ + + +-+-+
| | | |     |             | | |     |
+ + + + +-+ + + +-+-+-+ +-+-+ +-+ +-+
| | | |   | | |       |     |   |   |
+ + + +-+-+ + + +-+ +-+-+-+-+-+ + +-+
| | |     | | |   |           | |   |
+ +-+ +-+-+-+ +-+-+ + + + +-+-+-+ + +
|   |       |     | | | |       | | |
+ + +-+ +-+ + + + + + +-+ +-+-+ + + +
| |   |   | | | | | |   |     | | | |
+ + + + + +-+ +-+ + + + +-+ + +-+-+-+
| | | | |   |   | | | |   | |       |
+-+-+-+-+-+-+-+-+-+-+-+-+-+-+-+-+-+-+