+-+-+-+-+-+-+-+
|             |
+ + + +-+ +-+ +
| | | |   |   |
+ +-+ +-+-+ + +
| |     |   | |
+ +-+ +-+ +-+ +
|   | |     | |
+ + +-+ + + + +
| | |   | | | |
+ +-+-+ + + + +
|     | | | | |
+ +-+ +-+-+-+ +
| |       |   |
+-+-+-+-+-+-+-+