+-+-+-+-+-+-+-+
|             |
+ + +-+ + +-+-+
| |   | |     |
+ + +-+-+ +-+ +
| |     |   | |
+ +-+-+-+ +-+ +
|       |   | |
+ + +-+ +-+-+ +
| |   |     | |
+ + +-+ +-+ + +
| |   |   | | |
+ + +-+-+ +-+ +
| |     |   | |
+-+-+-+-+-+-+-+