+-+-+-+-+-+-+-+-+-+-+-+-+-+-+-+-+-+-+-+-+-+-+-+-+-+-+-+-+-+-+-+-+-+-+-+-+-+-+-+-+-+
|                                                                                 |
+ +-+-+ +-+ + + + + + +-+-+ + + +-+ + + +-+ + +-+-+-+ +-+ +-+ +-+-+ +-+ + + + + + +
|     |   | | | | | |   |   | | |   | | |   |       |   |   | |       | | | | | | |
+ +-+ +-+-+ +-+-+ + +-+ + + + +-+-+ +-+-+ +-+ + + +-+-+-+ + + +-+ +-+ +-+ + + +-+ +
| |       | |     |   | | | | |     |     |   | |       | | | |     |   | | |   | |
+ +-+ +-+-+ +-+ + + + + +-+-+ + + + + +-+ +-+ +-+ + +-+-+-+ +-+-+ +-+ + + +-+ +-+ +
|   |   |   |   | | | |   |   | | | |   | |     | |       |   |     | | |   | |   |
+ + + +-+-+-+ + +-+ + + + + + + +-+-+-+ + + +-+-+ + +-+ + +-+ + +-+-+-+ + + +-+ + +
| | |   |     | |   | | | | | |       | | | |     | |   |   | |       | | |   | | |
+ +-+ +-+-+ +-+ +-+ + + +-+ + + + + +-+ + +-+ + + + +-+-+-+-+-+ +-+ + + + + +-+ + +
| |     |     |   | | | |   | | | |   | | |   | | |         |   |   | | | | |   | |
+ + + + +-+-+-+-+-+ +-+-+ + +-+ + +-+ + + + +-+ + + +-+-+ + + + + + + +-+ +-+ + + +
| | | |           | |     |   | | |   | | | |   | |     | | | | | | | |   |   | | |
+ + + + + +-+ + + + + + +-+ +-+ +-+-+ + + + +-+-+ +-+ +-+ + + + +-+ + +-+-+-+ + + +
| | | | |   | | | | | |   | |     |   | | | |       | |   | | |   | |   |     | | |
+ +-+ + + +-+-+ + + +-+-+ + +-+ +-+-+ + + +-+-+ + +-+-+ + + + + +-+-+-+-+ + + + + +
| |   | |     | | | |     |   | |     | |     | | |     | | | |         | | | | | |
+ + +-+ + + + + +-+ + + + + + + + + +-+ + +-+ +-+-+-+ + +-+ + + +-+ +-+-+-+ +-+ + +
| |   | | | | |   | | | | | | | | | |   | |       |   | |   | | |   |         | | |
+ + + +-+ + +-+ + + + + + + +-+-+ +-+ + + + +-+ + + + + + + + + + +-+-+-+-+ +-+ +-+
| | | |   |   | | | | | | |     | |   | | |   | | | | | | | | | | |         |     |
+ +-+ + +-+ +-+ + + + + + +-+-+-+-+ +-+ + + +-+ +-+-+ + + + + + + + + +-+-+-+ +-+ +
| |   |   | |   | | | | |         |   | | | |       | | | | | | | | |       | |   |
+ + + +-+ + +-+ +-+ +-+ + + + +-+-+ +-+-+ + + + +-+-+ + + + +-+ + + + + + +-+-+ + +
| | |   | |   | |     | | | | |       |   | | |     | | | | |   | | | | |   |   | |
+-+ +-+ + + + +-+-+-+-+ +-+ +-+ +-+ +-+ + + +-+-+-+-+-+ +-+ + + + + + + +-+-+-+-+ +
|     | | | | |           |   |   | |   | |         |   |   | | | | | |     |     |
+ +-+ +-+-+ + +-+-+ + + + +-+-+-+ +-+ + + +-+-+ + +-+ + + + + +-+ + + + +-+ +-+ + +
| |       | |   |   | | | |         | | |   |   | |   | | | | |   | | | |     | | |
+ +-+ + + + +-+ +-+ + + +-+ + +-+ +-+ +-+ + +-+-+ +-+ +-+ + + +-+-+ +-+ + + + + + +
|   | | | |   |   | | | |   |   | |     | | |       | |   | |   |     | | | | | | |
+-+ + +-+-+ + + + + +-+-+-+ + +-+-+ + + + +-+ + + + + +-+ +-+ + + + + +-+ + + +-+ +
|   | |     | | | | |       |     | | | | |   | | | | |     | | | | |   | | |   | |
+ + +-+ +-+-+-+ +-+ + + + +-+-+ + + +-+-+ + +-+ +-+ + +-+ + + +-+-+ + +-+-+ + + + +
| |   | |         | | | |     | | |   |   | |     | |   | | | |     |     | | | | |
+ + +-+ +-+ + +-+ + + +-+ + + + + +-+ + + +-+ + +-+ + +-+ + + +-+ +-+ + +-+ +-+ + +
| | |     | | |   | |   | | | | | |   | | |   | |   | |   | |   | |   | |     | | |
+ + + +-+ +-+ + + + + + + +-+ + + + +-+-+ + +-+-+ + + + + + + + +-+ +-+-+-+-+ + + +
| | | |   |   | | | | | |   | | | |   |   |     | | | | | | | | |           | | | |
+ +-+ +-+-+ + +-+ + +-+-+-+ + +-+ +-+ + + + + +-+ +-+-+-+-+ + +-+ +-+ +-+ + + + + +
|   |   |   |   | |       | | |   |   | | | |   |   |       |   |   | |   | | | | |
+ +-+ + + +-+ +-+-+ + +-+ + + + +-+ +-+ + + + + + + +-+-+ +-+ + + + +-+-+ +-+-+-+ +
| |   | |   | |     |   | | | | |     | | | | | | |     |   | | | |     | |       |
+ + +-+ + + +-+ + + + +-+ + + + + + + + + + + + +-+ + + + + + + + + + +-+-+ + + +-+
| | |   | |   | | | | |   | | | | | | | | | | | |   | | | | | | | | | |     | |   |
+ + + +-+-+ + + +-+-+-+ + + +-+ + + + + +-+-+-+ + +-+-+ +-+-+ + +-+-+ +-+ + + +-+ +
| | | |     | | |       | | |   | | | | |       |   |       | | |       | | | |   |
+ + +-+ + + +-+ +-+ +-+-+-+-+ +-+ + + + +-+ + + + + + +-+ + + +-+ + + + + + + + + +
| |   | | | |   |       |       | | | |   | | | | | | |   | |   | | | | | | | | | |
+ + +-+-+ + + +-+ + + + + + + +-+-+-+ + + + + + +-+-+-+ +-+ + + + + + + + + +-+-+ +
| |     | | | |   | | | | | | |       | | | | |       | |   | | | | | | | |   |   |
+-+ +-+ + + + + + + + + + + +-+ + +-+-+ + + +-+ + + + + + +-+ + + + + + + + + + + +
|     | | | | | | | | | | | |   |     | | |   | | | | | |   | | | | | | | | | | | |
+-+ + +-+ + +-+ + +-+ + +-+ + +-+ +-+ + +-+-+-+-+ +-+ +-+-+ +-+ + + +-+ +-+ + + + +
|   |   | |   | | |   |   | | |   |   | |           |   |     | | |   | |   | | | |
+ +-+-+ +-+ + +-+ + +-+-+ +-+ + + +-+ +-+-+ + + +-+ + + + + +-+-+-+-+ + + + +-+ + +
| |     |   | |   |     |   | | |   |   |   | |   | | | | | |         | | | |   | |
+ + +-+-+-+ + +-+ +-+ + + + + +-+ + + + + + + + + +-+-+-+-+-+ +-+-+-+ + + + + +-+ +
| |       | |   | |   | | | | |   | | | | | | | | |           |       | | | |   | |
+ + +-+ + +-+ +-+-+ + +-+ +-+ +-+ + +-+ + + + +-+-+ +-+-+ +-+ +-+-+ + + + + + + + +
| |   | |   |   |   |   |   | |   | |   | | | |         |   |   |   | | | | | | | |
+ + +-+ + + + + +-+ + + +-+ + + + + + +-+ + +-+ + + +-+ +-+ + +-+ + + + +-+-+ + + +
| | |   | | | |   | | |   | | | | | |   | |   | | | |     | |   | | | | |     | | |
+-+ + +-+ + + + + + + +-+ +-+ +-+-+-+ + + + + + +-+-+ + + + + + + + + + + + + + + +
|   |   | | | | | | |   | |       |   | | | | | |     | | | | | | | | | | | | | | |
+ + + + + + + + +-+ +-+ + + + + + + +-+ + + + + + + + +-+ +-+ +-+ + + + + + + + + +
| | | | | | | |   |   | | | | | | | |   | | | | | | |   | |   |   | | | | | | | | |
+ + +-+-+ + + + +-+-+-+ + + + + + +-+ +-+-+ + +-+ + + + + + + + +-+ +-+ + +-+ + +-+
| |   |   | | |     |   | | | | | |       | |   | | | | | | | |   | |   |   | |   |
+ + + + + + + + +-+ + +-+ + +-+ +-+ + + +-+ +-+ + + + + + + + + +-+ + + +-+-+-+ + +
| | | | | | | | |   |   | |   | |   | | |     | | | | | | | | |   | | |     |   | |
+-+ +-+ +-+ +-+-+-+-+ + + + + + +-+-+-+-+ + + + + + + + + + + +-+ + + + + + +-+ + +
|     |   | |         | | | | |   |       | | | | | | | | | | |   | | | | | |   | |
+-+ +-+ + +-+ +-+ + + + + +-+-+ + + + +-+-+ + + + +-+ +-+ + + +-+ +-+ + + + + + + +
|   |   | |     | | | | | |     | | | |     | | |   |   | | |   | |   | | | | | | |
+ + + +-+ + + +-+ + +-+ + + + + +-+-+ +-+ + + +-+ + + +-+ + + + +-+-+ +-+ + +-+ + +
| | |   | | | |   |   | | | | |     | |   | | |   | |   | | | |   |   |   | |   | |
+ +-+ + + + + +-+-+-+ + + +-+-+-+ +-+-+ + + +-+-+-+-+ + + +-+ + +-+ +-+-+ +-+-+ + +
|   | | | | | |       | |       |   |   | |     |     | |   | | |       |   |   | |
+ + + + + +-+ +-+ +-+ + + +-+ + + + + + + + + + + + +-+-+ +-+ +-+ + +-+ + + + +-+ +
| | | | |   |   | |   | | |   | | | | | | | | | | | |     |     | |   | | | | |   |
+-+-+-+-+-+-+-+-+-+-+-+-+-+-+-+-+-+-+-+-+-+-+-+-+-+-+-+-+-+-+-+-+-+-+-+-+-+-+-+-+-+