+-+-+-+-+-+-+
|           |
+-+ +-+-+ + +
|       | | |
+ +-+-+-+ + +
|       | | |
+ +-+ + + + +
| |   | | | |
+ + +-+-+ + +
| |   |   | |
+ + +-+-+ +-+
| |     |   |
+-+-+-+-+-+-+