+-+-+-+-+-+
|         |
+ + + + +-+
| | | |   |
+ + + +-+ +
| | |   | |
+ +-+ + +-+
|   | |   |
+ + +-+-+ +
| |     | |
+-+-+-+-+-+