+-+-+-+-+-+-+-+
|             |
+ +-+ + + + +-+
|   | | | |   |
+ +-+-+ +-+-+-+
|     |       |
+ + + + +-+ +-+
| | | |   |   |
+ + + + + +-+ +
| | | | |   | |
+ +-+ +-+-+-+-+
|   |         |
+ + +-+ + +-+-+
| |   | | | | |
+-+-+-+-+-+-+-+