+-+-+-+-+-+-+-+-+-+-+-+-+-+-+-+-+-+-+-+-+-+-+-+-+-+-+-+-+-+-+-+-+-+-+-+-+-+-+-+-+-+
|     |                   |             |                 |             |   |     |
+-+-+ +-+-+ +-+-+ +-+-+-+ +-+-+-+ +-+-+ +-+-+-+ +-+-+-+-+-+ +-+-+-+-+ +-+ + + + +-+
|   | |   |     | |     |     |   |   |       |       |   | |       |     | | |   |
+ +-+ + + + +-+ +-+ +-+ +-+-+ + +-+ + +-+-+-+ + +-+-+ + + + + +-+-+ + +-+-+ + +-+ +
| |   | | |   | |     |   |   |     | |     | | |   |   |   | |     |     | | |   |
+ + +-+ + +-+ + + +-+-+-+ +-+ +-+-+-+ +-+-+ + + +-+ +-+-+-+-+ + +-+-+-+-+-+ + + +-+
|   |   |   | |   |     |   |       | |     | |       |       | |           | |   |
+ +-+ +-+-+ +-+-+-+ +-+ +-+ +-+-+-+ + + +-+ + +-+-+-+ + +-+-+-+ + + +-+-+-+-+ +-+ +
|     | |   |     | | |     | |   |   |   | |   |   | | |         | |         | | |
+-+-+-+ + +-+ +-+ + + +-+-+-+ + + +-+-+ + +-+-+ + + +-+ +-+-+-+-+ +-+ +-+-+-+-+ + +
| |     | |   | |   |         | |     | |     |   | |   |       | |   |   |     | |
+ + + +-+ + +-+ +-+-+-+-+-+-+ + +-+ +-+ +-+-+ +-+-+ + + + +-+-+ +-+ +-+ + + +-+-+ +
| | |     |   |             | |   |     |   |       | | |     |     |   |   |     |
+ + +-+-+-+ + + +-+-+-+-+-+ + +-+ +-+-+-+ +-+-+-+-+-+ + +-+-+ +-+-+-+ +-+-+ + +-+-+
| |   |     | |     | |         |   |     |     |     | |   |   | |   |     |     |
+ +-+ +-+-+-+ +-+-+ + + +-+-+-+-+-+ + +-+ + +-+ + +-+ + +-+ +-+ + + + + +-+-+-+-+ +
|   |         |   | | | |   |       |   | | |   | |   |     |   |   | | |   |     |
+-+ +-+-+-+-+-+ + + + + + + + +-+-+-+-+ + + + +-+ + +-+-+-+ + +-+-+-+ +-+ + + +-+ +
|     |   |     |   |     | |       |   |   | |   |       | |   |     |   | |   | |
+ +-+ +-+ + +-+ +-+-+ +-+-+-+-+-+-+ +-+-+-+-+ + +-+-+-+-+ +-+-+ + +-+-+ +-+ + + + +
|   |     |   |   |   | |     |   | |       | | |       |     | | |   |   | | | | |
+-+ +-+-+-+ +-+-+ +-+ + + +-+ + + + + +-+-+ + + +-+-+ + +-+ +-+ + + + +-+ + +-+ + +
|   |       |   |   | | | | |   |   |   | | | |     | | |   |   |   |   | |     | |
+ + + +-+-+-+ + +-+ + + + + +-+-+-+-+-+ + + + +-+-+ + + + +-+ +-+-+-+ +-+ +-+-+-+ +
| | |   |     |     |   |   |   |       |   |     | | | |   |   |     |   |       |
+ +-+-+ + +-+-+-+-+-+-+-+-+ + +-+ +-+ +-+ +-+ +-+ + + +-+-+ +-+ + +-+ + +-+-+-+-+ +
| |   | | |             |   |     |   | | | |   |   |     | |   |   | |     |   | |
+ + + + + + +-+-+-+-+-+ + +-+-+-+-+ +-+ + + +-+ +-+-+-+ +-+ + +-+ + +-+-+-+ + + + +
|   |   | |     |     | |   |       |   | |   |   |     |   |   | |       |   | | |
+-+-+-+-+ +-+-+ +-+ + + +-+ + +-+-+-+ +-+ + + +-+ + +-+-+ +-+-+ + +-+ +-+-+-+-+ +-+
|     |       |     | |   | |   |   |     | |     | |   | |     |   |       | |   |
+ +-+ + +-+-+ +-+-+-+ + +-+ +-+ + +-+ +-+-+-+-+ +-+ + + + + +-+-+-+-+-+-+ + + +-+ +
| | | |     |   |     |   |     |   |   |     |   | | |   | |     |   |   |   |   |
+ + + +-+-+ +-+ + +-+-+-+ +-+-+-+-+ +-+ +-+ + +-+ + + +-+-+ + + + + + + +-+-+ + + +
| | | |   |   | | | |     |           | |   |   |   |       | | | | |   |   | | | |
+ + + + + + + + + + + +-+ + +-+-+ +-+ + + +-+-+ +-+ +-+-+-+-+-+ + + +-+-+-+ + + +-+
| | | | | | | | |   | |   | |   | |   |   |   | | |             | |       |   |   |
+ + + + + + + +-+ +-+ + +-+ + +-+ +-+-+-+-+ + + + +-+-+ +-+-+-+-+ +-+-+-+ +-+-+-+ +
| |   | | | | |   |   | |   | |   |       | |   |   |   |       |         |       |
+ +-+ + + +-+ + +-+ +-+ + +-+ + +-+ + +-+ + +-+-+ +-+ +-+ +-+-+ +-+-+ +-+-+ +-+-+ +
|   |   |     | | | |   |     | |   |   | | |   |   | |   |   |     | |     |   | |
+ + +-+-+-+ +-+ + + +-+ +-+-+ + + +-+-+ +-+ + + + + + + + + + +-+-+ +-+ +-+-+ +-+ +
| |     |   |   | |   |     | |   |   | |   | |   |   | | | |     |     |     |   |
+ +-+-+ + +-+ +-+ +-+ +-+-+-+ +-+-+ + + + +-+-+-+-+ +-+ +-+ +-+-+ +-+-+-+ +-+ + +-+
|   |   |   |   |   |         |   | |   |         |   |       |   |         | | | |
+-+ + +-+-+-+-+ + + +-+-+-+-+-+ + + +-+ +-+-+-+-+ +-+ +-+-+-+ + +-+-+-+-+-+-+ + + +
|   |   |     | | |       |   | |   | |     |   | | | | |   | |       |     | |   |
+ +-+-+ + +-+ + +-+-+ +-+ + +-+ +-+-+ +-+-+ + + + + + + + + +-+-+ +-+ + +-+ + +-+ +
| |   |   |   | |   | |   |   |   |       | | |   | |   | |     | |   | | |   |   |
+ +-+ +-+-+ +-+ + + + + +-+-+ +-+ + +-+-+-+ + +-+-+ +-+ + +-+-+ +-+ +-+ + +-+ + +-+
|   |     |     | | | | |   |   | | |       | |         |   |   |   |   |     |   |
+-+ +-+-+ +-+-+-+ + + + + + + + + + + +-+-+-+ + +-+-+-+-+-+ + +-+ +-+ +-+-+-+-+-+ +
| |           |   |   | | | | | | | |     |   |   |   |     |     |     |         |
+ +-+-+-+-+-+ + +-+-+-+ + + +-+ + + + +-+-+ +-+-+ + + + +-+-+-+-+-+ +-+ + +-+-+-+-+
|           |   |     | | |     | |   |   | |     | | | |         |   |     |     |
+ +-+-+-+ +-+-+-+ +-+ + + +-+ +-+ + +-+ + + + +-+-+ + + +-+ +-+-+ + +-+-+-+ +-+ + +
| |   |   |     |   |     |   |   | |   |   |   |   | |   |     |   |     |   | | |
+ + + + +-+ +-+ +-+ +-+-+-+ +-+ +-+-+ +-+-+-+-+ + +-+ +-+ +-+-+-+ +-+ +-+ +-+ +-+ +
| | | |       |   |   |   | |   |   |   |     |   |     |       | |     | | |   | |
+ + + +-+-+-+-+ + + +-+ + +-+ + + + +-+ + +-+ +-+-+-+-+-+ +-+-+ +-+ +-+-+ + +-+ + +
|   | |       | |   |   |     | | |   | | |         |   |   | |   | |   | | |   | |
+-+-+ + +-+-+ + +-+-+ +-+ +-+-+ + +-+ + + +-+-+-+-+ + + +-+ + +-+ + + + + + + +-+ +
|     |   |   |     | |   |   | | | |   |   |     | | | |       |   | |   | |     |
+ +-+-+-+ + +-+-+-+-+ +-+-+ + +-+ + +-+-+-+ +-+ + + + + +-+-+-+-+ +-+ +-+-+ +-+-+ +
| |   |   |           |     |     |       |   | | |   |   |     |   | |       |   |
+-+ + + +-+-+-+-+-+-+ + +-+-+-+-+-+ +-+-+ +-+ +-+ +-+-+-+ + +-+ +-+-+ + +-+-+ + +-+
|   |   |   |         | |           |       | |         | | | |       | |     | | |
+ +-+-+-+ + +-+ +-+-+-+ + +-+ +-+-+-+-+-+-+ + + +-+-+-+ + + + +-+-+-+-+ +-+-+ + + +
|   |     |   | |       |   |       |   |     |     |   |   |       |   |   | | | |
+ + + +-+-+-+ + + +-+-+-+-+ +-+-+-+ + + +-+-+-+ +-+ + +-+-+-+ +-+-+-+ + + + +-+ + +
| |         | | |     |   | |     |   |       | | | |         |   |   |   |   |   |
+-+-+-+-+ +-+ +-+-+-+ + + + + +-+-+-+-+ +-+-+ + + + +-+-+-+-+-+ + + +-+-+-+-+ +-+ +
|       | |   |     | | | |   |       |   |   |   | |   |       |   |     |   | | |
+ +-+-+ +-+ + + +-+ + + +-+-+ + +-+-+ + +-+ +-+-+-+ + + + +-+-+-+-+-+ + +-+ + + + +
| |       | | |   | | |       | |     | |   |       | |   |   |       | |   |   | |
+ +-+-+-+ + +-+ +-+ + + +-+-+-+ + +-+-+ + +-+ + +-+ + +-+-+ + + + +-+ +-+ +-+-+-+ +
| |   |     |   |   | |   |   | |     | | |   | |   |       | | |   | |   |       |
+ + + +-+-+-+ +-+ +-+ +-+-+ + + +-+-+ + + +-+ + +-+-+-+-+-+-+ +-+-+ +-+ + + +-+-+-+
| | |   |   |   |   |       | |   | | | |   | |       |     |     | |   | |   |   |
+ + +-+ + + +-+ +-+ +-+-+-+-+ +-+ + + +-+-+ + +-+-+-+ + + +-+-+-+ + + +-+-+-+ +-+ +
|     |   |       |               |         |       |   |           |             |
+-+-+-+-+-+-+-+-+-+-+-+-+-+-+-+-+-+-+-+-+-+-+-+-+-+-+-+-+-+-+-+-+-+-+-+-+-+-+-+-+-+