+-+-+-+-+-+
|         |
+ + + + + +
| | | | | |
+-+ + + + +
|   | | | |
+ + + + +-+
| | | |   |
+ + + +-+ +
| | |   | |
+-+-+-+-+-+