+-+-+-+-+-+-+-+-+-+-+-+-+-+-+-+-+-+-+-+-+-+-+-+-+-+-+-+-+-+-+-+-+-+-+-+-+-+-+-+-+-+-+-+-+-+-+-+-+-+-+
|                                                                                                   |
+-+-+-+-+ + + + + + + + +-+ + + + +-+-+ + + +-+ +-+ + + + +-+ + +-+-+ +-+-+-+-+ +-+ + +-+ + + + + + +
|         | | | | | | | |   | | |     | | |   | |   | | |   | | |           |   |   |   | | | | | | |
+ +-+ + + + +-+-+ +-+ + + + + + + +-+-+ +-+ +-+-+ +-+ + + +-+-+ + + + + +-+ + + + +-+ + +-+ +-+-+ + +
| |   | | |     |   | | | | | | |     | |     |   |   | | |     | | | | |   | | | |   | |     |   | |
+ + +-+ +-+ + + + + + + + +-+ + + + + + +-+ + +-+-+ + +-+ +-+-+ + + + + + + + + + +-+ + + + + + + + +
| | |     | | | | | | | | |   | | | | |   | |     | | |       | | | | | | | | | |   | | | | | | | | |
+ + + + +-+ + + +-+ +-+-+ + +-+-+ + + +-+ +-+ + +-+-+-+-+ +-+ +-+-+ + + +-+ + +-+ +-+ + + +-+ + + +-+
| | | |   | | | |   |     |     | | | |     | |   |         |     | | |   | | |     | | | |   | |   |
+ + +-+ + + +-+ + + + + + + + + +-+ + +-+-+-+ + +-+ + + + +-+ +-+ + +-+ + + +-+ +-+-+-+ + + +-+ + + +
| |   | | |   | | | | | | | | |   | | |       | |   | | | |     | | |   | | |     |     | |   | | | |
+ + +-+ + + +-+ + + + + + + +-+ + + + +-+ + + +-+-+ + + + + +-+ + +-+ +-+-+ + + + + + +-+ +-+ + +-+ +
| | |   | | |   | | | | | |   | | | |   | | | |     | | | | |   | |   |     | | | | | |     | | |   |
+ +-+-+ + + + + +-+ + +-+-+-+-+-+-+ +-+ + + + + + + + + +-+ +-+ + +-+ + + + + + + +-+-+-+ + + + + + +
|     | | | | |   | |             | |   | | | | | | | | |     | |   | | | | | | |   |     | | | | | |
+ + +-+-+ + + + +-+ +-+ + + +-+ + +-+ + + + +-+-+ + +-+-+ + + + + +-+ + + + + + + +-+ +-+ +-+ +-+-+ +
| |     | | | |   |   | | |   | | |   | | |   |   |   |   | | | |   | | | | | | |   |   | |   |     |
+-+ + + + + + + +-+ +-+ +-+ +-+ + + +-+ + +-+ + + +-+ + + + + +-+-+ + +-+ +-+-+ + + +-+ + + + + + + +
|   | | | | | | |     |   | |   | |   | | |   | |   | | | | |     | | |     |   | |   | | | | | | | |
+ + + +-+ + + + + + +-+ + + + + +-+ + + +-+-+ +-+ + +-+ +-+ + +-+ + +-+ +-+-+ + +-+-+ + + + +-+ +-+-+
| | |   | | | | | | |   | | | | |   | | |     |   |   |   | |   | | |       | |   |   | | | |       |
+ + +-+ + +-+ + + + + +-+-+ +-+ +-+-+ + + + +-+ + + + + + + + +-+ +-+ +-+ +-+ + +-+ + + + + + + +-+ +
| | |   |   | | | | |   |   |     |   | | |   | | | | | | | | |     |   |   | |   | | | | | | | |   |
+ + +-+-+-+-+-+ + + + + +-+ +-+ +-+ +-+ +-+-+-+-+-+ +-+ +-+ +-+-+ + +-+-+-+ + + +-+ + + + + +-+ + + +
| |       |     | | | | |   |     |   |           | |   |     |   | |       | |   | | | | | |   | | |
+ + +-+ + + +-+-+ + + + +-+-+ + +-+ + + + + + + + + + + + + +-+ + + + + + + + +-+-+-+-+ +-+ + +-+ + +
| |   | | | |     | | | |     |   | | | | | | | | | | | | | |   | | | | | | |         | |   | |   | |
+ + + + + +-+-+ +-+ +-+-+ +-+ + + + + + + +-+-+ + +-+-+-+ + +-+ + + +-+ + +-+ +-+ +-+ + +-+ +-+-+-+ +
| | | | |     | |   |       | | | | | | |   |   |   |     | |   | | |   |   | |     | | |   |       |
+ + + + + + + + + + +-+ +-+ + +-+-+-+ +-+-+ + + + +-+-+ + + + + +-+ +-+ + + + +-+ + + + + +-+ + + + +
| | | | | | | | | |   | |   |       |   |   | | |     | | | | |   |   | | | |   | | | | | |   | | | |
+ +-+ + + +-+ +-+ +-+-+ +-+-+-+ + + + +-+-+ + + + + + + + + + + + + + + +-+-+ +-+ + + + + +-+ + + + +
| |   | |   | |     |     |     | | |     | | | | | | | | | | | | | | |     |   | | | | | |   | | | |
+ +-+-+ + + + + +-+ + + + + + + + + +-+ +-+ + + +-+ + +-+ + + + + + +-+ + + +-+-+ +-+-+-+-+ + + + + +
|   |   | | | | |   | | | | | | | |   |   | | |   | | |   | | | | |   | | |   |         |   | | | | |
+ + +-+-+ +-+ +-+ +-+ + + + +-+-+-+-+ + + + + + +-+-+ + +-+ + + + +-+-+ + +-+-+ +-+ + +-+ + + +-+-+ +
| |     |   | |   |   | | | |         | | | | | |     |   | | | |     | |     |   | |   | | |     | |
+ +-+ +-+-+ +-+ +-+ +-+-+ + +-+ +-+-+ + +-+ +-+ +-+ + + + + + + + + + +-+ + + + + + + + + + +-+-+ + +
|   | |       |   |     | | |     |   |   | |   |   | | | | | | | | | |   | | | | | | | | | |     | |
+ + + + + + + + + + +-+ + + +-+ + +-+ + +-+-+ +-+ +-+ + +-+-+ + + +-+-+ + +-+ + + + + + +-+-+-+-+-+ +
| | | | | | | | | |   | | |   | | |   |     | |     | |     | | | |     |   | | | | | |         |   |
+-+ +-+-+ +-+ + +-+-+ +-+ +-+ + + + +-+ +-+ + +-+ +-+ +-+ + + +-+ + + + + + + +-+-+ + +-+-+ + +-+ +-+
|   |       | | |     |   |   | | |   |   | | |   |   |   | |   | | | | | | |   |   |     | |   |   |
+ + +-+ + +-+-+-+ + + + + +-+ + + + + + + + + +-+-+ +-+-+ +-+-+ + + + +-+ + + + +-+ + + + +-+ + +-+-+
| | |   | |       | | | | |   | | | | | | | |     |     |   |   | | |   | | | |   | | | | |   |     |
+-+ + + +-+-+-+ + + + + + +-+ + +-+ +-+ + + + + + +-+ + + + +-+ +-+ +-+ + + + + + + + + + +-+-+-+-+ +
|   | |     |   | | | | |   | | |     | | | | | |   | | | |   | |   |   | | | | | | | | |     |     |
+ +-+ +-+ + + + +-+ + + + + +-+ + + + + +-+-+ +-+ +-+ + + +-+ + + + + +-+ + + + + + + +-+-+ + + + + +
|   |   | | | |   | | | | | |   | | | | |       |   | | | |   | | | | |   | | | | | | |     | | | | |
+ +-+-+ + + +-+ + +-+ +-+ +-+ + + + +-+ + + + +-+ +-+ + + + + + + + + +-+ + +-+-+-+-+ + + + +-+ +-+ +
| |     | | |   | |     |   | | | | |   | | |   | |   | | | | | | | |   | |     |     | | |   |   | |
+ +-+ + + + + + +-+-+ + +-+-+ + +-+ + +-+ +-+-+ + +-+-+-+ + + +-+ + + +-+-+-+ +-+ + + + +-+ + + + + +
| |   | | | | |   |   | |     |   | |   | |     | |       | | |   | |       | |   | | | |   | | | | |
+ + +-+-+-+ + +-+ + + + +-+ + + + +-+ + + +-+ +-+-+ + + + + +-+-+ +-+ + + + + + + +-+-+ + +-+ + +-+-+
| |       | | |   | | | |   | | | |   | | |       | | | | |   |   |   | | | | | | |     | |   |     |
+ + + + + + +-+ + + + + + + +-+ +-+-+-+ +-+ + + + + + + + + + +-+-+ +-+ + + +-+ +-+ +-+ + + + +-+ +-+
| | | | | | |   | | | | | | |       |   |   | | | | | | | | |     | |   | | |     | |   | | | |     |
+ + +-+ + + +-+ + +-+ + + + + + + + + + + + + + + +-+ + +-+ + + +-+ + +-+ + + + + + +-+ + + + +-+ +-+
| | |   | | |   |   | | | | | | | | | | | | | | |   | | |   | | |   | |   | | | | | |   | | | |     |
+ + + +-+ + + +-+ +-+ + +-+ + + + +-+ + + + + + + +-+ + +-+ +-+-+-+ + + + +-+-+ + +-+-+ + +-+ + + +-+
| | |   | | |   | |   |   | | | |   | | | | | | | |   | |     |     | | |     | |     | | |   | |   |
+ + +-+-+ + + +-+ +-+ +-+-+-+-+ +-+-+-+-+ + +-+ + + +-+-+ +-+ + +-+-+ + +-+-+ + + + + + +-+ + +-+-+ +
| | |     | |   | |           |     |     |   | | |     |   | |   |   |   |   | | | | |   | |     | |
+ + + +-+ +-+ +-+ + + +-+ +-+-+-+ + + +-+ + +-+-+ +-+ +-+ +-+-+-+ + + +-+ +-+ + + +-+ +-+-+ + + +-+ +
| | |   | |     | | | |   |       | | |   |     | |     |       | | |   |   | | |   |     | | |   | |
+ + + + + +-+ +-+ +-+ +-+ +-+ + + + + + + + + + +-+ + +-+-+-+-+ + + + +-+-+-+-+ + + +-+ + + + + +-+ +
| | | | |   |   | |     | |   | | | | | | | | |   | |         | | | |   |       | |   | | | | |   | |
+ +-+ +-+ + + + + + + +-+ + + + + + + +-+ + + + +-+ + + +-+ +-+ +-+ + +-+ + + +-+-+-+ + +-+ + + + + +
| |     | | | | | | | |   | | | | | | |   | | |   | | |   | |   |   |   | | | |       |   | | | | | |
+ + + +-+ + + + +-+ +-+ +-+ + + + + + +-+ +-+-+ + + + + + + +-+-+ +-+-+ + + + +-+-+ + +-+ +-+-+-+ + +
| | |   | | | |   | |   |   | | | | | |     |   | | | | | | |       |   | | | |     |   |       | | |
+ + +-+-+ + +-+ + + + + +-+ + + + +-+ + + + +-+ +-+ + + +-+-+-+ +-+-+-+ +-+ +-+-+ + + + + +-+ + +-+ +
| | |     | |   | | | |   | | | | |   | | |   |   | | | |         |     |     |   | | | | |   |   | |
+ + + + + + + + + + +-+-+ +-+-+-+-+-+ + + +-+ + +-+ +-+-+-+ + +-+ + + + + +-+ + + + + + + + + +-+ + +
| | | | | | | | | | |     |           | | |   | |   |       | |   | | | | |   | | | | | | | |   | | |
+ +-+ + + + + +-+-+-+ + +-+ + + + + +-+ +-+ + + + + +-+ +-+ + +-+ + +-+ + +-+ + + + +-+-+ + + +-+-+ +
|   | | | | | |       | |   | | | |   |   | | | | | |     | |   | | |   |   | | | |     | | |     | |
+ + + +-+-+-+ + + + + + +-+ + + +-+ + +-+ +-+-+ +-+-+ + +-+-+ + + + + +-+ + +-+ +-+ + + + + +-+ + + +
| | |     |   | | | | | |   | |   | | |     |   |     |     | | | | | |   |   | |   | | | |   | | | |
+ + + + +-+ + + + + + + + + +-+ + + + + +-+ + + +-+ + + + + + +-+ +-+ +-+ + + + + + + + + + + +-+ + +
| | | | |   | | | | | | | |   | | | | | |   | |   | | | | | |   |   | |   | | | | | | | | | | |   | |
+ + + +-+-+-+ + +-+-+ + + + +-+ + +-+ + + + + +-+ +-+ + +-+ + + + + + + + + + + + + + + +-+ + + + + +
| | |   |     |   |   | | | |   | |   | | | | |     | | |   | | | | | | | | | | | | | |   | | | | | |
+ + +-+ +-+ + +-+-+ + + + + +-+-+ + +-+-+ + + + +-+ + + + + + +-+-+-+-+ + + + + +-+-+ +-+ +-+ +-+-+ +
| | |     | |     | | | | | |     |   |   | | | |   | | | | |   |       | | | | |       |   |     | |
+ + + + + + +-+-+ + + + + + + + + + + + +-+-+-+ + + +-+-+ + + + +-+ + + +-+ + +-+ + +-+ +-+ + +-+ +-+
| | | | | |   |   | | | | | | | | | | |       | | |   |   | | | |   | |   | | |   | |     | | |     |
+-+-+-+ + + + +-+ +-+-+-+ +-+ + + + + + +-+-+ + + + + +-+-+ +-+ + + + +-+ + + + + + + + +-+-+ + + + +
|       | | | |       |   |   | | | | | |     | | | |   |     | | | | |   | | | | | | |     | | | | |
+ +-+ +-+ +-+-+-+ + + + + + + +-+ + +-+ +-+-+ + + + + +-+ +-+ +-+ + + + +-+ + + + +-+ +-+-+-+ + + + +
|   |   |     |   | | | | | | |   | |       | | | | |   | |   |   | | |   | | | | |       |   | | | |
+ + +-+ +-+ + + + +-+ +-+-+ + + + +-+ +-+ +-+-+ +-+ + + +-+ +-+ +-+ + + + + + + +-+ + + + +-+-+ +-+ +
| | |     | | | | |   |     | | | |   |   |       | | | |     |   | | | | | | |   | | | |     |   | |
+ +-+ + + + + + +-+ +-+ + + + +-+-+-+ + +-+ +-+-+ + +-+ + +-+-+ + + + + + + +-+-+-+ + + + + + +-+ + +
| |   | | | | | |     | | | |       | | |     |   |   | |   |   | | | | | |       | | | | | |   | | |
+ + + +-+ + + + + + + + + + +-+ +-+ + +-+ + + +-+ + + + + + + +-+ + +-+ + +-+ +-+ + + +-+ + + + + +-+
| | |   | | | | | | | | | |   | |   |   | | |   | | | | | | | |   |   | | |   |   | |   | | | | |   |
+-+ + + +-+ + + + + +-+ +-+-+-+-+ + +-+ + + +-+ + + + +-+ + + + + + + + + + + +-+ + +-+-+ + + + + +-+
|   | |   | | | | |   |     |     |   | | | |   | | |   | | | | | | | | | | | |   |     | | | | |   |
+-+-+-+-+-+-+-+-+-+-+-+-+-+-+-+-+-+-+-+-+-+-+-+-+-+-+-+-+-+-+-+-+-+-+-+-+-+-+-+-+-+-+-+-+-+-+-+-+-+-+