+-+-+-+-+-+-+-+-+-+-+-+-+-+
|                       |.|
+-+-+-+-+-+-+-+-+-+-+-+-+-+
|.|.|.|.|.|.|.|.|.|.|.|.|.|
+-+-+-+-+-+-+-+-+-+-+-+-+-+
|.|.|.|.|.|.|.|.|.|.|.|.|.|
+-+-+-+-+-+-+-+-+-+-+-+-+-+
|.|.|.|.|.|.|.|.|.|.|.|.|.|
+-+-+-+-+-+-+-+-+-+-+-+-+-+
|.|.|.|.|.|.|.|.|.|.|.|.|.|
+-+-+-+-+-+-+-+-+-+-+-+-+-+
|.|.|.|.|.|.|.|.|.|.|.|.|.|
+-+-+-+-+-+-+-+-+-+-+-+-+-+
|.|.|.|.|.|.|.|.|.|.|.|.|.|
+-+-+-+-+-+-+-+-+-+-+-+-+-+
|.|.|.|.|.|.|.|.|.|.|.|.|.|
+-+-+-+-+-+-+-+-+-+-+-+-+-+
|.|.|.|.|.|.|.|.|.|.|.|.|.|
+-+-+-+-+-+-+-+-+-+-+-+-+-+
|.|.|.|.|.|.|.|.|.|.|.|.|.|
+-+-+-+-+-+-+-+-+-+-+-+-+-+
|.|.|.|.|.|.|.|.|.|.|.|.|.|
+-+-+-+-+-+-+-+-+-+-+-+-+-+
|.|.|.|.|.|.|.|.|.|.|.|.|.|
+-+-+-+-+-+-+-+-+-+-+-+-+-+
|.|.|.|.|.|.|.|.|.|.|.|.|.|
+-+-+-+-+-+-+-+-+-+-+-+-+-+