+-+-+-+-+
|   |   |
+-+ + + +
| |   | |
+ +-+-+ +
|     | |
+ +-+ + +
|   |   |
+-+-+-+-+