+-+-+-+-+-+-+-+-+-+-+-+-+-+-+-+-+-+-+-+-+-+-+-+-+-+-+-+
|                                                     |
+-+ + + +-+ + + + +-+-+ + +-+-+-+-+ +-+ + + + + +-+-+-+
|   | | |   | | | |     |       |     | | | | |       |
+-+-+ +-+-+-+-+-+ +-+-+ +-+ + + + + + + + + + +-+ +-+ +
|         |         |   |   | | | | | | | | |   | |   |
+ + + +-+-+ + + + + + + + + +-+-+ + +-+ +-+-+-+-+ + +-+
| | |     | | | | | | | | |     | |   |       |   |   |
+ + + + + + + +-+ + + +-+-+ + + + +-+-+-+ + + + + + + +
| | | | | | | |   | | |     | | | |       | | | | | | |
+ + +-+ +-+ + + +-+-+ + + + + +-+-+-+-+ + + + + + +-+ +
| |   | |   | | |     | | | |     |     | | | | |   | |
+ + + +-+-+ + + + + + + + +-+-+-+ +-+ + + + +-+ + + + +
| | | |     | | | | | | | |         | | | |   | | | | |
+ + + +-+ + + + + + + +-+-+-+ +-+ + + +-+ + + + + +-+ +
| | | |   | | | | | |   |       | | |   | | | | | |   |
+ +-+-+ + + + + +-+-+ +-+ +-+ + +-+ +-+ + + + + +-+ + +
|     | | | | | |     |     | |   | |   | | | | |   | |
+ +-+ + +-+ +-+ + +-+ +-+ + +-+-+ +-+-+-+ + + + + +-+ +
|   | | |     | |   |   | | |         |   | | | |   | |
+ + +-+ + + +-+ + + + + + + + + + + +-+ + + +-+ + + + +
| |   | | |   | | | | | | | | | | | |   | | |   | | | |
+ +-+ + +-+ + + +-+-+ + + + + +-+ +-+-+-+-+ +-+ + + + +
|   | |   | | |     | | | | | |   |         |   | | | |
+ +-+-+ + + +-+ + +-+-+ + +-+ +-+ + + + + +-+ +-+-+ +-+
|   |   | | |   |     | | |     | | | | | |     |     |
+ + +-+ +-+ + + +-+-+ +-+-+ + + + +-+-+ + + +-+-+-+ + +
| |   | |   | | |     |     | | | |     | | |       | |
+ + + + + + + + +-+ +-+-+ + + + +-+-+-+ + + +-+-+ +-+-+
| | | | | | | |   | |     | | |   |     | |     |     |
+ + + + + + + +-+ +-+ + + + + + + + + + + + +-+-+-+ + +
| | | | | | |   | |   | | | | | | | | | | |       | | |
+ +-+ + +-+ +-+ + + + + + +-+ + +-+ +-+-+ + + + + +-+ +
|   | | |   |   | | | | |   | | |   |     | | | |   | |
+-+ + + + + +-+-+ +-+ + +-+ + + +-+ +-+ +-+ + + + + + +
|   | | | |     | |   |   | | |   |   | |   | | | | | |
+-+ +-+-+-+ + + + + + +-+-+ + +-+ +-+-+ + +-+ +-+ + + +
|         | | | | | |   |   |   |   |   |   |   | | | |
+-+ + + + + +-+ +-+-+ + +-+ + + +-+ + +-+ +-+ +-+-+ + +
|   | | | |   |     | | |   | | |   | |     | |     | |
+ +-+ + + + +-+ + + + +-+ + + + +-+ + + + +-+ + + +-+ +
| |   | | |   | | | |   | | | | |   | | |   | | | |   |
+ +-+ +-+ + + +-+ + + +-+ + + + + + + + +-+-+ +-+ + + +
| |     | | |   | | |   | | | | | | | | |       | | | |
+ +-+-+ + +-+ +-+ +-+-+ +-+ + +-+-+ +-+ + +-+ + + + + +
|     | | |     |     |   | | |     |   |   | | | | | |
+ + +-+ + + + + +-+-+ +-+-+ +-+ + + +-+ +-+ +-+-+ + +-+
| |   | | | | | |       |     | | |   | |       | |   |
+ +-+ +-+ +-+ + + +-+-+ + + + +-+ + +-+ + + + + + + + +
| |     |   | | |     | | | | |   |   | | | | | | | | |
+ +-+ + + + +-+-+ +-+-+-+ + +-+ + + + +-+ + + + + + + +
|   | | | | |           | | |   | | |   | | | | | | | |
+ + + +-+ + +-+-+ + +-+-+ + + + + + + +-+ +-+ + +-+ +-+
| | |   | |     | | |     | | | | | |   |   | |   |   |
+-+-+-+-+-+-+-+-+-+-+-+-+-+-+-+-+-+-+-+-+-+-+-+-+-+-+-+