+-+-+-+-+-+-+-+-+-+-+-+-+-+-+-+-+-+-+-+-+-+-+-+-+-+-+-+-+-+-+-+-+-+-+-+-+
|     |         |   |             |                       |   |         |
+-+-+ + +-+-+ + + + + +-+-+ +-+-+-+ +-+-+-+-+-+-+-+-+-+ + +-+ + +-+-+-+ +
|   | | | |   |   | |     |                   |       | |   |         | |
+ +-+ + + + +-+-+-+ +-+-+-+-+-+ +-+-+ +-+-+-+ +-+ + + + +-+ + +-+-+-+-+ +
| |   |   | |   |   |         | |   | |     |   | | | |   | | | |       |
+ + +-+-+ + + + +-+ + +-+-+-+ +-+ + +-+ +-+ +-+ +-+ +-+-+ + + + + +-+-+ +
| |     | |   |   |   |   |   |   |     | | |       |     | |   | |   | |
+ +-+-+ +-+-+-+-+ +-+-+ +-+ +-+ +-+-+-+-+ + +-+-+-+-+ +-+-+ +-+-+ + + + +
|   |   |         |             |     |           |   |   |       | | | |
+-+ + +-+ +-+-+-+-+ +-+-+-+-+-+-+ +-+ + +-+-+-+-+ + +-+ + +-+-+-+-+ +-+ +
|   | |   |               |   |     | | |   |     | |   |     | |       |
+ + + + + +-+-+-+-+-+-+-+ + + +-+-+ +-+ + + + +-+-+ + +-+-+-+ + + +-+-+-+
| | | | |   |         |   | |     |     | | |   |   | |   |   | | |   | |
+ +-+ + +-+ + +-+-+-+ +-+-+ +-+-+ +-+-+-+ + +-+ + +-+ + + + +-+ + + + + +
|     | | |       | |       |     |       | | |   |   | | |   | |   |   |
+ +-+-+ + +-+-+-+ + +-+-+-+-+ + +-+ +-+-+-+ + +-+-+ +-+ + +-+ + +-+-+-+ +
|     |     |   |     |       | |     |     |     |   | |   | |   | |   |
+-+-+ +-+-+-+ + +-+-+ + +-+-+-+-+ +-+-+ + +-+-+-+ + + +-+ +-+ + + + + +-+
|   |         |   |   |           |   | | |     |   |   |   | | | | | | |
+-+ +-+-+-+-+-+-+ + +-+-+-+-+-+-+-+ + + + + +-+ +-+ +-+ +-+ + + + + + + +
|   |   |     |   | |         |     |   | |   |   |   |   |     |   | | |
+ +-+ + + + + + +-+ +-+-+ +-+-+ +-+ +-+-+ +-+ +-+ +-+ +-+ +-+-+ +-+-+ + +
|     | | | | | | |   |   |   | |   |   | |     | | |   |     | |     | |
+-+-+-+ + + + + + +-+ + +-+ + + + +-+ + +-+ +-+-+ + +-+ +-+-+ +-+ +-+-+ +
|       | | | | |     |   | |   | |   |     |   | |         |     |     |
+ +-+-+ + + +-+ +-+-+ +-+ + +-+-+ + +-+-+-+-+ + + +-+-+-+-+ +-+-+-+-+ + +
|     | | |   |     | |   |   | | | |       | |   |   |   | |       | | |
+ +-+ +-+ +-+ +-+-+ + + +-+-+ + + + +-+-+-+ + +-+-+ + + +-+ + +-+-+ +-+ +
| | |     | | |     |   |     |   |         | |     | | |     |   | |   |
+ + +-+-+-+ + + +-+-+-+ + +-+-+-+-+-+-+-+-+ + + +-+-+ + + +-+-+ + + + + +
| |       | |   |       |                 | |   |     |   |   | | |   | |
+ + +-+-+ + +-+-+-+ +-+-+-+-+-+-+-+-+-+ + + +-+-+ +-+-+ +-+ + + + +-+-+ +
|   |   | |       | |   |           |   | |     | |   |   | | | | |     |
+-+-+ + + +-+ +-+ + + + +-+-+ + +-+-+ + +-+-+-+ + + + +-+-+ + + + +-+ +-+
|     |   |   |   |   |       | |     | |   |   | | |       |   |   |   |
+ +-+-+-+-+ +-+ +-+-+-+ +-+-+-+-+ +-+-+-+ + + +-+ + +-+-+-+-+-+-+-+ +-+-+
|     |   | |         | |   |   |     |   | |   | | |   |     |   |     |
+-+-+ + + + + +-+-+-+ +-+ + + + +-+-+ + +-+ +-+ + + + +-+ + + + + +-+-+ +
|   |   | | |   |   | |   |   |   |   | | |   | |   |     | |   | |     |
+-+ +-+-+ + +-+-+ + + + +-+-+-+-+ + +-+ + +-+ + +-+-+ +-+-+ + +-+-+ +-+ +
|       | |       | | |     |     |   | |   |   |     | |   | |     | | |
+ +-+-+-+ +-+ +-+-+ + +-+-+ +-+ +-+ + + +-+ +-+-+ +-+-+ + +-+ + +-+-+ + +
|       |   |     | |     |   |   | | |     |   | |     | |   |     | | |
+ +-+-+ +-+ +-+-+-+ +-+-+ + + +-+ +-+ +-+-+ + +-+ +-+ + + +-+-+-+-+ + + +
| |   |     |   |   | |   | | |         |   |   |     | | |         |   |
+ + + +-+-+-+ + + +-+ + +-+-+ +-+-+ +-+-+ +-+ + +-+ +-+-+ + +-+-+-+-+-+-+
| | |         | |   |     |   |   | |     |   |     |     | |       |   |
+ +-+-+ + +-+-+ + + +-+-+ + + + + +-+ +-+-+ +-+-+-+-+ +-+-+ + +-+-+ + + +
|     | |     | | | |   |   | | |     | |   |   |     |     | |   |   | |
+-+-+ +-+-+-+ + +-+ + + +-+-+ + +-+-+-+ + +-+ +-+ + +-+ +-+ + + +-+-+-+ +
| |   |     | |   |   |   |   | |         |   |   | |   |   | | |     | |
+ + +-+ +-+ + +-+ +-+ +-+ +-+-+ + +-+-+-+-+-+ + + +-+ +-+-+-+ + + +-+ + +
| |     | | | | |   |   | |     |           | | | |   |   |     |   |   |
+ +-+-+-+ + + + +-+ +-+ + + +-+-+-+-+-+-+-+ + + +-+ +-+ + + +-+-+-+ +-+ +
|         |   | |   |   |             |       | |   |   |   | |     |   |
+-+-+-+ + +-+-+ + +-+-+-+ +-+-+-+-+-+ +-+-+-+-+ + +-+ +-+-+-+ + +-+-+ +-+
|       | |     |       |   |       |           |   |   |     |   | |   |
+ +-+-+-+ + +-+ +-+-+-+ +-+-+ +-+-+ +-+-+-+-+-+ +-+ +-+ +-+ +-+-+ + +-+ +
|   |   | | |   |     |       |     |             |       |     | |   | |
+ + +-+ + + + + + + +-+-+-+-+-+ +-+-+-+-+-+ +-+-+-+ +-+-+ + + +-+ +-+ + +
| |   |   | | | | | |         | |         | |     | |   | | |   |   | | |
+ +-+ +-+ + + +-+ + + +-+-+-+ + +-+ +-+-+ +-+ +-+ +-+ + + +-+ + +-+ + + +
| | |   | | |     | | |     | |   |   | |   |   |     | |   | |   | |   |
+ + +-+ + + +-+-+-+ + + +-+ + +-+ +-+ + +-+ +-+ +-+-+-+ +-+ +-+-+ + +-+ +
|     | | | |     |   | |   |   |     |   | |   |     |   |   |   |   | |
+-+-+ + +-+ + + + +-+-+-+ + +-+ +-+-+-+ +-+ + +-+-+-+ +-+ +-+ + + +-+ + +
| |   | |   | | |     |   |   |     |       |       |     |     |   | | |
+ + +-+ + +-+ + +-+-+ + +-+-+ +-+-+ + +-+-+-+-+-+-+ + +-+-+-+-+-+-+-+ + +
| | | | | |   |     |   |   |     | | |   |         | |               | |
+ + + + + +-+-+-+-+ +-+-+ + +-+-+ + + + + +-+ +-+-+-+ +-+ +-+-+-+-+-+-+ +
|     |             |     |       |     |     |           |             |
+-+-+-+-+-+-+-+-+-+-+-+-+-+-+-+-+-+-+-+-+-+-+-+-+-+-+-+-+-+-+-+-+-+-+-+-+