+-+-+-+-+-+-+-+
|             |
+ + +-+ + + +-+
| |   | | |   |
+ + +-+-+-+ +-+
| |       |   |
+ + +-+ + + +-+
| |   | | |   |
+ + +-+ +-+-+ +
| |   |     | |
+ + + +-+ + +-+
| | |   | |   |
+ + +-+-+-+ +-+
| |       |   |
+-+-+-+-+-+-+-+