+-+-+-+-+-+
|     |   |
+-+ + +-+ +
| | | |   |
+ +-+ + + +
|   | | | |
+-+ + +-+ +
| |       |
+ + +-+ + +
|     | | |
+-+-+-+-+-+