+-+-+-+-+-+-+-+-+
|               |
+-+ +-+ + + +-+ +
|     | | | |   |
+ +-+-+ +-+ + + +
|   |     | | | |
+-+ + + +-+ +-+ +
|   | |   |   | |
+ + + +-+ +-+-+ +
| | |   |     | |
+ + + + +-+ + + +
| | | | |   | | |
+ + +-+ +-+ + + +
| |   |   | | | |
+ + + +-+-+ +-+ +
| | | |       | |
+-+-+-+-+-+-+-+-+