+-+-+-+-+-+-+-+
|             |
+ +-+ + +-+ + +
|   | |   | | |
+ + + + +-+ + +
| | | |   | | |
+ + +-+ +-+ + +
| |   |   | | |
+ +-+-+-+-+-+ +
|           | |
+ + + + +-+-+-+
| | | |       |
+ +-+-+ + +-+ +
|     | |   | |
+-+-+-+-+-+-+-+