+-+-+-+-+-+-+-+-+-+-+-+-+-+-+-+-+-+-+-+-+-+-+-+-+-+-+-+-+-+-+-+-+-+-+-+-+-+-+-+-+-+-+-+-+-+-+-+-+-+-+
|                                                                                                   |
+ + + + + +-+-+ + + +-+-+ + +-+ +-+ + +-+ +-+ +-+ + +-+ + + +-+ +-+ +-+-+ + + +-+-+ + + +-+-+ + +-+ +
| | | | |     | | |     | |   |   | |   |   |   | |   | | |   |   |     | | |     | | |     | |   | |
+ + + +-+-+ +-+ +-+-+-+ + + +-+-+ +-+ + + +-+-+ +-+ + +-+-+-+-+ + + +-+-+-+-+ +-+-+-+ + +-+-+ +-+-+ +
| | |     |   |       | | |     |   | | |     |   | |         | | |         |       | |     |     | |
+ + + + +-+ +-+-+ +-+ +-+ +-+-+-+-+-+ + + + + +-+ +-+-+ +-+ +-+ + + + +-+-+-+-+ + +-+-+-+-+-+ +-+-+ +
| | | |   |     |   |   |           | | | | |   |     |   |   | | | |         | |           |     | |
+ + +-+ + +-+-+-+-+-+-+ + + + + + +-+-+-+-+ + +-+-+ +-+-+ +-+ + + +-+ +-+ + +-+-+ + +-+-+ +-+ + +-+-+
| |   | |             | | | | | |         | |     |     |   | | |   |   | |     | |     |   | |     |
+ + + + +-+-+ + +-+ +-+-+-+ + + +-+ +-+ + +-+-+ +-+ +-+ +-+-+-+ +-+ + + +-+-+ + + + + + +-+ +-+ + +-+
| | | |     | |   |       | | |   |   | |     |   |   |       |   | | |     | | | | | |   |   | |   |
+ +-+-+ +-+ +-+ +-+ + +-+ + + +-+ +-+-+-+ +-+-+-+ +-+-+-+ +-+-+-+ + + + +-+ + + + +-+ + +-+ + + + +-+
|     |   |   |   | |   | | |   |       |       |       |       | | | |   | | | |   | |   | | | |   |
+ + +-+ + +-+-+ + +-+-+-+ +-+-+ +-+-+ + +-+-+-+-+ +-+ + + + +-+-+-+-+ + +-+ +-+ + + + + +-+-+-+-+-+-+
| |   | |     | |       |     |     | |         |   | | | |         | |   |   | | | | |             |
+ + + +-+-+ +-+ + +-+-+ + +-+ + +-+-+-+ +-+ +-+-+-+ + + + +-+ +-+ +-+-+ + +-+-+ + + + +-+ +-+ + + +-+
| | |     |   | |     | |   | |       |   |       | | | |   |   |     | |     | | | |   |   | | |   |
+ + + + + + +-+-+ + + +-+-+-+ + +-+ + + + +-+ + + +-+ +-+ +-+-+-+-+ + +-+ +-+-+-+-+ +-+-+ +-+ +-+ + +
| | | | | |     | | |       | |   | | | |   | | |   |   |         | |   |         |     |   |   | | |
+ + +-+-+ + +-+-+ +-+ +-+ +-+-+-+ + + + + + +-+-+ +-+ +-+-+ + +-+ +-+-+ +-+ +-+ + +-+ +-+-+-+-+ +-+-+
| |     | |     |   |   |       | | | | | |     |   |     | |   |     |   |   | |   |         |     |
+ +-+-+-+ +-+-+-+ + +-+ + + +-+-+-+ + + +-+-+ +-+-+-+-+-+ +-+-+-+-+-+-+-+ + + + +-+ +-+ + + +-+ + +-+
|       |       | |   | | |       | | |     |           |               | | | |   |   | | |   | |   |
+ + + +-+-+-+-+ + +-+ + +-+ + + +-+-+-+-+-+ + + +-+-+ + +-+-+-+-+-+ + +-+ + +-+ + +-+ + +-+-+ +-+ + +
| | |         | |   | |   | | |           | | |     | |           | |   | |   | |   | |     |   | | |
+ + + +-+-+-+ +-+ + +-+-+ +-+-+-+-+ +-+-+-+-+-+-+-+ + + + +-+-+ + +-+-+-+-+-+ + + +-+-+ +-+-+-+ +-+-+
| | |       |   | |     |         |               | | | |     | |           | | |     |       |     |
+ +-+ +-+-+ + +-+-+-+ +-+-+-+ + +-+ + + + +-+-+-+-+ + +-+-+ +-+ + +-+-+-+-+-+ +-+ +-+-+ + + + +-+-+-+
|   |     | |       |       | |   | | | |         | |     |   | |           |   |     | | | |       |
+ +-+ +-+-+-+-+ +-+-+ +-+-+ + +-+ +-+-+ + + + +-+ + +-+ +-+ +-+ +-+ + + +-+-+-+ +-+ + + +-+-+-+ +-+-+
|   |         |     |     | |   |     | | | |   | |   |   |   |   | | |       |   | | |       |     |
+ +-+ +-+ +-+ +-+ + +-+ + + + + +-+-+-+-+ + +-+-+ +-+-+ +-+ +-+-+-+ + +-+ + +-+-+-+ +-+-+-+-+-+-+-+-+
|   |   |   |   | |   | | | | |         | |     |     |   |       | |   | |       |                 |
+ + +-+ +-+ +-+ + + + +-+ +-+-+ + +-+-+-+ +-+-+ +-+ +-+ +-+-+ + +-+-+-+ +-+-+ +-+ +-+ +-+ +-+-+ +-+ +
| |   |   |   | | | |   |     | |       |     |   |   |     | |       |     |   |   |   |     |   | |
+ + + +-+ + +-+ + +-+-+ + + + +-+ + + + + +-+-+-+ + + + + + + + + + +-+-+-+ + + + +-+-+-+ + + + + +-+
| | |   | |   | |     | | | |   | | | | |       | | | | | | | | | |       | | | |       | | | | |   |
+ + + + + +-+ +-+ + + + + + + + + +-+ + + +-+-+-+ +-+ + +-+-+ +-+ +-+-+-+-+-+-+-+-+ + +-+ +-+-+ + +-+
| | | | |   |   | | | | | | | | |   | | |       |   | |     |   |                 | |   |     | |   |
+ + + +-+ + + + + + +-+-+ +-+ +-+-+ +-+-+-+-+ +-+-+-+-+-+ + +-+ +-+ +-+-+-+-+ +-+ +-+-+ + +-+ + +-+ +
| | |   | | | | | |     |   |     |         |           | |   |   |         |   |     | |   | |   | |
+ +-+-+-+-+-+-+ +-+ + +-+-+ + + + +-+ + +-+ +-+-+ + +-+ + +-+-+-+-+-+ +-+-+ + +-+-+-+-+-+ +-+ + +-+-+
|             |   | |     | | | |   | |   |     | |   | |           |     | |           |   | |     |
+ + +-+ + +-+ + +-+-+-+ + +-+-+-+ + +-+-+-+-+-+-+ +-+ + + + +-+-+ + +-+-+-+-+ + +-+-+ + + +-+ +-+ + +
| |   | |   | |       | |       | |             |   | | | |     | |         | |     | | |   |   | | |
+ + + +-+ +-+ +-+-+ +-+ +-+-+ +-+ +-+ + +-+ + + + + +-+ + + + +-+ +-+ +-+-+ + + + +-+-+ + + +-+-+-+-+
| | |   |   |     |   |     |   |   | |   | | | | |   | | | |   |   |     | | | |     | | |         |
+ +-+-+-+ + + +-+ +-+-+-+ +-+-+ + + +-+-+ + +-+-+-+-+-+ + +-+-+-+-+ + +-+ + + +-+ + +-+ +-+-+ +-+-+-+
|       | | |   |       |     | | |     | |           | |         | |   | | |   | |   |     |       |
+ + +-+ +-+ +-+ +-+ +-+-+-+-+ +-+ +-+ + + +-+ +-+ +-+ +-+-+-+ +-+ +-+ +-+ + + + + + +-+-+-+ +-+ + +-+
| |   |   |   |   |         |   |   | | |   |   |   |       |   |   |   | | | | | |       |   | |   |
+ + +-+-+ +-+ + +-+-+-+-+-+-+-+ + +-+-+-+-+ + + + + +-+-+-+ + +-+ +-+ + +-+ + + + + +-+-+ + +-+-+ +-+
| |     |   | |               | |         | | | | |       | |   |   | |   | | | | |     | |     |   |
+ + +-+-+-+-+ + + +-+-+ + +-+ +-+ +-+-+-+ + + + +-+ + +-+ +-+ + +-+ +-+ +-+ +-+-+ +-+ +-+ +-+-+-+ + +
| |         | | |     | |   |   |       | | | |   | |   |   | |   |   |   |     |   |   |       | | |
+ + + +-+-+-+ +-+-+-+ + + + +-+-+-+-+-+-+-+-+ + +-+-+ +-+-+ + +-+ +-+-+ +-+ + +-+-+ +-+-+ +-+-+-+-+-+
| | |       |       | | | |                 | |     |     | |   |     |   | |     |     |           |
+ + +-+-+-+ + +-+-+ + + +-+-+ +-+-+ + + +-+-+-+-+ + + + +-+-+-+ +-+-+-+ + + +-+ + + +-+-+ +-+-+ +-+-+
| |       | |     | | |     |     | | |         | | | |       |       | | |   | | |     |     |     |
+ + +-+-+-+-+-+ + + + +-+-+ + + + + + +-+ +-+-+ +-+ + +-+ + + + + + +-+-+ +-+-+ +-+ + +-+ +-+-+ + +-+
| |           | | | |     | | | | | |   |     |   | |   | | | | | |     |     |   | |   |     | |   |
+ + + +-+ +-+-+ + + +-+ +-+-+-+ + + +-+ + + +-+-+-+-+ + + + + + +-+ + +-+ +-+-+ +-+ +-+-+ + +-+ +-+-+
| | |   |     | | |   |       | | |   | | |         | | | | | |   | |   |     |   |     | |   |     |
+ +-+ +-+ + +-+-+ +-+-+ +-+ +-+-+ +-+-+-+-+ + +-+-+ + + + + +-+-+ + +-+-+-+ + + +-+-+-+ + +-+-+ +-+ +
|   |   | |     |     |   |     |         | |     | | | | |     | |       | | |       | |     |   | |
+ +-+ +-+ + +-+-+ + + + +-+-+-+-+ + + +-+-+ + + +-+-+-+-+ + +-+ +-+ + + + + + +-+ + +-+-+ +-+ +-+ +-+
|   |   | |     | | | |         | | |     | | |         | |   |   | | | | | |   | |     |   |   |   |
+ + + +-+-+ +-+ +-+ + +-+-+-+ +-+-+ + + + +-+-+-+ + + + +-+ + + + + + + + +-+ + + + +-+-+ + + +-+-+ +
| | |     |   |   | |       |     | | | |       | | | |   | | | | | | | |   | | | |     | | |     | |
+ + +-+-+ + + +-+ + +-+-+ +-+ +-+ +-+ + + +-+-+ + +-+ + +-+ +-+ + +-+ + + +-+-+-+-+ +-+-+-+-+-+-+-+ +
| |     | | |   | |     |   |   |   | | |     | |   | |   |   | |   | | |         |               | |
+ + + + + + +-+-+ + +-+ +-+-+ + + + +-+-+-+-+-+-+-+ + + +-+-+ +-+-+ +-+-+-+ +-+-+-+-+-+-+ + + +-+-+-+
| | | | | |     | |   |     | | | |               | | |     |     |       |             | | |       |
+ + +-+-+-+ +-+ +-+ + + +-+-+ +-+-+ +-+ + +-+-+ + +-+ +-+ +-+-+ +-+-+ +-+-+-+ +-+ + +-+ + + + +-+-+ +
| |       |   |   | | |     |     |   | |     | |   |   |     |     |       |   | |   | | | |     | |
+ +-+-+ + +-+ + +-+-+ +-+-+-+ +-+ +-+-+ +-+ +-+-+-+-+-+-+-+ + + +-+ +-+-+ +-+ +-+ +-+-+ +-+-+-+-+-+-+
|     | |   | |     |       |   |     |   |               | | |   |     |   |   |     |             |
+ + + + + + +-+-+-+ + + +-+-+ + + +-+ + + +-+-+ + +-+ + + +-+-+-+-+ +-+-+ +-+-+ + +-+-+-+ + + + + + +
| | | | | |       | | |     | | |   | | |     | |   | | |         |     |     | |       | | | | | | |
+ + +-+-+ + + + +-+-+-+-+ +-+-+-+ + + + + +-+ + +-+ + +-+ +-+ + + +-+-+ +-+ +-+ +-+ + +-+-+ +-+ +-+ +
| |     | | | |         |       | | | | |   | |   | |   |   | | |     |   |   |   | |     |   |   | |
+ +-+ + + + +-+ + + + + + + +-+ +-+-+ + + +-+-+-+ + + +-+ +-+ +-+ +-+ + + + +-+-+-+-+ + +-+ + + + + +
|   | | | |   | | | | | | |   |     | | |       | | |   |   |   |   | | | |         | |   | | | | | |
+ +-+ + +-+-+ + + + +-+-+ + + + +-+-+ + +-+ +-+ + + + + + + +-+-+-+-+-+-+-+-+-+-+-+ +-+ +-+-+-+-+-+ +
|   | |     | | | |     | | | |     | |   |   | | | | | | |                       |   |           | |
+ + + +-+-+-+ +-+-+-+-+ +-+ +-+ + + +-+ +-+-+-+-+-+-+-+ +-+-+ +-+ +-+ + + + +-+ + +-+ +-+-+-+ + + + +
| | |       |         |   |   | | |   |               |     |   |   | | | |   | |   |       | | | | |
+ + +-+ +-+ + +-+-+ + +-+ +-+-+-+ + + + + + +-+-+-+-+-+ +-+ + + +-+-+ + + + + +-+ + + +-+ +-+ + + +-+
| |   |   | |     | |   |       | | | | | |           |   | | |     | | | | |   | | |   |   | | |   |
+ +-+-+-+-+-+-+-+-+-+ + + +-+ + + + + +-+ +-+ +-+ +-+ + + +-+-+ + + +-+ +-+ +-+ +-+-+ + + + +-+ +-+ +
|                   | | |   | | | | |   |   |   |   | | |     | | |   |   |   |     | | | |   |   | |
+ +-+ +-+-+-+-+-+-+-+-+ + + +-+ +-+ +-+-+-+-+-+-+ +-+-+ + +-+-+ +-+ +-+-+-+ + +-+ +-+-+ + + +-+ + +-+
|   |                 | | |   |   |             |     | |     |   |       | |   |     | | |   | |   |
+ +-+ + + + +-+-+ + + +-+ +-+-+ + +-+-+-+ + +-+ +-+-+-+-+ + + +-+-+ +-+-+ +-+-+-+ +-+ +-+-+ +-+-+ + +
|   | | | |     | | |   |     | |       | |   |         | | |     |     |       |   |     |     | | |
+ +-+-+ + +-+ + + + +-+ +-+ +-+-+ + + + + + + + + +-+ + +-+ + + + +-+ +-+ + +-+ + + +-+ +-+-+ +-+-+ +
|     | |   | | | |   |   |     | | | | | | | | |   | |   | | | |   |   | |   | | |   |     |     | |
+ + + + + +-+ +-+-+-+ + +-+-+ +-+-+-+-+-+-+-+ + + + +-+-+-+-+ + + +-+ + +-+ +-+ +-+-+ + +-+ + + +-+ +
| | | | |   |       | |     |               | | | |         | | |   | |   |   |     | |   | | |   | |
+-+-+-+-+-+-+-+-+-+-+-+-+-+-+-+-+-+-+-+-+-+-+-+-+-+-+-+-+-+-+-+-+-+-+-+-+-+-+-+-+-+-+-+-+-+-+-+-+-+-+