+-+-+-+-+-+
|         |
+ + +-+-+-+
| |       |
+ +-+-+-+ +
|       | |
+ +-+-+ + +
|     | | |
+ + +-+ +-+
| |   |   |
+-+-+-+-+-+