+-+-+-+-+-+-+-+
|             |
+ +-+ + + + +-+
|   | | | |   |
+ +-+-+ +-+-+-+
|     |       |
+ + + + +-+ +-+
| | | |   |   |
+ + + + + +-+ +
| | | | |   | |
+ +-+-+-+-+-+-+
| | | | | | | |
+-+-+-+-+-+-+-+
| | | | | | | |
+-+-+-+-+-+-+-+