+-+-+-+-+-+-+-+-+-+-+-+-+-+-+-+-+-+-+-+-+-+-+-+-+-+-+-+-+-+-+-+-+-+-+-+-+-+-+-+-+-+-+-+-+-+-+-+-+-+-+
| |       | |       |   |           |     | | | |         |   |   |   |         |       |   |     | |
+ + +-+-+ + + +-+-+-+ +-+-+-+-+ + +-+-+ +-+ + + +-+ + + +-+-+ +-+ + +-+-+ +-+-+ + +-+-+ + + +-+ +-+ +
|   | |     | |   |     |     | |   |       | |     | |       |     |   | |       |   |   |   |   | |
+-+ + + + +-+ +-+ +-+-+ +-+ +-+ +-+-+ +-+ +-+ +-+ +-+-+-+-+ +-+-+-+ +-+ +-+ + +-+-+-+ + +-+ +-+ + + +
| | |   | | | | |         | | | |     |   |           |   |   |   |   | |   | | |     |   |   | | | |
+ +-+ +-+-+ + + + +-+ +-+-+ + + + + +-+-+ + +-+ +-+ +-+ +-+-+-+-+ +-+ + +-+-+ + +-+-+ +-+ +-+ + +-+ +
| |     |     | |   |   |       | |   |     |   |     |     | | | | |     | |         | |   |       |
+ + +-+-+ +-+ + + +-+ +-+-+-+-+ +-+ +-+-+ + +-+-+-+ +-+-+ +-+ + + + +-+-+ + +-+ +-+ +-+ +-+-+-+ +-+ +
|           | |     |     | |       |     | |   |     | |   |     |       |   |   |     |       |   |
+ + +-+-+ +-+ +-+-+ +-+-+ + +-+-+ + +-+ +-+-+ +-+-+ +-+ +-+ + +-+ + + +-+ +-+ + +-+-+-+ +-+ + +-+-+ +
| | |   | |   |     |     |   |   | |     |     | |     |   | |   | |   |   |   |     | |   | |   | |
+-+ +-+ + +-+ +-+ +-+-+-+-+-+ + +-+ +-+ +-+-+ + + + + + +-+ + +-+ + +-+ +-+-+ +-+-+ +-+ +-+ +-+ + + +
|   | | | | | |   |   |           |   |       | | | | |     | | | | |     |           | | | |   | | |
+ + + + + + + + + + + + +-+-+-+ + +-+-+ + + +-+-+ +-+-+ +-+ + + + + +-+-+ +-+ +-+-+-+-+ + +-+-+ +-+-+
| | |       | | |   |   |       |   | | | | |     | | |   | | |     | |   |     |       |     | |   |
+-+-+ +-+-+-+-+-+ + + + +-+ + + + + + + +-+-+-+-+ + + +-+-+ +-+ +-+ + +-+-+-+-+-+ +-+ + + +-+-+ + + +
| |   |         | | | | |   | | | | |           | | |     | |   |     | |     |   |   | | |     | | |
+ + +-+ + +-+ +-+-+-+ +-+-+ +-+-+-+-+ +-+-+-+ +-+ + + +-+ +-+-+-+-+ +-+ +-+ +-+-+-+-+-+ + + +-+ + +-+
|     | | |     | |   | | |       | | | | |   |   |     |   | |       |         |         |   | |   |
+-+ + +-+-+-+ +-+ +-+-+ + +-+ + +-+ + + + + +-+ +-+-+ + +-+ + +-+ +-+ +-+ + +-+-+-+ + +-+-+-+ +-+ +-+
|   |           |   | | |   | |   | |     | |     | | |   |   | | |       |       | | |     |     | |
+ +-+ +-+-+ +-+ + + + + + +-+-+-+ + +-+ +-+-+-+ + + +-+-+-+ + + + + + +-+ +-+-+ + +-+ +-+ + + +-+-+ +
| |     |     | | |   |     |       |           | |   | |   |     | |   | |     |     | | |   | |   |
+ +-+ + +-+-+-+ + +-+ +-+-+ +-+ + + +-+-+-+ +-+ + + + + +-+ +-+-+ +-+ +-+-+-+-+ +-+ + + + + + + + +-+
| |   |       | | |   |         | | | |     |   | | |   | | | |   |     |   |   |   |   | | |     | |
+-+ + +-+ + +-+-+-+-+ + + +-+-+ + +-+ +-+-+-+-+ +-+ + + + +-+ +-+-+ +-+ +-+ +-+ +-+ +-+ + + + +-+-+ +
|   | |   |       |     |   |   | |   | |   |     | | | |         | |   |       |   |     | | |     |
+-+ + +-+ + + +-+-+ +-+-+-+-+ +-+ + +-+ +-+ +-+-+ + +-+ + +-+-+-+ +-+-+-+ + + + +-+-+ +-+-+ +-+ +-+ +
|   | | | | | |   |   |     | | | | |       | | |   | |         | |       | | | |       | | |   | | |
+-+-+-+ + +-+-+ +-+ +-+ + + +-+ +-+ +-+-+-+ + + + +-+ + +-+ +-+-+-+-+-+-+ +-+-+ +-+-+ + + +-+-+-+ + +
|     |     |         | | |         |       |       |     |       |     | | |   |   | |   | |       |
+-+ +-+ + + +-+-+ +-+-+-+-+-+ +-+ + + +-+-+-+-+ +-+-+-+-+-+-+ +-+ + +-+-+-+ + +-+-+ +-+ +-+ + + + +-+
|     | | |   |   |   | | |     | |   | |   |             |   |       |           |   | |     | | | |
+-+ +-+ +-+ +-+ +-+-+ + + + +-+-+ + +-+ + +-+-+ +-+ + +-+-+-+-+ + +-+ + +-+-+-+-+ + + + +-+-+ +-+-+ +
| |   | |         | |     | |     |   | |   |   | | |         | | | | |     |   | | | | | |   |     |
+ + +-+-+-+-+ +-+-+ + + + +-+-+ + +-+ + + +-+ + + +-+-+ +-+-+-+ + + +-+-+-+ + + +-+ +-+ + +-+ + +-+-+
|   | | |   | | |     | |       |   |     |   |   |           | |   | |       | |     |       | |   |
+ + + + + +-+ + +-+-+-+ +-+-+-+-+-+-+ +-+ +-+-+ +-+-+-+ + +-+-+ +-+-+ + +-+ +-+ +-+-+ + +-+-+-+ + + +
| | | |   |       |   |     | |       |       |       | | |   |   |   |   |   | | | | |       | | | |
+-+ + + +-+-+-+ +-+ +-+ + +-+ +-+-+-+-+ +-+-+ + +-+-+-+ +-+ +-+ +-+ + +-+ +-+-+-+ + + + + +-+ + + +-+
| | |     |       |     | |     |     | |   |     |     |           | | |   | | |       |   |       |
+ + +-+-+ +-+-+ +-+-+-+ +-+ +-+ + +-+-+-+-+ +-+ +-+-+-+-+-+-+-+ +-+-+ + + +-+ + +-+ +-+ +-+ + +-+-+ +
| |   |   | |         | |   | |                 |   | | |   | | |   |         | | | |   |   | |   | |
+ + + +-+ + +-+ +-+-+ +-+-+-+ + +-+ +-+ +-+-+ +-+-+ + + +-+ + +-+-+ + +-+-+-+ + + +-+-+-+-+-+-+ + +-+
| | |   |     |   |   | | |     |   | |     |   |   | |   |     |   | |   | | | | |             |   |
+ +-+ + +-+ +-+ +-+-+-+ + +-+-+-+ +-+ +-+ +-+-+ +-+ + +-+ +-+ +-+ + +-+-+ + + + + + +-+ + +-+-+-+-+ +
|   | | |       |     |       | | | |     |     |   |   |         |     | |         |   | |   |     |
+-+ + +-+ + +-+-+-+ +-+ + +-+ + +-+ +-+-+-+ + + +-+ + + + +-+-+-+ +-+ +-+ + +-+ +-+ + +-+ + +-+-+-+-+
|       | |   | |   | | |   | |   |   |     | |     | | | |     |   | | |     | |   | |       |   | |
+ +-+-+ +-+ + + +-+ + +-+-+ +-+-+ +-+ + + + +-+-+ +-+ + +-+ +-+-+ +-+ + + + +-+-+-+ + +-+ +-+ + + + +
|   |       | |       |   |   |   |     | | |     |   |     |       | |   |     |   |   | |   | |   |
+ +-+-+-+ + + + +-+ +-+ + +-+ +-+ +-+-+-+ +-+-+-+ +-+ + + +-+ + + + + + + +-+-+-+-+-+-+ +-+-+ +-+ +-+
|     |   | | | | |     | |     |   |         |   |   | | |   | | | | | | | |             |   |     |
+ +-+ +-+-+-+-+-+ +-+ +-+ +-+ + + +-+-+-+-+ + + + +-+ +-+ +-+-+-+ + + + + + +-+-+ +-+-+-+-+-+ + + +-+
|   |       |     |   |       | |           | | | |   |         | | |   | |   |   | |     | |   |   |
+ +-+ +-+-+ +-+ + +-+-+-+-+-+ + + +-+ + + + + + +-+-+-+ +-+-+-+ +-+ +-+-+-+-+ + +-+ +-+-+ + + +-+ +-+
| |       | |   | | |         | | |   | | | | |     | | |           |             |     | | | |     |
+ +-+ + +-+-+ +-+-+ + +-+ +-+-+-+ +-+ + +-+-+-+-+ +-+ + +-+-+-+-+-+-+ + +-+-+-+ +-+-+-+ + + + +-+-+ +
| |   |     |       | |           | | | |             | | |     |     |     | | |                 | |
+-+-+-+-+ +-+-+ +-+-+ +-+-+-+ + + + + + + +-+-+-+ +-+ +-+ +-+ +-+-+ +-+ +-+-+ + +-+-+ + +-+-+-+-+-+-+
|   |   | |         |     | | | | | | | | |   |   | | |         |   | |   |   | | | | |     | | |   |
+ +-+ + + +-+-+ +-+ + +-+ + + +-+-+ +-+-+ +-+ +-+-+ +-+ + + +-+ + +-+ +-+ + +-+-+ + + + + +-+ + +-+ +
|   | |     | |   | |   |   |   |   |         |   |     | | |   | |   | | |     |     | |       |   |
+ + +-+ +-+-+ + + + +-+-+ +-+-+-+ + +-+ +-+-+-+-+ +-+-+-+ +-+-+-+-+ +-+ +-+ + + +-+-+-+-+ + +-+-+ +-+
| | |   |       | | |   |   |   | | | | |         |     |   |     |     |   | |     |   | |   | |   |
+-+ + +-+-+ + +-+-+ + +-+-+ + + +-+ + +-+-+-+ +-+ +-+-+ + + + +-+-+-+ +-+-+ + + +-+ + + +-+ +-+ + +-+
|       |   |   | | | |     | |     | | |       | |       |       | | | | | | | | |   |         |   |
+-+-+ +-+ +-+-+ + +-+ + +-+-+-+-+-+ + + +-+ + + +-+ +-+-+ +-+-+-+-+ + + + +-+-+-+ +-+-+-+ +-+-+ + +-+
| | | |     | | |   |         | |     |   | | |       |       | |   |   |           |     |   |   | |
+ + + +-+ +-+ +-+-+ + +-+-+ + + +-+-+ + +-+-+-+ + + +-+ +-+-+ + + + + +-+-+ +-+ +-+ + + +-+ + + + + +
|     | |   |       | |   | |   |   | |       | | | |     | |     | | | |     | | | | | |   | | |   |
+-+ +-+ + + +-+-+-+ +-+ + + +-+ + + + +-+ +-+-+-+ +-+-+ +-+ + +-+-+ + + +-+ +-+-+ +-+ +-+ +-+ +-+-+-+
|     |   |     |     | | | |     | | | |   |     |     | |   |   |     |       |       | |       | |
+ +-+ + + +-+ +-+ + + + + +-+ + +-+-+ + + +-+ +-+-+-+-+-+ +-+-+ + + +-+ +-+-+ +-+ +-+ +-+ +-+-+-+-+ +
| | | | | | |     | | | | |   |         |       |   |       |   | | |     |     |   | |       |   | |
+-+ +-+-+ + + +-+ +-+-+-+ +-+-+ + +-+-+-+ +-+ + + +-+-+ +-+-+ +-+ +-+ +-+-+ +-+ + +-+ + + + +-+ +-+ +
|   |   | | |   |   | |   |   | |   |     | | |   |     |       | |     | |   |     |   | |   | | | |
+-+ + + +-+ + +-+ +-+ +-+ + +-+ +-+ +-+ + + +-+-+ + +-+ +-+-+ +-+ + +-+-+ +-+-+ +-+-+-+ + +-+-+ + + +
|     |     | |   |   | |         | |   |     | |   | |     |   | | |   | |     | |     | |       | |
+ +-+-+-+ +-+ + +-+ + + +-+ +-+ +-+-+-+-+-+-+-+ + + + + + + + +-+ +-+ + + + + + + +-+-+-+ + +-+-+-+ +
|     |   |   |     | | |   |     | |   |   |     | | | | | |   | |   |   | | | |     | |       |   |
+ +-+-+ +-+ +-+ +-+ +-+ +-+-+ + + + + + + +-+ + +-+-+ + + +-+-+ +-+-+ +-+-+-+ +-+-+ + + +-+ +-+-+-+ +
| |           | | | | |       | |     | |     |       | |   | |   |   |             |   | |     |   |
+ +-+ +-+ + +-+ + +-+ + +-+ + +-+ +-+-+-+ +-+ +-+-+-+-+ +-+-+ + +-+ + +-+-+ +-+ +-+-+-+-+ + +-+ + +-+
|   |   | |   |   | | | |   |   |   |   | | |   |   |     | | |   | | | | | |   |       |     |   | |
+-+-+-+-+ +-+-+-+ + + +-+-+-+ +-+ +-+ +-+ + +-+-+-+ + + + + + + + +-+ + + + + + + +-+-+ +-+ +-+ +-+ +
|         |   | |   |     |     |       | | |   |     | | |   | |       |   | | | | |         | |   |
+ + +-+-+ + +-+ + + +-+ +-+-+-+-+-+-+ + + + + +-+-+-+ +-+-+-+ +-+ +-+ + +-+ +-+-+ + +-+ +-+-+ +-+-+ +
| | |   |     |   |     | |   |       | | |     |   | |   | |       | | |       |   |   |     |   | |
+-+ + +-+-+-+ +-+-+ + +-+ + + + +-+-+ +-+ + +-+ +-+ + +-+ + +-+ +-+ + + + + + + + + +-+-+-+-+-+-+ + +
| | | | | | | |     |       |   | | |         |     |   |     | |   | | | | | | | |                 |
+ + + + + + +-+-+-+-+ +-+ +-+-+-+ + + +-+ +-+-+-+-+-+ + + + +-+-+ +-+-+ + + +-+ +-+ + +-+ +-+-+ +-+-+
|   |     |     | | | |   |   |       | | |     |   | |   | |   | | | |   |   | | | | |     |   | | |
+ + +-+-+ + +-+-+ + + +-+ +-+ +-+ +-+ + + + +-+-+-+ +-+ + +-+ + + + + +-+ + + +-+ +-+-+ +-+ +-+ + + +
| | |                   |   | | | | | |     |   |     | | | | |   | |     | |   |   |   | | |       |
+ +-+-+-+ +-+ +-+-+-+-+ + +-+ + +-+ +-+ +-+-+-+ +-+ + +-+ + +-+-+-+ + +-+-+-+-+-+ +-+-+ + +-+-+-+ + +
| | |     |     |   |   | |                 | |     | |       | | |                   |   |       | |
+ + +-+-+-+-+ + +-+ +-+ + +-+-+-+ + +-+-+ +-+ +-+-+-+ + +-+ + + + + + +-+ +-+ + + + +-+-+ +-+ +-+-+-+
|     |       |       | |     |   |     |       |       |   | |     |   | |   | | | |       |       |
+-+-+-+-+-+-+-+-+-+-+-+-+-+-+-+-+-+-+-+-+-+-+-+-+-+-+-+-+-+-+-+-+-+-+-+-+-+-+-+-+-+-+-+-+-+-+-+-+-+-+