+-+-+-+-+-+
|         |
+ + + + + +
| | | | | |
+ + + + + +
| | | | | |
+ +-+ + +-+
| |   |   |
+ +-+ +-+ +
| |     | |
+-+-+-+-+-+