+-+-+-+-+-+-+-+-+-+-+-+-+-+-+-+-+-+-+-+-+-+-+-+-+-+-+-+-+-+-+
|     |       | | |       | |   | |       |   | | |     |   |
+ +-+-+-+ +-+-+ + +-+-+ + + +-+ + + +-+-+ + +-+ + + +-+-+-+ +
|       |         |     | | | |   | |     |   |       |     |
+ +-+ +-+-+ +-+ +-+-+ +-+ + + + +-+ +-+-+ + + +-+-+-+ +-+-+ +
| | |     | |     | | |   |         | |   | | |     |       |
+ + +-+-+ +-+-+ +-+ +-+-+ + +-+-+ +-+ +-+-+-+ + +-+-+ +-+ + +
| |   |         |   |       | |           |   |   | | |   | |
+-+-+ + + +-+-+-+-+ +-+ +-+-+ + +-+ +-+-+-+ +-+-+ + +-+-+-+ +
| | |   | |       |         |   |   |         |   |     | | |
+ + +-+ + +-+ +-+-+-+ +-+-+-+ + +-+-+-+ + +-+-+-+ +-+ +-+ + +
| | |   | |         | |   |   | |     | | |         |   |   |
+ + + +-+-+ +-+ +-+-+ +-+ +-+ +-+-+ + +-+ +-+ + +-+-+ + +-+ +
| | |   |   | |     | |         | | |     |   |       |     |
+ + +-+ + +-+ + +-+-+ + + +-+ +-+ +-+-+-+ +-+-+-+ +-+-+ +-+-+
| |       |   | | |   | | | | |   |   |     |     | |   |   |
+ + + + +-+ +-+-+ + +-+-+ + +-+ +-+-+ +-+ + +-+ + + + +-+ +-+
|   | | |       |   | | | | | |   |     | | | | |   | |     |
+ + + +-+-+ +-+ +-+ + + +-+ + + +-+ + + +-+ + + + +-+-+ + +-+
| | |     | |   |     |       | |   | | |       |       |   |
+-+-+-+-+ +-+ + +-+-+ + + + +-+ +-+ + + +-+-+ + +-+-+-+-+ +-+
| |     |   | |   |   | | |   |     | |   |   |   | | | | | |
+ + + +-+-+ + +-+ + +-+-+-+ +-+-+-+-+-+-+ + +-+-+-+ + + +-+ +
|   |   |     |     | | |             |       |       | |   |
+-+ + +-+ +-+-+-+-+-+ + +-+ +-+ +-+-+-+ +-+ + +-+ + +-+ +-+ +
| | |       | | |     |   |   |         | | |   | | | |     |
+ +-+ +-+-+ + + +-+-+ +-+ +-+ +-+-+-+ + + + +-+-+-+ + + +-+ +
|     | |     |   |     | |   | | | | |   | |           |   |
+-+-+ + +-+ +-+ +-+ + + + + +-+ + + + +-+ +-+-+-+ +-+-+ +-+ +
| | | | |           | | | |   | |       | | | | | | |     | |
+ + +-+ +-+-+-+ +-+ + +-+ + +-+ +-+-+-+-+-+ + + +-+ +-+-+ +-+
|   |     |   | |   | |       |   |   |   |     |       | | |
+ +-+ + + + + + +-+ +-+ +-+-+ +-+ + +-+ +-+-+ + + + +-+ + + +
|   | | | | | | |     | |   | | |   | | |     |   | |       |
+ +-+ +-+ +-+ + +-+ + +-+ + + + + +-+ + + +-+-+-+-+ +-+-+-+-+
|   |   |       | | | |   |   |           | | |       | |   |
+-+ + +-+-+-+ +-+ +-+-+-+-+-+ +-+-+ +-+ +-+ + +-+ +-+-+ +-+ +
|   | |     |       |                 | | |             | | |
+ + +-+-+-+ + +-+-+-+-+-+-+ +-+-+ +-+-+ + +-+ +-+ +-+ + + + +
| | |       |     |       | |     | | |     | |   |   |     |
+-+ +-+ +-+-+ +-+-+-+-+ +-+ +-+ +-+ + +-+ +-+-+ + +-+ + + + +
|       | | | |       |   | | | |           |   | |   | | | |
+-+-+-+ + + + + +-+-+-+ +-+ + +-+-+ +-+ +-+ + + + +-+ +-+ +-+
|       |   |   | | | |   |     | | |   |   | | |   | |   | |
+ + +-+-+ +-+ +-+ + + + + + + + + +-+-+-+ +-+-+-+-+-+-+-+ + +
| |     |     | |       |   | |   | |       | |     | |     |
+ +-+-+ +-+-+ + + + +-+ + +-+-+-+-+ +-+-+ +-+ + +-+-+ +-+-+ +
|     |   | |     |   | | |     |       |       |   |   |   |
+-+-+ +-+ + + +-+ +-+ +-+-+-+ +-+-+-+ + + + +-+-+ +-+ +-+ +-+
|     |       | |   | |         |     |   |       |   |     |
+-+ +-+-+-+-+-+ +-+ +-+-+ +-+ + +-+-+ +-+ +-+ + +-+-+ +-+-+-+
| | |   |     | | | |   |   | |   |     | | | | |     |     |
+ + + + +-+ +-+ + + + +-+ +-+-+ +-+-+ +-+-+ + +-+ + +-+ +-+-+
| | | |     |       |         | |   | |         | |         |
+ + + +-+-+ +-+-+ +-+ +-+-+-+-+-+ + + +-+ +-+ +-+ +-+ +-+ + +
| | | | | |               | |     |     |   |     | | |   | |
+ +-+-+ + + +-+-+-+-+-+ +-+ +-+ + +-+-+ +-+-+-+ + + + +-+-+-+
|     |   |   |           |   | |   | |   | | | | | |     | |
+-+-+ + + +-+ +-+ +-+-+-+ + + +-+-+ + + +-+ + +-+ + + +-+-+ +
|       |     |     |     | |       |     |       |         |
+-+-+-+-+-+-+-+-+-+-+-+-+-+-+-+-+-+-+-+-+-+-+-+-+-+-+-+-+-+-+