+-+-+-+-+-+-+-+-+-+-+-+-+-+-+-+-+-+-+-+-+-+-+-+-+-+-+-+-+-+-+-+-+-+-+-+-+-+-+-+-+-+-+-+-+-+-+-+-+-+-+
|   |   |       |     |         |   |   |             |     |         |       |                 |   |
+-+ + + + +-+-+ +-+ + + +-+-+ + +-+ + + + +-+-+-+ +-+ + + + +-+-+ +-+ +-+ + + + +-+-+-+-+-+-+-+ +-+ +
| |   |   |   | |   | | |     |   |   |   |   |   | | | | |       |     | | |   |   |         |   | |
+ +-+-+-+-+-+ + + +-+ + + +-+-+-+ + +-+-+-+ + + +-+ + + + +-+ +-+-+-+-+ +-+ +-+-+ + + +-+ +-+-+-+ + +
|     | |     | | |   | | |       |   | |   |   |     | | |   |     |   |   |     |   |   |   |   | |
+ +-+ + + + + + + + +-+-+ + +-+-+-+-+ + + +-+-+-+ +-+-+ + +-+-+ +-+ +-+ + +-+ +-+-+-+-+ +-+ + + +-+ +
| | | |   | | | | |       |   |     |   | |     | |   | |       | |   |   | | |       |     |   |   |
+ + + + +-+ +-+ + +-+-+-+-+-+ + + +-+-+ + + +-+ + + + + +-+-+-+-+ +-+ +-+-+ + + + +-+ +-+-+-+-+-+ + +
| |   |   | |   |   |     |   | | |     | | | |   | |       |       |   |     | | |   | |       | | |
+ +-+ +-+-+ + +-+-+ + + +-+ +-+ + + +-+-+ + + +-+-+-+-+-+-+ + +-+-+-+-+ + +-+-+-+ +-+ + + +-+ + + + +
|   |     | |       | |     |   | |   | | |       |       |   |   |   | | |     |   |   | |   | | | |
+ + +-+-+ + +-+-+-+-+ +-+-+-+ +-+-+-+ + + +-+-+-+ + +-+-+ +-+ + + + + + + + +-+ + + +-+-+ + +-+-+ + +
| |     | |     |     |       |   |     | |     | | |     |   | |   |   |   | | | |   |   |   |   | |
+-+-+-+ + +-+ +-+ +-+-+ + + +-+ + + +-+-+ +-+-+ + + +-+-+ +-+-+ +-+-+ +-+-+-+ + + +-+ + +-+-+ + +-+ +
|       |   |   | |     | | |   | | |   |     |   |     | |     |     |     | | | | | | | |   | |   |
+ +-+-+-+-+ +-+ + + +-+-+ +-+ +-+ + + + +-+-+ + +-+-+-+ + + +-+-+-+-+-+ +-+ + + + + + + + + +-+ + +-+
|   |   |       | |   | |   | | |   | | |     | |       |   |   |       |   | | |   |   | | |   |   |
+ + +-+ + +-+-+ + +-+ + +-+ + + +-+-+ + + +-+-+ +-+ +-+-+ +-+ + + +-+-+-+ +-+ + +-+ +-+-+ + + +-+-+ +
| |   |   |   | |   | |   |     |     | | |     |   |     |   |   |     | |   |   | | |   |   |   | |
+ +-+ +-+-+ + +-+-+ + + + +-+-+-+ +-+-+ + + +-+-+ +-+ +-+-+ +-+-+-+ +-+ + +-+ +-+ + + + + +-+-+ +-+ +
|   |       |     | |   |   | |   |   |   |   |   |   |   | |       |   | |     | | |   |       |   |
+-+ +-+-+-+-+-+-+ + +-+-+-+ + + +-+ + +-+-+-+ + +-+-+-+ + + +-+-+ + + +-+ + +-+-+ + + +-+-+ +-+ + + +
|   |       |   | |   |       | |   | |     | |   |     | |     | | | |   | |     | |   |   |   | | |
+ +-+-+ +-+ +-+ + +-+ + +-+-+-+ + +-+ + +-+-+ +-+ + +-+-+ +-+-+ + + +-+ +-+ + +-+-+ +-+ + +-+-+ + +-+
|     |   |   | |     | |       |   | |       |   |     |     | | |   | |   | |     |   |     | |   |
+-+-+ +-+ +-+ + +-+-+-+ + +-+-+-+-+ + + +-+-+-+ + +-+-+ + +-+-+ + +-+ + + + + +-+-+ +-+-+-+-+ + +-+ +
| |   |   |       |   | |     |   | | | |       |     | |       |   | | | | |     |           |   | |
+ + +-+ +-+-+-+-+-+ + + +-+-+ + + + + + +-+-+ +-+-+-+ + +-+-+-+-+-+ + + +-+ +-+-+ +-+-+-+-+-+-+-+-+ +
| | |     |         | |     |   |   | | |     |       |       |     | | |     | |       |         | |
+ + +-+-+ + +-+-+-+-+ +-+-+ +-+-+-+-+ + + +-+-+-+ +-+-+-+-+-+ + +-+-+ + + +-+ + +-+-+-+ + +-+-+-+ + +
|   |     |   | |   |       |   |     | | |     |   |     | | |   |   | | |         |   |   | |   | |
+ +-+ +-+-+-+ + + + +-+-+-+-+-+ + +-+-+ + + +-+ +-+ + + + + + +-+-+ +-+ + +-+-+-+-+-+ +-+-+ + + +-+ +
| | |     |   |   |   |       | |   | | |     |   | | | |   |       |   |   |   |     |     | |   | |
+ + + +-+ + +-+ +-+-+ + + +-+ + +-+ + + +-+-+-+-+ +-+ + +-+-+ +-+-+-+ +-+ + + + + +-+-+ +-+-+ +-+ + +
| |   |   | | | |   |   |   | | |   | |     |   |   | |       |       |   |   |   |       | |   |   |
+ + +-+ + + + + + + +-+-+-+ + + + +-+ +-+-+ + + + + + +-+-+-+-+ +-+-+-+-+ +-+-+-+-+ +-+-+ + + + +-+ +
| |   | | | |   | |     |   | | | |   |   |   | | | | |     |   |       |       |     |   |   |     |
+ +-+ + +-+ +-+-+ +-+-+ + +-+ + + + +-+ + +-+-+ +-+ + + +-+ + +-+ +-+-+ +-+-+-+ + +-+-+ +-+ +-+-+-+-+
| |   |   |     |   |   | |     | |     |     |   |   | |   |     |     |     | | | |   | | |     | |
+ +-+-+-+ +-+-+ +-+ + +-+ + +-+-+ +-+-+ +-+-+ +-+ +-+-+ + +-+ +-+-+ +-+-+ + +-+ + + + +-+ + + + + + +
|       |       |   | |   | |     |   |     |           | |   |     |     | |   |   |   | | | | |   |
+-+-+-+ + +-+-+-+ +-+ + +-+-+ +-+-+ + +-+-+ +-+-+-+-+-+-+ +-+-+ +-+-+ +-+-+-+ +-+-+ +-+ + + + + +-+ +
|     | | |   |   |   |   |   |     |   |       |   |   | |     |             |   | | | |   | | | | |
+-+ + + + + + + +-+ +-+-+ + + + +-+-+-+ +-+-+-+ + + +-+ + + +-+-+ +-+-+-+-+-+-+ +-+ + + + +-+ + + + +
|   | | | | |   |   |   | | | |       | |   |   | |   |     |     |   |     |     |   | | |   | | | |
+ + +-+ + + +-+-+ +-+ + + + + +-+-+-+ + + + +-+-+ +-+ +-+-+-+ +-+-+ + +-+ +-+ +-+ + +-+ + +-+-+ + + +
| | |   |   |     |   |   | | |     | |   |   |   | |   |   |   |   |     |   | |   |   |       | | |
+ +-+ +-+-+-+ +-+-+ + + +-+ +-+ + +-+ +-+-+-+ + +-+ +-+ + + +-+ + +-+-+-+ + +-+ +-+-+ +-+-+-+-+-+ + +
|   |   |   |     | | | |   |   |     | |     |       | | | |   | |   |   |   |   | |     |       | |
+ + +-+ + + +-+-+ +-+ + + + + +-+-+-+-+ + +-+-+-+-+ +-+ + + + +-+ + + + +-+-+ + + + +-+-+ +-+ + +-+ +
| |   | | |     |     | | | | |   |     |           |   | |   |   | | | |   |   |   |   | |   | |   |
+-+-+ + +-+ +-+-+-+-+ +-+ + + + + + + +-+-+-+-+-+-+-+ +-+ +-+-+ + + +-+ + +-+-+-+-+ + +-+ + +-+ + +-+
|     | |   |       | |   | | | | | |       |   |     | | |     | |     |     |   | | |   | |   | | |
+ +-+-+ + +-+ +-+-+ + + +-+-+ + + + +-+-+ + + + + +-+-+ + +-+ +-+ + +-+-+-+ + +-+ + + + +-+ +-+ + + +
|     | |     |     | |       | | | |     | | | | |     |   | |   |         |     |   |   |   | |   |
+ +-+ + + +-+-+ + +-+ +-+-+-+ + + +-+ +-+ +-+ + + + + +-+-+ + + +-+ +-+-+-+-+-+-+ +-+ +-+ +-+ +-+-+ +
|   |   | |     | |     |   | | |   |   | |   |   | |       | | |   |           | |     |   |   |   |
+-+ +-+-+ + +-+-+-+ +-+-+ + + + +-+ +-+ +-+ +-+-+-+ +-+-+-+-+-+ + +-+ +-+-+-+-+ + + +-+-+-+ + + + +-+
| | |   | |         |   | | |   |       |   |     |         |   |   | |     |   | |   |     | |   | |
+ + + + + +-+-+-+-+ + + + + +-+-+ +-+-+-+ +-+ +-+-+-+-+-+-+ + +-+ +-+ +-+ +-+ + +-+-+ + +-+-+ +-+-+ +
|   | |   |       | | |   | |   | |       |     |   |   |   | |   |   |   |   | |     |     | |     |
+ +-+-+-+ + +-+-+ +-+ +-+-+ + + +-+ +-+-+-+-+-+ + + + + + +-+ +-+-+ +-+ +-+ +-+-+ +-+-+-+ + + +-+-+ +
| |     | |   | |     |   |   |   |     |     |   |   |   |       | |     | |     |     | | |       |
+ + +-+ + +-+ + +-+-+-+-+ +-+-+-+ +-+-+ + +-+ + +-+-+-+-+-+ +-+-+ + +-+-+ + + +-+-+ +-+ +-+ + +-+-+ +
| | | | | |   |         | |       |   |     | | |     |     |   |   |   | |   |   |   |     | |   | |
+ + + + +-+ +-+-+-+ +-+ + + +-+-+-+ + + +-+-+ + +-+ + + +-+-+ + +-+-+ + + +-+-+-+ +-+ +-+-+-+-+ + +-+
|   | |   | |     | |     | |     | | | |     |   | |         |     | | |       |   |     |     |   |
+-+-+ +-+ + + +-+ + +-+-+-+ + +-+ + + + + +-+-+-+ +-+-+-+-+-+-+-+-+ + + + +-+-+ +-+ +-+-+ + +-+-+-+ +
|       |   |   | |   |   |   | | | | | |   | |   |     |         | | |   |   |   | |   |     |     |
+-+-+ + +-+-+-+ + +-+ + + +-+-+ + + + + +-+ + + +-+ +-+ + +-+-+-+ + + +-+-+ +-+-+ + + + +-+-+-+ +-+ +
|     |         |     | |       |   | |   | |       | | | |     | |   | |       | | | |         |   |
+ + +-+-+-+-+-+-+-+-+-+ +-+ +-+ +-+-+ +-+ + +-+-+-+-+ + +-+ +-+ + +-+-+ + +-+-+ + + + +-+-+-+-+-+ +-+
| | |       |           | | |       | |   |         |     | |   |   |   |   |   | | |   |   |   |   |
+ + + +-+-+ + +-+-+-+-+-+ + +-+-+ +-+ + +-+-+-+-+ + +-+-+ + +-+ + +-+ + +-+ + +-+ + +-+ + +-+ + +-+ +
| | | |   | |   |       | |     | |   | | |     | |     | |   | |     |   | |       |   |   | |     |
+ + + +-+ + +-+ +-+ +-+ + +-+-+ + + +-+ + + +-+ +-+-+-+ + +-+ + +-+-+-+ + + +-+-+-+-+ +-+-+ + +-+-+-+
| | |     |     |   | |   |   | | | | |   | | |     |   | |   |   |     | |   |   |   |     |   |   |
+ + +-+-+ +-+-+-+ +-+ +-+ + +-+ + + + +-+ + + +-+-+ + +-+ + +-+-+ + +-+-+-+-+ + + + +-+ +-+ +-+ + + +
| |   |   |       |     | | |   | | |   | | |   |   | | |   |     | |         | | |   | |     |   | |
+ + +-+ +-+ +-+-+-+ +-+ + + + +-+ + + + + + + + + +-+ + +-+-+ +-+-+ + +-+-+-+ + + +-+ + +-+-+ +-+-+ +
| | |   |     |     |   | | | |   | | | | | | | |     |     | | |     |     |   | |   |   |   |   | |
+ +-+ +-+-+-+ +-+-+ +-+-+ + + + +-+ + + + + + + +-+-+-+-+-+ + + + +-+-+ +-+ +-+-+-+ +-+ + +-+ + + + +
| |   |     |     |       | | |   | | |   | | |   |       | | | | |     |           | | |   | | | | |
+ + +-+ +-+ +-+-+ +-+ +-+-+ + +-+-+ +-+-+-+ + +-+ + + +-+ + + + + + +-+-+-+-+-+ +-+-+ + +-+ + +-+ + +
|   |   |       |   |   |   |       |   |   |   |   | |     | | | |   |       | |   |   |   |     | |
+ +-+ +-+-+-+-+ +-+ +-+ + +-+-+-+-+-+ + + +-+-+ +-+-+ +-+-+ + + + +-+ + +-+-+ +-+ + + +-+ +-+-+ +-+ +
| |       |   | |   | | | |           |   |     |   |     | | |     | |   |   |   | |   | |     |   |
+ +-+-+-+ +-+ + + +-+ + + + +-+ +-+-+-+-+-+ +-+-+-+ +-+-+ +-+ +-+-+-+ +-+ + +-+ +-+ +-+ + + +-+-+ +-+
|   |     |   | |   |   |     |       |     |     |     |   | |         | |   | |   |   | | |   |   |
+-+ + +-+-+ +-+ +-+ + +-+-+-+ +-+-+-+ + +-+-+ +-+ + + + +-+ + + +-+-+-+-+ +-+ + + +-+ +-+ + + + +-+ +
| |   |     |   |   |     | |   |   | |       | | | | | |   | | |     |     |   |   | | | | | |   | |
+ +-+-+ +-+ + +-+ +-+-+-+ + +-+ +-+ + +-+-+-+-+ + +-+ +-+ + + + + +-+ + +-+-+-+ +-+ + + + +-+ +-+ + +
|       |   |     | |     |   |     | | |   |     |   |   | | |     |   |     |   | |   |   |   |   |
+ +-+-+-+ +-+-+-+-+ + +-+-+-+ +-+ +-+ + + + + +-+-+ +-+ +-+-+ +-+-+-+ +-+ +-+ +-+ + +-+-+-+ +-+ +-+-+
|       |           |       |     |   | | |   |   |   | |   |       |   | | | | | |       |     |   |
+ +-+-+ + +-+-+-+-+-+-+-+-+ + +-+-+ +-+ + +-+-+ + +-+ + + + +-+-+-+ +-+-+ + + + + +-+-+-+ +-+ +-+ + +
|     | | |     |         | |     |   |   |     |     |   |   |   | |   | | | |     |   |   |     | |
+-+-+ + +-+ +-+ + +-+-+ +-+ +-+-+-+-+ + +-+-+ +-+-+-+ +-+-+-+ + + + + + + + + +-+-+-+ + +-+ +-+-+-+ +
|     |       |       |               |       |             |   |     |   |           |     |       |
+-+-+-+-+-+-+-+-+-+-+-+-+-+-+-+-+-+-+-+-+-+-+-+-+-+-+-+-+-+-+-+-+-+-+-+-+-+-+-+-+-+-+-+-+-+-+-+-+-+-+