+-+-+-+-+-+-+-+-+-+-+-+-+-+-+-+-+-+-+-+-+-+-+-+-+-+-+-+-+-+-+-+-+-+-+-+-+-+-+-+-+-+-+-+-+-+-+-+-+-+-+
|     |   |   |         |     |     | |         |       | | |   | |     |   | |     | | | |     | | |
+-+ +-+-+ + +-+ + +-+-+-+ +-+ + + + + +-+-+-+ +-+ +-+-+ + + + +-+ + +-+-+-+ + +-+ +-+ + + + +-+-+ + +
|         | | | | |   |     |   | |     |       |     | | |             |     |       | |     |     |
+ +-+-+ +-+ + +-+ + +-+-+-+ + + + +-+ + +-+ + +-+-+-+ +-+ + + + +-+-+ +-+ +-+-+ + + +-+ +-+ +-+ + + +
|   | |                   | | | |   | | | | | |     | | |   | |   |       | |   | |   |   |     | | |
+ +-+ +-+-+ +-+-+ +-+-+-+-+-+-+ +-+-+ + + + +-+ +-+-+ + + + +-+ +-+ + +-+-+ +-+-+-+-+ + +-+ + + +-+ +
| |   | |   |   |   |     | |   | | | | |       |     | | |   | | | |   |   | |           | | |   | |
+-+ +-+ +-+-+ +-+ + + +-+-+ + +-+ + +-+-+-+ +-+-+-+ + + +-+-+ + + + +-+-+-+ + +-+ +-+-+-+-+-+-+ + +-+
|           |     | |     | |   |   |   |     | |   |         |   | |           |     | | | |   | | |
+ +-+ +-+-+ + +-+ +-+ +-+ + +-+ + +-+ +-+ +-+ + +-+-+-+ +-+ + +-+-+ + +-+-+-+-+-+ +-+ + + + + +-+ + +
| |     |     |     |   |   |       | | | |               | |   |   | | |           | |       |   | |
+ +-+-+ + + + + +-+-+ +-+-+ + +-+-+-+ + +-+ + +-+ +-+ +-+-+-+-+-+-+-+ + +-+-+ +-+ +-+-+-+-+-+ + +-+ +
|   | | | | | |     |   |     | | | |       |   | | |   | |   | |               |     |       |     |
+-+-+ +-+ +-+-+-+ +-+ + + +-+ + + + + + + +-+-+-+ + + +-+ + + + +-+ +-+ + +-+ +-+-+ +-+-+ + +-+-+-+ +
| |         |   | | | | |   |     |   | |   |     |         | |   | | | |   |   |       | | | |   | |
+ + +-+-+-+ + + + + +-+-+-+-+ + +-+ +-+-+-+-+-+-+ +-+-+-+ +-+ +-+ + + + +-+-+ +-+-+ + + + +-+ + + +-+
| | |       | | | |         | |   | | |     | |   | |     |   |   | |   |   |   |   | | |       |   |
+ +-+-+ +-+-+-+ + +-+ + +-+-+-+ + + + + + +-+ +-+-+ +-+-+ +-+-+ +-+ +-+-+-+ +-+-+ + +-+-+-+ +-+-+ +-+
|   |   |   | | |     | |     | |     | |       |   | | | |   |         |   | | | | |   |     | |   |
+ + +-+ + + + + +-+ +-+-+-+ + + + +-+ +-+-+ + +-+-+ + + + +-+ +-+-+ +-+-+ +-+ + + +-+ +-+ + +-+ + + +
| | | |   |     |   |       | | | |   |   | |   |         |   |     | | |   |     |   | | |   |   | |
+ +-+ + + +-+ + +-+-+-+ +-+-+ + +-+-+ + +-+ + +-+-+-+ +-+-+ +-+-+ + + + + +-+ +-+-+ +-+ +-+-+ +-+ + +
| |   | | |   |   |   | |       |     | |   |   | | |   |   |     | | | |     |           |     | | |
+ + +-+-+ + + + +-+-+ +-+ +-+-+-+ +-+-+ +-+-+ +-+ + + +-+ +-+-+ +-+-+ + + + +-+-+ + +-+-+ +-+ + + + +
|   |     | | | |       | | |         |   |   |   | |         | |     |   |   |   |     | | | | | | |
+ + + +-+-+-+-+ + + + +-+-+ +-+-+ +-+ + +-+-+ + + + + +-+ + +-+ +-+-+ + +-+ + +-+-+ + +-+ + +-+ +-+ +
| |   |   |   |   | |   |       | | | | |   |   |     |   |   |     | | |   |   |   | | |     | | | |
+ +-+-+ +-+-+ + +-+-+-+-+-+-+ +-+ + +-+ + +-+-+ + +-+-+ +-+ + + +-+-+ +-+-+ + +-+ +-+ + +-+ + + + + +
|   | |       | |   |     |   | | |       | |   | | | | |   | | | | | |     |       |     | |   |   |
+-+ + + +-+-+ +-+ +-+ +-+ + + + +-+ +-+-+ + +-+-+-+ + + + +-+-+-+ + + +-+-+ +-+-+ +-+-+ +-+ +-+-+ +-+
|   |     |   |     |   | | |     |     |   |     | | | |   |   | | | | |   |   |   |     |   |   | |
+ + + +-+-+-+ +-+-+ + +-+-+ +-+-+-+ + +-+ +-+ +-+-+ + +-+-+ + +-+ + + + + + + +-+-+ +-+ + + +-+ + + +
| |   | |         | |           | | | |     | |   | |         |   | | |   |   |     |   | |   | | | |
+-+ + + +-+-+ +-+-+ +-+-+-+-+ +-+ +-+-+ +-+ + + + + + +-+-+ + + +-+ + + +-+ +-+-+ +-+-+-+-+ +-+-+ + +
| | | |             |   |   |       |   | | | | |       |   |           | | |   | | |           |   |
+ +-+ +-+ +-+-+-+ + + + + +-+-+ + +-+-+ + + + +-+-+-+ + + +-+ + +-+-+-+-+ +-+ + +-+ + +-+ + +-+ +-+ +
|   |   |     |   |   | | |   | | | |     | |         | | |   | |   |   | | | |   |     | | |     | |
+-+ + +-+-+-+-+ +-+-+-+ + +-+ + +-+ +-+ +-+-+-+ + + + +-+ + + +-+ + + + + + +-+ +-+ +-+ +-+-+-+ + +-+
|   | |       |   | |     | | |   | |   |   |   | | |   | | |   | |   | | |       | |     |   | |   |
+ + + +-+ + +-+ + + +-+-+ + + +-+ + + +-+-+ +-+-+ +-+ +-+ + +-+ + +-+ + + + + + + +-+ + +-+ + + +-+ +
| | | |   | | | |     | | |   | | | | |   |   | | |     | | | |   |   | | | | | | |   |   | | |   | |
+ +-+ +-+-+ + + + + +-+ + + +-+ + + + + +-+-+ + +-+ +-+ +-+-+ +-+-+ +-+-+ +-+-+ +-+ +-+ +-+ + + + + +
|   | |       | | |   | |       |   |         |     |       |           | |       |   |   | |   | | |
+ +-+-+ +-+ +-+ +-+-+-+ +-+ + +-+ + + + + +-+-+-+ + +-+-+-+-+ + +-+ + + + + + +-+-+-+-+-+ +-+-+-+-+-+
| | |   |     |       | |   |     |   | | |   |   | | |     | | |   | | |   | |     | | |       |   |
+ + + + +-+ +-+-+ +-+-+ +-+-+ +-+ +-+ +-+ + +-+ + +-+ +-+ +-+ +-+ + + +-+-+ +-+-+ + + + +-+-+-+ + + +
|   | | |   | |         | |     |   | |         |     |   |   |   | | |   |       |   | | | | |   | |
+-+ + + +-+ + + +-+ +-+ + +-+ +-+-+-+ +-+ + + + +-+-+-+ +-+ +-+ +-+ +-+-+ +-+ +-+ +-+ + + + + +-+-+-+
| | | | |   | | |     | | |   | | | | | | | | |   |       |   | |   | | | |     | | | |         | | |
+ + + +-+-+-+ + + +-+-+-+ +-+ + + + +-+ +-+-+-+ +-+-+-+ +-+-+-+-+ +-+ + + +-+ + + + + +-+ + + +-+ + +
|           | | | | |     | |     |   | |         |     |       | | | |       | | |     | | |     | |
+-+ +-+-+ +-+ +-+ + + +-+-+ + +-+ + + + +-+ + + +-+ + +-+-+-+ +-+ + + + +-+ +-+-+-+-+-+ + +-+-+-+-+ +
|   |                 |     | |     |     | | |   | |   | |           |   |   |       |     |     | |
+ + + + +-+-+-+-+ + + +-+-+ + +-+-+ +-+-+ +-+ + + +-+ +-+ +-+-+-+ + + + +-+ +-+ +-+-+ +-+-+ +-+ + + +
| | | |   | | | | | |     |     |     | | |   | |       |         | |     | |   | |     | | |   |   |
+ +-+-+ +-+ + + + +-+-+-+-+ +-+ +-+ + + + +-+-+-+ + +-+ + +-+-+-+ + + +-+-+-+-+-+ +-+-+ + + + + +-+-+
| |         |   |   | |   |   | |   | | | |       | | | | |     | | |         |       |   | | |     |
+-+ +-+-+-+ +-+ +-+ + + +-+-+-+ +-+-+ + +-+ +-+ + +-+ + + + +-+ + + +-+ +-+-+ +-+-+ + +-+ +-+ + + +-+
| | |       |   |       | |   | |       | | |   | |   | |   | | | | | | | |   | |   |         | |   |
+ +-+ + +-+-+ +-+-+ + + + +-+ +-+-+-+ + + +-+ +-+ +-+ +-+-+ + + + +-+ +-+ + +-+ + + + + +-+-+ +-+-+-+
|     |   |   |     | |   | |   |   | |   | | | | |   |   | | | |   |     |   |   | | | |       |   |
+-+ + + +-+ + +-+-+ + +-+ + +-+ + +-+ + +-+ + + +-+ + + + + + +-+ +-+ +-+-+ + +-+ +-+-+-+-+-+ + +-+ +
|   | |   | |   |   | |   |       | | | |           | | |   |     |     |   | | | | |     |   |   | |
+ + + + + + +-+-+-+ +-+-+ +-+ +-+ + +-+-+-+ + +-+ +-+-+-+-+-+-+ + + + + + + + + + + +-+ + + +-+ +-+ +
| | | | |   |     |   |       | | |   |     | | | |   | |   |   | | | |   | | |   | | | | | |       |
+-+-+ +-+ +-+-+-+ + +-+ + +-+-+ +-+ +-+ + +-+ + + +-+ + +-+ +-+-+-+ +-+-+-+ +-+ +-+ + + +-+-+-+ + +-+
|   |   |     |   | | | | |     | |     | | | |     | | |   |   |         |     |     |   |     |   |
+ + +-+ +-+-+-+ +-+ + + + +-+ +-+ + +-+-+-+ +-+-+ + + + +-+ +-+ +-+-+ +-+-+-+ +-+ +-+ + + +-+ + + +-+
| | |   |   |   |   | | |   |       |     |     | |         |       | |     | |   |     |     | |   |
+ +-+ + +-+ + + + +-+ +-+ +-+-+ +-+-+ + +-+-+ +-+-+-+ +-+-+ +-+-+ + + +-+ +-+-+-+-+-+ +-+-+ + +-+ +-+
|   | |   |   |     |   | |         | | |   |       |   |   |   | | |   |         |     | | |   |   |
+-+ +-+ +-+ +-+ + +-+ +-+-+-+-+-+ + + + +-+ +-+-+-+ +-+ + + + +-+ +-+ +-+ + +-+-+-+-+ +-+ +-+-+-+-+-+
|         | |   | |         |     |   |             | | | |     |     |   |     |   |   |   |       |
+ +-+-+ + +-+-+-+-+-+ + +-+-+ +-+-+ +-+-+ + + + + + + + + + +-+ +-+-+-+ +-+ +-+ +-+ + +-+-+ + +-+ + +
| |     | |         | |     | |       | | | | | | | |   | |   |       | | |   | |   |     |   | | | |
+-+-+-+ +-+-+ +-+-+-+-+ + + +-+ +-+ +-+ + +-+ +-+-+-+-+-+-+ + +-+-+ +-+-+ +-+ +-+-+ +-+ +-+-+ + +-+-+
| | |   | | |   |   | | | |   | | | |   |   | |   | |       |     |   |     | | | |     | |       | |
+ + +-+ + + + +-+ + + +-+-+-+ + + +-+ +-+ +-+-+ + + + +-+ + +-+-+ +-+ +-+ + + + + +-+ +-+ + +-+-+-+ +
|   |   | | | |   |   |   |   | | |   | |     | |     |   | |     | |   | | |   | | |   |   |       |
+ +-+-+-+ + + + +-+-+-+ +-+-+ + + +-+ + +-+ +-+-+-+-+-+ +-+-+ +-+ + + + +-+ + +-+ + + +-+-+ + +-+-+-+
|   |     |   |   |   |   |   |   | |       |   |   |   | |   |     | |           |     |       |   |
+ + +-+-+ + +-+ +-+-+ + + +-+ +-+ + + +-+ +-+ + +-+ +-+ + + +-+-+ +-+-+ +-+ + + +-+ +-+ + +-+-+-+-+ +
| |         |   | |     | |   | |   |   |   | |   |     | | |   |   |   | | | | |   |           |   |
+ + +-+-+ + +-+ + + + +-+-+-+ + +-+-+ +-+ + +-+-+ +-+ +-+ +-+-+ + +-+ +-+ + +-+-+ +-+-+ + + +-+ + + +
| | | | | |     |   | |   | | |   | |   | |   |   |       |     | |     | | | | | |   | | | |     | |
+-+ + + + +-+-+-+ +-+ + +-+ + +-+ + + +-+-+-+-+-+ +-+ +-+ +-+-+ +-+ +-+-+ +-+ + +-+-+ + +-+-+ +-+-+-+
| | |   |     | | |   |       |   |   |   |     |     |   | |   |       |   | |         | | | | |   |
+ +-+ +-+ + +-+ +-+ +-+-+-+ + +-+ +-+ + +-+-+ + +-+ + +-+-+ + +-+-+-+-+-+ + + +-+ +-+-+ + + +-+ + +-+
|   |     |   |           | |     | |         | | | | | |   | | |   |     |       |       |   |   | |
+ + +-+-+ +-+-+ + + +-+ + +-+-+ + + +-+ +-+ + + + + + + + +-+ + + +-+ + + +-+-+-+-+-+ +-+ + +-+-+ + +
| |       |     | | |   |     | |   | |   | | |   | |         | | |   | | |   |     |   |         | |
+-+-+ + + +-+-+-+ +-+ +-+-+-+ +-+ + + + +-+-+ +-+ +-+-+-+-+-+-+ + +-+-+ +-+ + +-+ +-+-+ + + +-+-+-+ +
| |   | | |     | |     | |       |     |     |   |   | |   |     |       | | |     | | | | |       |
+ +-+ +-+-+-+ +-+ + +-+ + +-+-+ +-+-+ + +-+-+-+-+-+ +-+ +-+ + + + + +-+-+-+ + +-+ + + + +-+ + +-+ + +
| |   | |     | | | |     |       |   |             | |   |   | |   |       | |   | | | |     | | | |
+ + + + + + +-+ + +-+-+-+ +-+ + +-+-+-+-+-+ +-+-+-+ + + + + + +-+-+ +-+ +-+-+-+ + + + + +-+ +-+ + + +
|   |     |         |   | |   |     |         | | |   | |   | |   |     | |     | | |   | |     | | |
+ + +-+-+ + +-+-+-+ + + +-+-+ +-+ +-+-+-+-+ +-+ + +-+ +-+ + +-+ +-+-+ +-+ +-+-+ +-+ +-+ + +-+-+-+-+ +
| | |     |   |       | |     |         |         |   |   |         |         |   |               | |
+-+-+-+-+-+-+-+-+-+-+-+-+-+-+-+-+-+-+-+-+-+-+-+-+-+-+-+-+-+-+-+-+-+-+-+-+-+-+-+-+-+-+-+-+-+-+-+-+-+-+