+-+-+-+-+-+-+-+-+-+-+-+
|     |         |     |
+-+-+ + +-+-+ + + +-+ +
| |   | |     | | |   |
+ + +-+ + +-+-+ + + +-+
| | |   | |   | | |   |
+ + + +-+ + + + +-+-+ +
|   |   | | | | |   | |
+ +-+-+ + + +-+ + + + +
|   |   | |     | |   |
+-+ +-+ + + +-+-+ +-+ +
| |   | | |   | |   | |
+ +-+ +-+ +-+ + + + + +
|   |     |   |   | | |
+-+ +-+-+-+ +-+ +-+ + +
|         | |     | | |
+ +-+-+ +-+ +-+-+-+ + +
|   |   |   |     | | |
+ + +-+-+ +-+ +-+ + + +
| | |     |   |   | | |
+ + + +-+-+ +-+ +-+ + +
| |         |       | |
+-+-+-+-+-+-+-+-+-+-+-+