+-+-+-+-+-+-+
|           |
+ +-+-+ +-+ +
|     |   | |
+ +-+-+ + + +
|     | | | |
+ + +-+ +-+ +
| |   |   | |
+ +-+-+ +-+ +
|     |   | |
+ +-+ + + +-+
|   | | |   |
+-+-+-+-+-+-+