+-+-+-+-+-+-+-+-+-+-+-+-+-+-+-+-+-+-+-+-+
| | |         |       |                 |
+ + + +-+ +-+-+ +-+ + + + +-+ +-+-+-+-+ +
| | |   |       | | | | | |   |   | |   |
+ + +-+ +-+-+-+-+ + +-+ + +-+-+ + + + +-+
| |     |         |     |   |   | |     |
+ +-+ +-+-+-+ + +-+-+-+-+-+ + +-+ +-+-+-+
|   | |     | |     |     | |   |       |
+-+ + + +-+ +-+ + + + +-+ + + +-+-+-+-+ +
|   |   | |   | | |   | | | | |     |   |
+ +-+-+-+ +-+ +-+ +-+-+ + + + + +-+ + +-+
| |   |         | |       |   | | | |   |
+ + + +-+-+-+-+ + +-+-+ +-+-+-+ + + + + +
|   |       |   |     | | |     |   | | |
+-+-+-+-+-+ + +-+-+-+ + + + +-+-+ +-+-+ +
|   |     | |         |   | | |   |     |
+ + + +-+ + + +-+-+-+-+-+-+ + + +-+-+ +-+
| |   | |   | |     |     | | |     |   |
+ +-+-+ +-+-+ + +-+ + +-+ + + +-+-+ +-+ +
| |     |   | |   |   | | | | |   | |   |
+ + +-+ + + +-+ + +-+-+ + + + + + + + + +
| |   |   |   | |     | |   |   |     | |
+ +-+ +-+-+-+ + +-+-+ + + +-+-+-+-+-+-+-+
|     |   |   | |     |   |   |         |
+-+-+-+ + + +-+-+ +-+ +-+-+ + + +-+-+-+ +
|       | | |     |   |     | | |   |   |
+ + +-+-+ + + + +-+-+ + +-+-+ + + + + +-+
| |     | | | |     | |   |   | | | |   |
+ +-+-+ + + + +-+-+ + + +-+ +-+ + + +-+ +
|   |   | | | | |   | | |   |   | |   | |
+-+ + +-+ + + + + +-+ + + +-+ +-+ + +-+ +
| | |   | | | | |   | | |     |   | |   |
+ + +-+ + + + + +-+ + + +-+-+-+ +-+ + + +
| |   | | | |     | | |         | | | | |
+ +-+ + + + +-+-+-+ +-+ +-+-+-+-+ + + +-+
|   | | | | |     |     |   |       |   |
+ + + + + + + +-+ +-+-+ + + +-+-+-+-+-+ +
| | | | | |   | |     | | | |   |       |
+ +-+ + +-+-+-+ +-+-+ +-+ + + + + +-+-+ +
|     |                   |   |   |     |
+-+-+-+-+-+-+-+-+-+-+-+-+-+-+-+-+-+-+-+-+