+-+-+-+-+-+-+-+-+-+-+-+-+-+-+-+-+-+-+-+-+-+-+-+-+-+-+-+-+-+-+-+-+-+-+-+-+-+-+-+-+-+-+-+-+-+-+-+-+-+-+
|   |                 |             |             |             |       |       |     |   |   |     |
+-+ + +-+-+ +-+-+-+-+-+ +-+ +-+-+-+ +-+ +-+-+-+-+ + + +-+-+-+-+ +-+-+ + +-+ +-+ + +-+ +-+ + + + + + +
| | |     |       |       |   |   |   |     |     | |     |   |     | |   | | |   | |   | | |   | | |
+ + +-+-+-+ +-+-+ + +-+-+-+-+ + +-+-+ +-+-+ +-+-+ +-+-+-+ + +-+-+-+ + +-+ + + +-+-+ +-+ + + +-+-+ + +
|   |     |   | |   |   |     | |   | |     |   | |     | |   |   | |   |   |       |   |   |   | | |
+ +-+ +-+ +-+ + +-+-+-+ + +-+-+ + + + + +-+-+ + + + +-+ + + + + + + + + +-+ +-+-+-+ + +-+-+ + + + +-+
|   |   | |             | |       |   |   |   | |   | |   | |   | | | |   | |     |       | | | |   |
+-+ +-+ + +-+-+-+-+ +-+-+ + +-+-+-+-+-+ + + +-+ +-+-+ +-+-+-+-+-+ + + +-+ + + +-+ +-+-+-+ + + +-+-+ +
| |     |         | |   | |   |   |   | |   |   |                 | |   | | |   |   |     |   |     |
+ +-+-+-+-+-+-+-+ + + + + +-+ + + + + +-+ +-+ +-+-+-+-+ + +-+-+-+ + +-+-+ +-+-+ +-+ + +-+-+-+ + +-+ +
|     |     |     | | |   | |   |   |   |   | |         | |   | | |     |   |     | |       | |   | |
+ +-+ +-+ + + +-+-+ + +-+-+ +-+-+-+-+-+ +-+-+ + + +-+-+-+-+ + + + +-+-+ +-+ + +-+-+ +-+-+-+ + +-+ + +
|   |   | | |     | | |   |           |       | |           | |     | |   |     |   |   |   | | | | |
+-+ +-+ + + +-+-+ + + + +-+ +-+-+ +-+-+-+-+-+-+ +-+-+-+-+-+-+ +-+-+ + +-+ +-+-+-+ +-+ + + +-+ + + + +
|   |   | |   |   | | | |   |   |       |       |         | |   |     |   |     | |   |   |   | | | |
+ +-+ +-+-+-+ + +-+-+ + + +-+ +-+-+-+-+ + +-+-+-+ + +-+-+ + +-+ + +-+-+ +-+ +-+ + + +-+-+-+-+ + + +-+
| |   |       |   |   | |   |       | | |   |     |   | |   |   | |     |   | | | | |       |   |   |
+ +-+ + + +-+-+-+ + +-+ +-+ +-+-+ + + + +-+ +-+-+-+-+ + +-+ + +-+ + +-+-+ +-+ + + + + +-+ + +-+-+-+ +
|   | | |       |   |   |   |     | | |   |           |   | |   | | | |     |     | | | | | |   |   |
+-+ + +-+-+ + + +-+-+-+ + +-+ +-+-+ + + +-+-+-+-+-+-+-+ +-+ +-+ +-+ + + +-+ +-+-+-+ + + + + + + + + +
|   |     | | |   |   |     | |   |   |         |       |   |   |   |     |     |   |   | |   |   | |
+ +-+-+-+ +-+ +-+ + + +-+-+ + + + +-+ +-+-+ +-+ + +-+-+ + +-+ +-+ +-+-+-+-+-+-+ + +-+-+-+ +-+-+-+-+ +
|     |     | | | | | |   |   | |   | |   | |   | |     | | | |   |   |         | |       |       | |
+ +-+ +-+-+ + + + + + + + + +-+ +-+ + + + + + +-+-+ +-+ + + + + +-+ + + +-+-+-+-+ + +-+-+-+ + + +-+ +
|   |   |     |     | | | | |   |   | | | | |     | | | | | | | |   | | |     |     |   |   | | |   |
+-+ +-+ +-+-+-+-+-+-+ + + +-+ +-+ +-+-+ + + +-+-+ + + + + + + + +-+ + + + +-+ +-+-+-+ +-+ +-+ + + +-+
|   | |   |     |       |   |   | |     | | |     | | | |   | |     | |   | |   |         | | | |   |
+ +-+ +-+ + +-+ +-+-+-+-+-+ +-+ + +-+ +-+ + + +-+-+ + + +-+ + +-+-+-+ + +-+ +-+ +-+-+-+-+ + + +-+-+ +
|     |   | | |   |   |     |   |     | |   | |     | |   | |         |       |         |   |     | |
+-+-+-+ +-+ + +-+ + + + +-+-+ +-+-+-+-+ +-+-+ +-+ +-+ +-+ + +-+-+-+-+-+-+-+-+ +-+-+-+-+ +-+ +-+-+ + +
|     |     |   | | | |     | |         |   |     |   |   | |           |   |         | |   |   |   |
+ +-+ + +-+-+ +-+ + + +-+-+ + + + +-+-+-+ + + +-+-+ + + +-+ +-+-+-+ +-+ + + +-+-+-+-+ + + +-+-+ +-+-+
| |   |     |   | | | |   |   | | |       |   |   | |     |   |     | | | | |       | | |     |     |
+ +-+ +-+-+ +-+ + + + + + +-+-+ + + +-+-+-+-+-+ + + +-+-+-+-+ + +-+-+ + +-+ + +-+ + + + +-+-+ + +-+ +
|   |     |     | | | | | |     | |     |       | | |       |   |   |   |   | |   | | | | |   |   | |
+ + +-+-+ +-+-+ + + + +-+ + +-+-+ +-+ +-+ +-+-+-+ +-+ +-+ + +-+-+ +-+ +-+ +-+ + +-+-+ + + + +-+ + +-+
| | |   |     | |   |   | | |   | |   |   |     |   |   | | |   |     |   |   |       | |   | | |   |
+ + + +-+-+-+ +-+-+-+-+ + + +-+ + + +-+ +-+-+-+ +-+ +-+ + +-+ + + +-+-+ + + +-+-+-+-+-+ +-+ + + +-+ +
| | | |   |   |       | | |   | |   |   |       | |   | |     | |     | | | |     |   |   | | | | | |
+ + + + + + +-+ +-+-+ + + +-+ + +-+-+ +-+-+ +-+ + +-+ + +-+-+-+ +-+-+ + + + + +-+ +-+ +-+ + + + + + +
| | |   |   |   |       |   |       |     | | | |   |     |   |     | | |     |     |   | | |     | |
+ + +-+-+ +-+-+ +-+-+-+-+ +-+ +-+-+-+-+-+ + + + +-+ +-+-+-+ + +-+ + + + +-+-+-+-+-+ + + + + +-+-+-+ +
| | |   |     | |     | |     |           | |         |     |     | | | |       |     | | |       | |
+ + + + +-+-+ + + +-+ + + +-+-+ +-+-+-+-+-+ +-+-+-+-+-+ +-+-+-+-+-+ + +-+ +-+-+ +-+-+-+ + +-+-+-+ + +
| | | | |     | |   | |       |       |     |       |   |   |       | |   |   |     |   |     | | | |
+ + + + +-+-+ + +-+ + +-+-+-+-+-+-+-+ + +-+ + +-+-+ + +-+ +-+ +-+-+-+ + +-+ +-+-+-+ +-+-+-+-+ + + + +
| |   |     |     | |       |       | |   | | |       |       |     | |   |         |         | |   |
+ +-+-+-+-+ + +-+-+ +-+-+-+ + +-+ +-+ +-+-+ + +-+-+-+-+-+-+ +-+ +-+ + + + +-+-+-+-+ + +-+-+-+-+ +-+ +
| |       | | |     |     | |   |     |     |       |     |   | | | | | |         | |     | |     | |
+ +-+ +-+ + + + +-+-+ + +-+ +-+ +-+-+-+ +-+-+-+ +-+ + +-+ +-+-+ + + + + +-+-+-+-+ + +-+-+ + + +-+ + +
|     |   | | |       | |     | |       |     |   | | | | |     | | | |     |     |   |   |     |   |
+-+-+-+ +-+ +-+-+-+-+-+ + +-+-+ +-+ +-+ + +-+ +-+-+ + + + + +-+-+ + + +-+-+-+ +-+-+-+ + +-+-+-+ +-+-+
|   |     |           | |       |   | | |   |     | | | |   |     |   |       |       |       | |   |
+ +-+ +-+-+-+-+-+ +-+-+ +-+-+-+-+ +-+ + +-+ +-+-+ + + + +-+-+ +-+ +-+-+ +-+-+-+-+-+-+ +-+-+ + + +-+ +
| |   |         |   |   |         | |   | |   |   | |   |     |     |       |       |     | | |   | |
+ + +-+ +-+-+-+ +-+ + +-+ +-+-+ +-+ + +-+ +-+ + +-+ +-+ +-+-+-+ +-+-+ +-+-+ + +-+-+ +-+-+ +-+ +-+ + +
|     | |     | |   |   |   |   |   | |     | | |     | |     |       |   |     |   |   |   | | | | |
+ +-+-+ + +-+-+ + + +-+ +-+-+ +-+ + + +-+ +-+ + +-+ + + + +-+ +-+ +-+-+-+ +-+-+-+ +-+ +-+-+ + + + + +
| |   | |   |   | | | |       |   | |   |   | |     | |   | |   |       |   |     |         | |     |
+-+ + + + + + +-+ + + +-+-+-+-+ +-+-+-+ +-+ + +-+-+-+ +-+-+ +-+ +-+-+-+ +-+ + +-+-+ +-+-+-+-+ +-+-+ +
|   |   | | |   | |     |     |       | |   |   |   |         | |       |   | |     | |     |     | |
+ +-+-+-+-+ +-+ + +-+-+ + + +-+ +-+-+ + + + +-+ +-+ +-+-+-+-+ + +-+-+-+ + +-+ + +-+-+ + + +-+ +-+ + +
| |           | |     |   | |   |   |   | |   |   | |     |   |       |   |   | |     | |     |   | |
+ +-+ + +-+-+-+ +-+-+ +-+-+ + +-+ + +-+-+ +-+ +-+ + + + +-+ +-+-+-+-+ +-+ + +-+ + +-+-+ +-+-+-+ +-+ +
|   | | |     |       |   | | |   | |     | | |   | | |   | |     |   | | |   | |     | |   |   |   |
+-+ + + + +-+ +-+-+-+-+ +-+ + + +-+ +-+ +-+ + + +-+ + +-+ + + +-+ + +-+ + +-+ + +-+ + + +-+ + +-+ +-+
|   | |     |               |   | |     |     | |       | | | |   | |   |   | |   | |       |   | | |
+ +-+ +-+-+-+-+ +-+-+-+-+ +-+-+-+ + +-+-+-+-+-+ +-+-+-+-+ + + + +-+ + + +-+ + +-+ +-+-+-+-+ +-+ + + +
|   | |   |   |   |     | |   |     |   |     |         | | | | |   | | |   | | |         |   | |   |
+ + + + +-+ + +-+ + +-+ +-+ + + +-+-+ + + +-+ + +-+-+-+ + + + + + +-+-+ + +-+ + +-+-+-+-+ +-+ + +-+ +
| | |   |   |   | | | | |   |       | | | |   | |       |   | | |     |     | |   |     | |   | | | |
+ + +-+-+ +-+-+ +-+ + + + +-+-+-+-+-+ + + + +-+-+ +-+-+-+ +-+-+ +-+-+ +-+-+-+ + + + +-+ + + +-+ + + +
| | |   |   | |     | |         |   | |   |     | |       |         | |     | | | |   |   | |   |   |
+ + + + +-+ + +-+-+-+ +-+-+-+-+-+ + + +-+-+-+-+ + + +-+-+-+-+ +-+-+-+ + +-+ + + +-+-+ +-+-+ + +-+-+ +
| |   |   |     |     |   |       | |     |   |   |           |       | | | | |         |   |     | |
+ +-+-+ + +-+-+ + +-+ +-+ + +-+-+-+ +-+ + + + +-+-+ +-+-+-+-+ + +-+-+-+ + + + +-+-+-+-+ +-+ +-+-+ + +
| |     | |   | | | |     | |     |   | |   |     | |     |   |     |   |   | |     | |   |     | | |
+-+ +-+-+-+ + + + + +-+-+ + +-+ +-+-+ + +-+-+-+-+ +-+ +-+ +-+-+-+-+ + +-+ +-+ + +-+ + +-+ +-+-+ + + +
|   |       |     |   |   |   |   |   |       | | |     | |       |   | | |       | |     |     | | |
+ +-+ +-+-+-+-+-+-+ +-+ +-+-+ + + + +-+ +-+-+ + + + +-+-+ + + +-+-+-+-+ + +-+ +-+-+ + +-+-+-+-+ + + +
|     |         |       |     | |   |   |   |   | |   |   | |   |       |   | |     | |       | | | |
+-+-+-+ +-+-+-+ +-+-+-+-+ +-+-+ +-+-+-+ + + +-+-+ +-+ + + + +-+ + +-+ +-+-+ +-+ +-+-+ +-+ +-+ + + + +
|       |     |         | |     |     | | |     | |   | | | | |   | |     |     |     |   |   | | | |
+ +-+-+-+-+ +-+ +-+-+-+ + + +-+-+-+ + +-+ +-+-+ + + +-+ +-+ + +-+-+ +-+-+ +-+-+-+ +-+-+ +-+ +-+ + + +
| |   |   |     |   |     |       | |     |   | | |   |     |         |   |   | | |     |   |   | | |
+ + + + + +-+-+-+ + +-+-+-+-+-+-+ + +-+-+-+-+ + + +-+ +-+-+-+-+ + +-+ + + + + + + + +-+-+ +-+ +-+ +-+
| | |   |       | |   |         |   |         | |   |         | | |   | |   |   |   |   |   |   |   |
+ + +-+-+-+-+-+ + +-+ +-+-+ +-+-+-+-+ +-+-+-+ + + + +-+-+-+-+ +-+ +-+-+ +-+-+-+ +-+-+ +-+-+ + +-+-+ +
| | |       | | | | |     |             |     |   | |       |   | |     |     | |   |       | |     |
+ + + +-+ + + + + + +-+-+ + +-+-+-+-+ + +-+-+-+-+-+ +-+ +-+-+-+ + + +-+-+-+ + + +-+ + +-+-+-+-+ +-+ +
| | |   | | | |   |     | |   |     | |   |   |         |     | | |     |   | | |   | |         |   |
+ + +-+-+ + + +-+-+-+-+ + +-+ + +-+ +-+-+ + + + +-+-+-+ + +-+ + + +-+-+ + +-+ + + +-+ + +-+ +-+-+ +-+
| | |     | |     |   | | |   |   |     |   |     |   | | | | | |     | | |   | | |   | |   | |   | |
+ + + +-+-+ + + + + + + + +-+-+-+ +-+-+ +-+-+-+-+-+ + +-+ + + + + + + + + +-+-+ + + +-+-+ +-+ + +-+ +
| | | |     | | |   |   | |     |     |             | |   | |   | | | | |         | |     |   | |   |
+ + + + +-+-+ + +-+-+-+ + + + +-+-+-+ +-+-+-+-+-+-+-+ + +-+ +-+-+-+ + + +-+-+-+-+-+ + +-+-+ + + +-+ +
| |   | |     | | |   | | | | |     | |       |   |   | |     |   | | | |       |   | |     | | |   |
+ +-+-+ +-+-+-+ + + + + + + + + + +-+ +-+ +-+ +-+ + +-+ +-+ + + + + + + + +-+-+ + +-+ + + +-+-+ + + +
|               |   |   |   |   |         |       |         |   |   | |       |       | |         | |
+-+-+-+-+-+-+-+-+-+-+-+-+-+-+-+-+-+-+-+-+-+-+-+-+-+-+-+-+-+-+-+-+-+-+-+-+-+-+-+-+-+-+-+-+-+-+-+-+-+-+