+-+-+-+-+-+-+-+-+-+-+-+-+-+-+-+-+-+-+-+-+-+-+
|                                           |
+ +-+ + +-+ +-+-+-+-+-+ +-+-+-+-+-+-+-+ +-+-+
|   | |   |           |               |     |
+ + +-+-+-+ + +-+-+-+-+-+ +-+ +-+ +-+ +-+ + +
| |       | |           |   |   |   |   | | |
+ +-+ + + + +-+-+-+ + + + + + +-+ + +-+-+-+-+
|   | | | |       | | | | | |   | |         |
+ + +-+-+ +-+ +-+ +-+ + +-+ +-+-+ + + + + +-+
| |     |   |   |   | |   |     | | | | |   |
+ + + +-+ + +-+-+ +-+ +-+-+-+ +-+-+-+ +-+-+-+
| | |   | |     |   |       |       |       |
+ + +-+-+ + +-+ +-+-+ +-+ +-+ + + +-+ + + +-+
| |     | |   |     |   |   | | |   | | |   |
+ + +-+ +-+-+ +-+-+-+-+ + + +-+ +-+-+ + + +-+
| |   |     |         | | |   |     | | |   |
+ +-+-+ + +-+ +-+ + + +-+-+ +-+-+ + +-+ +-+ +
|     | |   |   | | |     |     | |   |   | |
+ +-+-+ +-+ +-+-+ + + + + +-+ +-+ + +-+-+-+-+
|     |   |     | | | | |   |   | |         |
+ +-+-+ + +-+-+ + +-+ + +-+ + +-+ +-+ + + + +
|     | |     | |   | |   | |   |   | | | | |
+ + +-+ +-+ +-+ + + + + + + + + + + + +-+-+ +
| |   |   |   | | | | | | | | | | | |     | |
+ + + + +-+-+-+-+-+-+ + + +-+-+ +-+-+-+-+ + +
| | | |             | | |     |         | | |
+ +-+-+ + + +-+-+ + + +-+ + + + +-+ +-+-+-+-+
|     | | |     | | |   | | | |   |         |
+ +-+-+-+ + + +-+ + +-+ + + +-+-+ +-+ + + +-+
|       | | |   | |   | | |     |   | | |   |
+ + + + + +-+ +-+-+ + +-+-+ + + + +-+-+-+ + +
| | | | |   |     | |     | | | |       | | |
+ +-+-+ +-+-+-+-+ +-+-+ + +-+-+ +-+-+-+-+ + +
|     |         |     | |     |         | | |
+ + +-+ +-+-+-+-+-+ +-+-+ + +-+ + + + +-+ + +
| |   |           |     | |   | | | |   | | |
+ +-+ + + +-+ +-+-+-+ +-+ + + +-+-+ + + +-+ +
|   | | |   |       |   | | |     | | |   | |
+ + +-+ + + + +-+-+ + + +-+-+-+-+-+-+-+ + + +
| |   | | | |     | | |               | | | |
+ +-+ +-+-+-+-+-+-+ + + + +-+-+ + +-+ +-+-+ +
|   |             | | | |     | |   |     | |
+ + + + +-+-+-+ + +-+ +-+-+ + +-+-+-+ +-+ + +
| | | |       | |   |     | |       |   | | |
+-+-+-+-+-+-+-+-+-+-+-+-+-+-+-+-+-+-+-+-+-+-+