+-+-+-+-+-+-+-+-+-+-+-+-+-+-+-+-+-+-+-+-+-+-+-+-+-+-+-+-+-+-+-+-+-+
|     |   |         |     |   |           |   |       |           |
+-+-+ + + + +-+-+ + +-+ + + + + +-+-+ +-+ + + +-+ + + +-+ +-+-+-+ +
|   |   | |   |   |     | | | | |   |   |   |   | | |   | |   |   |
+-+ +-+-+ +-+-+ +-+-+-+-+ + + +-+ + +-+ +-+-+-+ +-+ +-+ + + + + +-+
|   |     |     |       | | | |   |     |     |     |   | | | |   |
+ +-+ +-+-+ +-+-+-+ +-+ + + + + +-+-+-+-+ + +-+-+-+-+ +-+ +-+ +-+ +
|   |       | |     |   | | |   |         |     |     | | |   |   |
+ + +-+-+-+-+ + + +-+-+-+ + +-+-+ +-+-+-+-+-+-+ + +-+-+ + + + + + +
| |   |       | |     |   |   | |   | |       | |   |   |   | | | |
+-+ + + +-+-+-+ +-+-+ + +-+-+ + +-+ + + + +-+ + +-+ +-+ + +-+-+ + +
|   |   |       | |   |   |   |   | |   |   | |   |   | | |     | |
+ +-+-+ + +-+-+-+ + +-+-+ + +-+ + + +-+ +-+ +-+-+ +-+ + + + + +-+-+
|     | | |       |   |   |   | | |   |   |     |     | | | | |   |
+ +-+ + + +-+-+ + +-+ + +-+-+ + + +-+ +-+-+-+ +-+-+-+-+ + + +-+ + +
|   | | |       |   |   |     | |     |     |     |       |     | |
+-+ + +-+-+-+-+-+-+ +-+-+ + +-+-+ +-+-+ +-+ +-+ + + +-+-+-+ +-+-+ +
| | |   |       |   | |   | |   |     |   |   | | | | |   |   |   |
+ + +-+ + +-+-+ + +-+ + +-+ + + +-+-+ +-+ +-+ +-+ + + + + + +-+ + +
| |   |   |   |   |   |   |   |     |   |   |   |     | | | |   | |
+ +-+ +-+-+ +-+-+-+ +-+-+ +-+-+-+-+ +-+ +-+ +-+ + +-+-+ + +-+ +-+ +
|     | |           |       |       |   |   | | | |   | |   |   | |
+ +-+-+ + +-+-+-+ + + +-+-+-+ +-+ +-+-+ + +-+ + +-+ + + +-+ + + +-+
| |     |   |   | |     |     |   |   |   |   |   | | | |   | |   |
+ + +-+-+-+ + + + +-+-+ + +-+-+ +-+ + +-+-+ +-+-+ + + + + +-+ +-+ +
| |   |     | | | |   | |   |   |   |   |       |   |   |   |   | |
+ + + + +-+-+ + +-+ + + +-+ +-+-+ +-+-+ +-+-+-+ +-+-+-+-+-+ + +-+ +
| | |   |     |     | |   |       |   |     |     |       | | |   |
+ + +-+-+ +-+-+-+-+-+ +-+-+-+ +-+-+ + +-+-+ + +-+ + + +-+ + +-+ + +
| |     | |   |     |       |   |   |     | | | | | |   | |   | | |
+ +-+-+-+ + + + +-+-+-+-+-+ +-+-+ +-+-+-+ + + + + + +-+ +-+-+ + + +
|       |   | |           | |     |   | |   | |   |   |     | | | |
+-+-+-+ +-+-+ + +-+-+-+ +-+ + +-+-+ + + +-+-+ +-+-+-+ +-+ +-+ + + +
|   |   |     | |       |   |   |   |     |   |     | | |     | | |
+-+ + +-+ +-+-+-+ +-+-+ + +-+-+ + + +-+-+-+ + + +-+ + + +-+-+-+ + +
|   |   |   |     |   | |   |   | | |     | | |   | | |   |     | |
+ +-+-+ + + +-+ +-+ + +-+-+ + +-+ +-+ +-+ + + +-+ + + + + +-+-+ +-+
|       | | |   |   |     |   | |     | |   |     | |   | |   |   |
+ +-+-+-+ + + +-+ +-+-+-+ +-+-+ + +-+-+ +-+-+-+-+-+ +-+-+ + + + + +
| |       | |           | |       |           |   |     |   | | | |
+ +-+-+ +-+ + +-+-+-+-+-+ + +-+-+-+ +-+ +-+-+ + +-+-+-+ +-+-+ +-+ +
| |   | |   | |   |   |   |     |     |     | |       |     | |   |
+ + + +-+ +-+ + + + + + + +-+-+ + +-+-+-+ + + +-+-+ + +-+-+ + + + +
|   | |   | | | | | |   |   |   |   |   | | |       | |   |   | | |
+-+-+ + +-+ + +-+ + + +-+-+ + +-+-+ + + +-+ +-+-+-+-+ + + +-+-+ + +
|   |   |     |   | | |   | | |   | | |   | |       | | |     | | |
+ +-+-+-+ +-+-+ + + +-+ + +-+ + +-+ + +-+ + +-+-+-+ + + + +-+ + + +
|         |     | |     |     |   | | |   | |     |   | | | | | | |
+ +-+-+-+-+-+ +-+-+-+-+-+-+-+-+-+ + + + +-+ + +-+ +-+ +-+ + + + + +
|         |   |       |     |     | | |     |   |   |     | | | | |
+-+-+-+-+ + +-+ + +-+ + +-+ + + +-+ + +-+-+-+ +-+-+ +-+-+-+ + + + +
|   |   | |     |   |   |   | |     |       | |     |   |     | | |
+-+ + + + + +-+-+-+ +-+-+ +-+ +-+-+-+ +-+-+ + + +-+-+ +-+ +-+-+ +-+
|   | | | | |     | |   | |     |   |   | |   | |     |   |       |
+ +-+ + + + + +-+ + + +-+ + +-+-+ + +-+ + +-+-+ +-+-+ + +-+-+-+-+ +
| |   |   |   |   | |   | |   |   |   |   |   |     | |   |       |
+ + +-+-+-+ +-+-+-+ +-+ + + +-+ +-+-+ +-+ + + + +-+ + +-+ + +-+-+ +
|   |   |   |       |   | | |   |   |   | | | | |   |     |   |   |
+ +-+-+ + +-+ +-+-+-+ +-+ +-+ +-+ +-+-+ +-+ + +-+ +-+ +-+-+-+ + +-+
|     |     | |       |   |   |   |   |   | |     | | |       |   |
+-+-+ +-+-+-+ + +-+ +-+ +-+ +-+ + + + +-+ + +-+-+-+ + +-+ +-+-+-+ +
|   |     |   |   |     |   |   | | |   | | |       |   | |     | |
+ +-+-+-+ + +-+-+-+ +-+-+ +-+ +-+-+ +-+ + + +-+-+-+ +-+ + + + +-+ +
|       | |       | |   | |   |     | | | |   |     |   | | |   | |
+ +-+-+ + +-+-+-+ + + + + + +-+ +-+-+ + + +-+ + +-+-+ +-+ + +-+ + +
|     |           |   |   |           |       |           |   |   |
+-+-+-+-+-+-+-+-+-+-+-+-+-+-+-+-+-+-+-+-+-+-+-+-+-+-+-+-+-+-+-+-+-+