+-+-+-+-+-+-+-+-+-+-+-+-+-+-+-+-+-+-+-+-+-+-+-+-+-+-+-+-+-+-+-+
| |     | |             |   |     |   |       |           |   |
+ + +-+ + + +-+-+ +-+ + + + + +-+ +-+ + + +-+ + +-+-+-+-+-+ + +
| | |   |   |   | |   | | | |   |   |   |   |   |           | |
+ + + +-+-+-+ + +-+ +-+ + + +-+ +-+ +-+-+-+ +-+ + +-+-+-+-+-+ +
| | | |       |   |   | | |   | | |   |   |   | |     |     | |
+ + + +-+ +-+-+-+ + + + + +-+ + + +-+ + + +-+ + +-+-+ + + +-+ +
| | |     |     | | | |   |     |       |     |     | | | |   |
+ + +-+-+-+ + +-+ +-+ +-+-+ +-+-+-+-+-+-+ +-+-+ +-+-+ + +-+ + +
| |   |     | |       |   |   |         | |   | |   | | |   | |
+ +-+ +-+ +-+ + +-+-+-+ + +-+-+ +-+-+-+ + + + + + + + + + +-+ +
|   |   |   |     |     |   |   |   |   | | | | | |     | | | |
+-+ +-+ +-+-+-+-+ + +-+-+-+ + +-+ +-+ +-+ + + +-+ +-+-+-+ + + +
| |   |     |   | | |   |   |   | |   |   | | |   |   |   | | |
+ +-+ +-+-+ + + + + + + + + +-+ + + +-+-+-+ + + +-+ +-+ +-+ + +
|   | |   |   | | | | | | |   | | |         |   |   |   |     |
+ + + + + +-+-+ +-+ + +-+ +-+-+ + +-+-+-+-+-+-+-+ + + +-+-+-+ +
| |   | | |   | |   |   | |     |   |             | |       | |
+ +-+-+ + + + + + +-+-+ + + +-+-+ +-+ +-+-+-+-+ +-+ +-+-+-+ +-+
| | |   | | | |       | | |   |     |   |       | |   |   |   |
+ + + + + + + +-+-+-+ + + +-+ + +-+ +-+ + + +-+-+ +-+ + +-+-+ +
| |   | |   | |   |     |     |   |     | | |   |     | |     |
+ +-+ + +-+-+ + + + +-+-+-+ +-+-+-+-+-+ + +-+ + +-+-+ + + +-+ +
|   | |   | |   | |   |   | |         | |     |     |   |   | |
+-+ +-+-+ + +-+-+ + +-+ + + +-+ +-+-+ +-+-+-+ +-+-+ +-+-+-+ +-+
| |       | |     | |   | |   | |   |       |   | |       |   |
+ +-+-+-+-+ + +-+-+-+ +-+ +-+ + +-+ +-+-+-+ +-+ + +-+-+ + +-+ +
|         | |   |     |   | | |   |       |   |   |     | |   |
+ +-+-+ + + +-+ + + +-+ +-+ + + + + +-+-+ +-+ +-+ + +-+-+-+ + +
| | |   |     | | |   |   | | | | | |   |   | |   |       | | |
+ + + +-+-+ +-+ + +-+ +-+ + + +-+ + +-+ +-+ + +-+-+-+-+-+ + +-+
|   |   |   |   |   | |   | | |   |   |   | |     |       |   |
+-+ +-+ +-+-+ +-+-+ + +-+ + + + +-+-+ +-+ + +-+-+ + +-+-+-+-+ +
| |   | |     |   | |   | |   | |   |     |       |   |       |
+ +-+ + + +-+-+ + +-+-+ + + +-+ + + +-+-+ +-+-+-+-+ + + +-+-+ +
| |   |   |     |   |   | |     | |     |       |   | | |   | |
+ + +-+-+-+-+ +-+-+ + +-+ +-+-+-+ +-+-+-+-+-+-+ + +-+ + +-+ + +
| |           |   |   |   |   |             | | |   | |   |   |
+ +-+-+-+-+-+-+ + +-+-+ +-+ + + +-+-+-+-+ + + + +-+-+ +-+ + +-+
|         |     | | |   |   | | |       | | | |   |     | |   |
+ +-+ +-+ +-+ +-+ + + +-+ +-+ + + +-+-+ + + + +-+ + +-+-+ +-+ +
|   |   |     |     | |   |   | | |   | | |   |   | |     |   |
+-+ +-+ +-+-+-+ +-+-+ + + +-+ + + +-+ + + +-+-+ +-+ + +-+-+ +-+
|   | | |     |   |   | |   | | |   | | |       |   | |   | | |
+ +-+ + + +-+ +-+ + +-+-+-+ +-+ +-+ + + +-+-+-+-+-+ + + + + + +
| |   | |   |   | |   |   | |   |   | | |         | | | | |   |
+ + + + +-+-+-+ + +-+ + + + + +-+ +-+ + + +-+ +-+ + + +-+ +-+ +
| | | |       |     |   | |   |   |   | |   |   |   |   |   | |
+ +-+ +-+-+-+ +-+-+-+-+-+ +-+ + +-+ + + +-+-+-+ +-+-+-+ + +-+ +
|     |   |   |   |     |   |   |   | |         |     | |   | |
+-+-+ + + + +-+ + + +-+ +-+ +-+-+ +-+-+ +-+-+-+-+ +-+ + + + + +
|   | | | |     |     |   | |   |       |   |     |   | | |   |
+-+ + + + +-+-+-+-+-+-+-+ + + + +-+-+-+-+ + + +-+-+ +-+ +-+ +-+
|   | | |     |   |     | |   |         | |   | |   |     |   |
+ +-+ +-+-+ + +-+ + +-+ + +-+-+-+-+-+-+ + +-+-+ + +-+-+-+ +-+-+
|   |       | |   | | |     |       |   | |     |       |     |
+ + +-+-+-+-+ + +-+ + +-+-+ + +-+-+ + +-+ + +-+ +-+-+-+ +-+ + +
| |   |     |   |   |     | |   |   | |   |   |       |   | | |
+-+ + +-+ +-+-+ + +-+-+ +-+ +-+ + +-+ + + +-+-+-+-+ + +-+ + + +
|   |     |     |     |     |   | |   | |         | |   | | | |
+ +-+-+-+-+ +-+-+-+-+ +-+-+-+ +-+ + +-+-+-+-+-+-+ + +-+ + +-+ +
|                   |           |                 |   |       |
+-+-+-+-+-+-+-+-+-+-+-+-+-+-+-+-+-+-+-+-+-+-+-+-+-+-+-+-+-+-+-+