+-+-+-+-+-+
|         |
+ + +-+-+ +
| |   |   |
+ +-+-+ + +
| |     | |
+ +-+ + +-+
|   | |   |
+-+-+ +-+ +
|     |   |
+-+-+-+-+-+