+-+-+-+-+-+-+-+-+-+-+-+-+-+-+-+-+-+-+-+-+-+-+-+-+-+-+-+-+-+-+-+-+-+-+-+
|                                                                     |
+ + + + + + + +-+ + + + + + + +-+ + + + + + +-+-+-+ + +-+-+ +-+ + + + +
| | | | | | | |   | | | | | |   | | | | | | |       |   |     | | | | |
+ + + + +-+ + + + + + + + +-+ +-+-+ + + + +-+ + + + + + + + +-+-+ + + +
| | | |   | | | | | | | | |     |   | | |   | | | | | | | | |     | | |
+ + + +-+ +-+-+-+ + + + + + +-+ + + + + +-+-+-+ + + +-+ +-+ + +-+ + + +
| | | |       |   | | | | |   | | | | |       | | |   | |   |   | | | |
+ +-+-+ +-+-+-+ +-+ + + +-+ +-+ + + + + +-+ +-+ +-+ + +-+ + + +-+ +-+ +
|     | |       |   | |   | |   | | | |   |   | |   | |   | |   | |   |
+ + + +-+ +-+ + + + + + + +-+ + + + +-+-+ + +-+-+ + +-+ + +-+ + + + + +
| | | |     | | | | | | |   | | | |     | |   |   |   | |   | | | | | |
+ +-+ + +-+ + + + +-+ + + + + +-+ + +-+ +-+ + +-+-+ +-+ + +-+-+-+ + + +
| |   |   | | | | |   | | | | |   | |     | | |       | |   |     | | |
+ + + + +-+-+ + + +-+ +-+ +-+-+ +-+ + +-+ + + + + + + + +-+-+-+ + + + +
| | | |     | | |   |   | |     |   | |   | | | | | | |   |     | | | |
+ +-+ + + +-+ + + + +-+ +-+ + + +-+ +-+ +-+-+ + + + + + + + +-+ + + + +
| |   | | |   | | |   | |   | | |   |       | | | | | | | | |   | | | |
+-+-+ + + + +-+ + + + +-+ + + +-+ + + +-+ +-+ + +-+-+ + + + + + + + + +
|     | | | |   | | | |   | | |   | |   |   | |     | | | | | | | | | |
+ + + + + + + + + +-+ + +-+ + +-+ + +-+ + + +-+ +-+ + +-+ + + + + + +-+
| | | | | | | | |   | | |   |   | | |   | | |   |   | |   | | | | |   |
+ + + +-+ + + + + + + + +-+ + + +-+-+ + +-+ +-+ + + + + + + +-+-+ + +-+
| | |   | | | | | | | |   | | |   |   |   |   | | | | | | | |     |   |
+ +-+ + + +-+-+-+-+ +-+-+ + + + + +-+ +-+ + +-+ + + + + + + +-+-+-+ + +
|   | | | |             | | | | | |     | |   | | | | | | |   |     | |
+ + +-+ + + + + + + +-+ +-+ + + + +-+ +-+-+ + +-+ +-+ + + +-+ + +-+-+ +
| | |   | | | | | | |     | | | | |       | |   |   | | | |   | |     |
+ + +-+ +-+-+ + + + + + + +-+ + +-+ +-+-+-+ + + +-+ + + +-+-+ +-+ + + +
| |   | |     | | | | | | |   | |         | | |   | | | |       | | | |
+ +-+ + + + + + + + + +-+-+-+ +-+-+ +-+ + +-+ + + + + +-+ + +-+-+ +-+ +
| |   | | | | | | | | |           | |   |   | | | | | |   | |       | |
+ + +-+ + +-+-+-+ +-+-+-+-+ + + + + +-+ + + +-+-+-+ + +-+ + + + +-+-+ +
| | |   |   |       |       | | | |   | | |       | |   | | | |   |   |
+-+-+ + + + + + + + +-+ +-+ +-+ + + + +-+ +-+ +-+ + +-+ +-+ +-+-+ +-+ +
|     | | | | | | |   | |     | | | |   | |     | |   |   |     |   | |
+-+ + + + + + + + + +-+ + + + +-+ +-+-+ +-+ + + + + + + + + + + + + + +
|   | | | | | | | | |   | | |   |   |     | | | | | | | | | | | | | | |
+ +-+ + + +-+ + +-+ + + +-+ + + + + +-+-+ + + + + + +-+ + +-+-+ +-+ + +
|   | | | |   | |   | |   | | | | | |     | | | | | |   |     |   | | |
+ + + + +-+-+ +-+ + + +-+-+ + + + +-+ +-+ + + + + + + + +-+ + +-+-+-+ +
| | | |     | |   | | |     | | | |     | | | | | | | | |   |   |     |
+ +-+ + +-+ + + + +-+ +-+ +-+ + +-+ + + + + +-+ +-+ + +-+-+ + + +-+ + +
|   | |   | | | |   |   | |   |   | | | | | |   |   | |     | |   | | |
+-+ +-+ + +-+ + +-+ + + +-+ + +-+-+ + + + + +-+-+-+ + +-+ + + + + + + +
|     | |   | | |   | |   | | |     | | | |       | |   | | | | | | | |
+ +-+ + + + + + + + + +-+-+ + +-+ +-+ + + +-+ + + + + + + + +-+-+-+ +-+
|   | | | | | | | | |     | |   | |   | |   | | | | | | | | |         |
+ + +-+ + +-+-+-+-+ + + +-+ + + + + + +-+-+ + + +-+ + + + +-+ + + + + +
| |   | |         | | | |   | | | | |     | | | |   | | | |   | | | | |
+ + +-+ +-+-+-+-+ +-+ + +-+ + +-+ + + + + +-+ + + + +-+ + + + +-+ + + +
| | |           |   | | |   |   | | | | | |   | | | |   | | | |   | | |
+ + +-+ + + + + + +-+-+ + + + +-+ +-+ +-+ + +-+ + + + + +-+-+ + + +-+-+
| |   | | | | | | |     | | |   |   | |   |   | | | | |     | | |     |
+-+-+ + +-+ +-+ + + + + +-+ +-+-+ + + + +-+ +-+ +-+ + +-+-+ + + +-+ + +
|     |   |   | | | | |   |     | | | | |     |   | |     | | |   | | |
+ + +-+ + + +-+ + +-+ + + + +-+-+ + +-+ + + + + + + + + +-+ + + + + +-+
| | |   | |   | |   | | | | |     | |   | | | | | | | |   | | | | |   |
+-+-+ + + +-+-+ +-+-+ + +-+ + + + + +-+-+ +-+ + + + +-+ + + + + + +-+ +
|     | |   |     |   |   | | | | |     |   | | | |   | | | | | |   | |
+ + + + + + + + + +-+ +-+ + + + + + + + + +-+-+ + + + + + +-+ +-+ + + +
| | | | | | | | | |   |   | | | | | | | | |     | | | | | |   |   | | |
+ + + +-+-+ + + + + + + + +-+-+ +-+ + + + + + + + + + + + +-+ + + +-+ +
| | | |     | | | | | | | |       | | | | | | | | | | | | |   | | |   |
+ + + + + + +-+ + + + + + + + + +-+ + + + + + + + +-+-+ + + +-+-+ +-+ +
| | | | | |   | | | | | | | | |   | | | | | | | |   |   | | |     |   |
+ +-+-+ + + +-+ + + +-+ + +-+-+-+ + + + +-+ +-+ + + +-+ + + +-+ +-+ + +
|     | | | |   | |   | | |       | | | |   |   | |   | | | |   |   | |
+ + +-+ + + + +-+ + + + + + + +-+-+-+-+ + + + + + + + +-+ + + + +-+ + +
| | |   | | |   | | | | | | | |         | | | | | | |   | | | |   | | |
+-+-+-+-+-+-+-+-+-+-+-+-+-+-+-+-+-+-+-+-+-+-+-+-+-+-+-+-+-+-+-+-+-+-+-+