+-+-+-+-+-+-+-+-+-+-+-+-+-+-+-+-+-+-+-+-+-+-+-+-+-+-+-+-+-+-+-+-+-+-+-+-+-+-+-+-+-+-+-+-+-+-+-+-+-+-+
|                                                                                                   |
+ +-+ +-+ + +-+-+-+ + +-+ + +-+ +-+-+ + +-+ + +-+-+ +-+ +-+-+-+ + + + +-+-+ +-+-+-+-+ + +-+-+ +-+-+ +
|   |   | |       | |   | |   |     | |   | |     |   |       | | | |     |         | |     |     | |
+ +-+-+-+ +-+-+-+ + +-+ +-+-+ + + + + + +-+-+-+ + +-+ +-+-+-+-+-+ +-+ +-+ + +-+-+-+-+ +-+ +-+ + + + +
|       |       | |   |     | | | | | |       | |   |           |   |   | |         |   |   | | | | |
+ +-+ + + + + + +-+ + +-+-+-+ +-+-+ + + + +-+-+ + + +-+-+-+-+-+ + +-+ + + + + + +-+-+-+ + + + + +-+-+
|   | | | | | |   | |       |     | | | |     | | |           | |   | | | | | |       | | | | |     |
+ +-+-+ +-+-+ +-+ + + +-+-+ + + + +-+ +-+ +-+ +-+-+-+-+ + +-+ + + +-+-+ + + + + + +-+ +-+-+ + +-+ +-+
|     |     |   | | |     | | | |   |   |   |         | |   | | |     | | | | | |   |     | |   |   |
+ +-+ +-+-+ + +-+-+-+ +-+ +-+-+ +-+-+ + +-+-+-+ +-+ + + +-+-+ + +-+-+-+-+ +-+ + + + + +-+ +-+ + +-+-+
|   |     | |       |   |     |     | |       |   | | |     | |         |   | | | | |   |   | |     |
+ +-+-+ +-+ +-+-+-+-+ + +-+-+-+ + +-+-+-+-+ + + +-+-+ +-+ +-+-+-+ +-+-+-+ + + +-+ +-+-+-+ + +-+ + + +
|     |   |         | |       | |         | | |     |   |       |       | | |   |       | |   | | | |
+ +-+ +-+ + +-+ + +-+ +-+-+-+-+-+-+ +-+ + +-+-+-+-+-+-+ +-+ +-+ +-+ +-+-+ + + +-+-+-+ +-+ +-+-+ +-+-+
|   |   | |   | |   |             |   | |             |   |   |   |     | | |       |   |     |     |
+ + +-+-+ + + +-+-+-+ + +-+ +-+-+ + +-+-+-+ + +-+-+ + +-+ +-+ + + + + +-+-+-+ + + + + +-+-+-+-+ +-+-+
| |     | | |       | |   |     | |       | |     | |   |   | | | | |       | | | | |         |     |
+ + +-+-+ +-+-+-+ +-+ +-+-+-+-+-+-+ + +-+-+ + + + +-+-+ +-+ +-+ +-+-+-+-+-+ +-+ + +-+ + + +-+ + +-+ +
| |     |       |   |             | |     | | | |     |   |   |           |   | |   | | |   | |   | |
+ + + + + +-+-+-+-+-+ + +-+ + + + +-+ +-+-+ + +-+-+-+ +-+-+-+-+-+ + + + +-+ + + + +-+ + +-+-+-+-+-+ +
| | | | |           | |   | | | |   |     | |       |           | | | |   | | | |   | |           | |
+ +-+-+ + +-+-+-+ + + + + + +-+-+-+ +-+ + + + +-+-+ +-+ + + +-+-+-+-+ +-+-+ +-+-+-+ + +-+-+ +-+ + + +
|     | |       | | | | | |       |   | | | |     |   | | |         |     |       | |     |   | | | |
+ +-+ + +-+-+-+ +-+ + +-+ + +-+-+ + +-+ + + + + + +-+ + + +-+-+-+ +-+-+-+-+-+-+-+ + + + +-+ + +-+ + +
|   | |       |   | |   | |     | |   | | | | | |   | | |       |               | | | |   | |   | | |
+ +-+ +-+ + +-+ + + + + + +-+ +-+ + +-+-+ +-+-+-+ +-+-+ +-+ + + + + +-+-+-+ + +-+-+-+ + +-+ +-+-+-+-+
|   |   | |   | | | | | |   |   | |     |       |     |   | | | | |       | |       | |   |         |
+ + + +-+ + + + + +-+ + + +-+-+-+-+ + +-+ +-+-+-+-+ + + + + + +-+ + +-+ +-+ + +-+-+ + +-+ +-+-+-+ + +
| | |   | | | | |   | | |         | |   |         | | | | | |   | |   |   | |     | |   |       | | |
+ +-+-+-+-+ + + + + +-+-+ + + +-+-+ + + +-+ + + + + +-+ +-+-+-+ +-+ +-+-+ + + + + +-+ +-+-+ + +-+ + +
|         | | | | |     | | |     | | |   | | | | |   |       |   |     | | | | |   |     | |   | | |
+ +-+ +-+ +-+-+ +-+-+ + + + + + + + + +-+ + + +-+ +-+ +-+ +-+-+-+-+-+-+ + +-+-+-+ +-+ + + +-+ +-+ +-+
|   |   |     |     | | | | | | | | |   | | |   |   |   |             | |       |   | | |   |   |   |
+ +-+ + + + + +-+ + +-+ + + +-+-+ + + + +-+ + +-+-+ + +-+-+-+ +-+ + + + + +-+-+ + + + +-+ +-+ +-+-+ +
|   | | | | |   | |   | | |     | | | |   | |     | |       |   | | | | |     | | | |   |   |     | |
+ + +-+-+ +-+ +-+-+-+-+-+ + + +-+-+-+-+-+-+ +-+-+ +-+-+ + + +-+-+-+-+-+ + +-+-+ +-+ + + +-+-+-+-+ + +
| |     |   |           | | |             |     |     | | |           | |     |   | | |         | | |
+ +-+-+ + +-+ + +-+-+ +-+ +-+-+ +-+ + +-+ +-+-+-+-+-+-+-+ + + +-+-+-+-+ + + + + +-+ + +-+-+-+ + +-+-+
|     | |   | |     |   |     |   | |   |               | | |         | | | | |   | |       | |     |
+ + +-+-+-+ + +-+-+ + + +-+ + +-+-+ +-+-+-+ +-+ +-+-+ +-+-+-+-+-+-+ +-+-+-+-+-+-+ +-+-+ + + + + +-+-+
| |       | |     | | |   | |     |       |   |     |             |             |     | | | | |     |
+ + +-+-+-+-+ +-+-+ + + +-+ +-+-+-+ + + + +-+-+ + + + + + +-+ + + +-+-+-+-+ + +-+-+ + +-+-+-+-+ + + +
| |         |     | | |   |       | | | |     | | | | | |   | | |         | |     | |         | | | |
+ + + + +-+ +-+-+-+ + + + +-+ +-+-+-+-+ + + + + +-+ +-+ +-+-+ +-+ + +-+-+ + +-+-+-+-+ + + + +-+-+-+ +
| | | |   |       | | | |   |         | | | | |   |   |     |   | |     | |         | | | |       | |
+ + +-+-+ +-+ + + + + +-+-+ + +-+ + + + +-+-+-+-+ + +-+ + +-+-+-+-+-+-+-+ + + +-+ + +-+-+ + +-+ +-+ +
| |     |   | | | | |     | |   | | | |         | |   | |               | | |   | |     | |   |   | |
+ + + + +-+-+ + + +-+ +-+-+-+-+-+-+-+-+-+ +-+-+ + +-+-+ +-+-+-+ +-+ + +-+ + + +-+ +-+ + +-+-+-+ +-+-+
| | | |     | | |   |                   |     | |     |       |   | |   | | |   |   | |       |     |
+ + + +-+-+-+-+ + +-+ +-+ +-+-+-+-+-+-+ +-+ + +-+-+ + + + +-+ +-+ +-+-+-+ +-+ + + + + +-+ + +-+-+ + +
| | |         | |   |   |             |   | |     | | | |   |   |       |   | | | | |   | |     | | |
+ + + +-+-+ +-+ + +-+-+ + +-+-+ +-+-+-+-+-+ + + +-+-+ + + +-+-+ + +-+-+-+ +-+-+ +-+ + + + + + +-+-+-+
| | |     |   | |     | |     |           | | |     | | |     | |       |     |   | | | | | |       |
+ + + +-+ +-+-+-+-+-+-+-+-+ + + +-+-+-+ + + +-+-+ +-+ + + +-+ + + +-+-+ + + +-+-+-+ +-+-+-+ + + +-+ +
| | |   |                 | | |       | | |     |   | | |   | | |     | | |       |       | | |   | |
+ +-+-+ + + + +-+ +-+ + + + + + +-+-+-+-+-+ +-+ +-+ +-+ +-+ + + + +-+-+ + + + + +-+-+-+-+-+-+ +-+ + +
|     | | | |   |   | | | | | |           |   |   |   |   | | | |     | | | | |             |   | | |
+ +-+ +-+ + + +-+-+ +-+-+ +-+ +-+ + +-+-+-+ + + + +-+ +-+ + +-+ +-+-+-+ +-+-+ +-+ +-+-+ + +-+-+ +-+-+
|   |   | | |     |     |   |   | |       | | | |   |   | |   |       |     |   |     | |     |     |
+ + + + +-+ + +-+ +-+ +-+-+ +-+ +-+-+ +-+ + + + + + +-+-+ + + +-+-+ +-+ + + +-+-+-+ + +-+-+ +-+-+ + +
| | | |   | |   |   |     |   |     |   | | | | | |     | | |     |   | | |       | |     |     | | |
+ +-+-+ + + + +-+ + +-+ +-+-+-+-+-+-+ +-+ + + + +-+-+ +-+ + +-+-+-+ + +-+-+-+-+-+ +-+ + +-+ + + + + +
|     | | | |   | |   |             |   | | | |     |   | |       | |           |   | |   | | | | | |
+ + +-+ +-+-+-+-+ + +-+-+ + + +-+-+ +-+-+ +-+-+ +-+ + + + +-+ + + + + + +-+-+ + +-+-+-+ + +-+-+ + + +
| |   |         | |     | | |     |     |     |   | | | |   | | | | | |     | |       | |     | | | |
+ + +-+-+ +-+-+-+-+-+-+-+-+-+-+ + +-+ +-+ +-+-+-+ + + + + +-+ + +-+ +-+ +-+-+ + + + +-+ +-+ + +-+ +-+
| |     |                     | |   |   |       | | | | |   | |   |   |     | | | |   |   | |   |   |
+ +-+ +-+ + +-+-+-+ +-+-+ + +-+ + +-+-+-+ + + +-+ + + +-+ +-+ +-+-+-+ + + +-+ + + +-+-+ +-+-+ +-+ + +
|   |   | |       |     | |   | |       | | |   | | |   |   |       | | |   | | |     |     |   | | |
+ + +-+ + + +-+ + +-+-+ +-+ +-+-+ +-+-+ +-+-+ + + + + + +-+ +-+ + +-+ +-+-+-+ +-+-+ +-+-+ +-+ + +-+ +
| |   | | |   | |     |   |     |     |     | | | | | |   |   | |   |       |     |     |   | |   | |
+ +-+-+-+ + +-+ + +-+-+-+-+ +-+-+-+-+ +-+ + + + +-+-+-+-+ + +-+ +-+-+-+-+ + + + +-+ +-+-+ +-+-+-+-+ +
|       | |   | |         |         |   | | | |         | |   |         | | | |   |     |         | |
+ +-+-+-+-+-+-+ +-+-+ +-+ +-+-+-+ + + +-+ + + +-+ + + +-+ +-+-+ + + + + + +-+-+ +-+ + +-+ +-+-+-+ +-+
|             |     |   |       | | |   | | |   | | |   |     | | | | | |     |   | |   |       |   |
+ + + + + +-+-+-+ + +-+-+ +-+ +-+ +-+-+-+-+ +-+ +-+ + + + +-+ + + + + +-+-+ +-+-+ + + + + +-+ +-+-+-+
| | | | |       | |     |   |   |         |   |   | | | |   | | | | |     |     | | | | |   |       |
+ + +-+ +-+-+ + +-+-+ + +-+ + + +-+ +-+-+-+-+ + +-+-+ +-+-+ +-+ +-+ +-+ +-+ +-+-+ + + + + + + +-+-+-+
| |   |     | |     | |   | | |   |         | |     |     |   |   |   |   |     | | | | | | |       |
+ + + +-+-+ + + +-+ +-+-+-+-+-+-+-+-+-+ + + + + +-+-+ +-+-+-+-+-+-+-+-+ + +-+-+ +-+-+-+ +-+-+ + +-+-+
| | |     | | |   |                   | | | | |     |                 | |     |       |     | |     |
+ +-+ + + + +-+-+ + +-+-+ + + + +-+ +-+-+-+ + + +-+-+ +-+ + +-+ + +-+ +-+ +-+-+ + +-+ +-+ + +-+ + +-+
|   | | | |     | |     | | | |   |       | | |     |   | |   | |   |   |     | |   |   | |   | |   |
+ + +-+ +-+ +-+-+-+ +-+-+-+-+-+-+-+-+ +-+ +-+ +-+-+-+ +-+ + + + + + + + +-+-+-+ + + + +-+ +-+-+-+-+-+
| |   |   |       |                 |   |   |       |   | | | | | | | |       | | | |   |           |
+ + + +-+-+ +-+-+ + +-+ + + +-+-+ + + + + +-+ +-+-+ + +-+ +-+ +-+-+-+-+-+-+-+-+ +-+-+ +-+ +-+-+ +-+-+
| | |     |     | |   | | |     | | | | |   |     | |   |   |                 |     |   |     |     |
+ + + +-+ +-+-+-+-+-+ +-+ +-+ +-+ + +-+-+-+-+ +-+ + + + +-+-+-+ + + +-+-+-+ + +-+-+-+ +-+ +-+ + +-+-+
| | |   |           |   |   |   | |         |   | | | |       | | |       | |       |   |   | |     |
+ + +-+ +-+ + + +-+-+ +-+-+ + +-+ +-+ + + + +-+ +-+ + + +-+ + + +-+ +-+ +-+-+-+-+-+ +-+ + + +-+ + + +
| |   |   | | |     |     | |   |   | | | |   |   | | |   | | |   |   |           |   | | |   | | | |
+ +-+-+-+-+ +-+-+ + +-+-+ + + +-+-+-+ + +-+ +-+-+-+-+-+ + + +-+ + +-+-+ + +-+ + +-+-+-+ +-+ + +-+ +-+
|         |     | |     | | |       | |   |           | | |   | |     | |   | |       |   | |   |   |
+ + + +-+-+-+ + +-+-+ + +-+ + + +-+-+ + +-+ +-+ + +-+ +-+ + + +-+-+-+-+ +-+-+ +-+ +-+ +-+-+ + + +-+-+
| | |       | |     | |   | | |     | |   |   | |   |   | | |         |     |   |   |     | | |     |
+ +-+-+ +-+ +-+ +-+ + +-+ +-+ +-+-+-+ +-+ +-+-+-+-+-+ + +-+ +-+-+-+ + +-+-+-+-+-+-+ +-+ + +-+-+ +-+ +
|     |   |   |   | |   |   |       |   |           | |   |       | |             |   | |     |   | |
+ +-+ +-+ +-+ + + +-+-+-+-+-+ +-+-+ +-+-+-+-+ + +-+ + +-+ + + + +-+ +-+ +-+-+ + +-+-+-+ +-+ +-+ + +-+
|   |   |   | | |           |     |         | |   | |   | | | |   |   |     | |       |   |   | |   |
+-+-+-+-+-+-+-+-+-+-+-+-+-+-+-+-+-+-+-+-+-+-+-+-+-+-+-+-+-+-+-+-+-+-+-+-+-+-+-+-+-+-+-+-+-+-+-+-+-+-+