+-+-+-+-+-+-+-+-+-+-+-+-+-+-+-+-+
|     |     | |         |     | |
+-+ +-+-+-+ + + +-+ +-+ + +-+ + +
|             |   | |   | |     |
+-+-+ + +-+-+ + +-+-+ + + + +-+-+
| | | |   |   |   |   | | |   | |
+ + + + +-+-+ + +-+-+ +-+ +-+ + +
|   | | |   | |   | | |   |     |
+-+ +-+ +-+ + + +-+ + + +-+-+ + +
|       | | | |   |   |   | | | |
+ +-+-+ + + +-+-+ + +-+-+-+ + +-+
|   |   | | | | | | | | | |     |
+-+ +-+ + + + + + +-+ + + + +-+ +
|   | |     |     |         |   |
+ + + + +-+ + +-+-+-+-+ +-+ + +-+
| | |     | |     |       | |   |
+ +-+-+-+-+ + +-+ +-+-+ +-+-+-+ +
|   |           |     |       | |
+ +-+ + + + +-+-+ + + + + + + +-+
|   | | | |   |   | | | | | | | |
+-+-+-+ +-+-+ +-+-+-+ + +-+-+-+ +
|       |         |   |   | |   |
+-+-+-+ +-+-+-+-+ +-+-+-+ + + +-+
|           |     |     |       |
+ +-+-+-+-+ +-+-+ + +-+-+ +-+ + +
|   |           |         | | | |
+-+-+-+ +-+ +-+-+ +-+-+ +-+ +-+-+
|     | |       |   |       |   |
+ + + + + +-+-+-+-+ +-+ +-+ +-+ +
| | |   |   |         | | |     |
+-+ + + +-+-+-+ +-+ +-+-+ + +-+ +
|   | | |       |     |       | |
+-+-+-+-+-+-+-+-+-+-+-+-+-+-+-+-+