+-+-+-+-+-+
|         |
+ + + + + +
| | | | | |
+-+ + + + +
|   | | | |
+ + + + + +
| | | | | |
+ + + + +-+
| | | |   |
+-+-+-+-+-+