+-+-+-+-+-+-+-+-+-+-+-+-+-+-+-+-+-+-+-+-+-+-+-+-+-+-+-+-+-+-+-+-+-+-+-+-+-+-+-+-+-+-+-+-+-+-+-+-+-+-+
|   | | |   | |   |   | | |   |               |   |   |   |   |     |     |   |     | | |   | |     |
+ +-+ + +-+ + +-+ + + + + +-+ +-+-+-+-+ + + + + +-+-+ + +-+-+ + + +-+ +-+-+-+ + +-+-+ + + + + + +-+ +
|   |     |         |     |   |   | | | | | |     |       |     |     |     | |     | |   |       | |
+-+ +-+-+ +-+ + + +-+ + + + +-+ + + + +-+ +-+ +-+-+ + + +-+ +-+-+ +-+-+ + + + +-+ +-+ +-+ +-+-+-+ + +
|           | | |   | | | | |   | |   |     |     | | |     |   |       | | |     | |   |       | | |
+-+-+-+ +-+-+-+-+ +-+-+-+ + +-+-+ + + + + +-+ + +-+-+ +-+-+-+ + +-+ +-+-+-+ + +-+-+ +-+ +-+-+-+-+ +-+
| |       |   | |   |   | |   |   | | | | |   |     |         |   |     |   |     | |   |         | |
+ +-+-+ +-+-+ + +-+ +-+ + + + + +-+ + + +-+-+ +-+ + + +-+-+ + +-+ + +-+ + + + + +-+ + + + + + +-+-+ +
|     | |   |   |   | |     |   |   |     |     | |     |   | | | | |   | |   |     | | | | | | |   |
+-+ +-+ +-+ + +-+-+ + +-+ +-+ +-+-+-+ + + +-+ +-+-+-+ +-+ +-+-+ + + +-+ +-+-+-+ +-+ + +-+ +-+-+ + +-+
|         | | |   | | |   | |   |     | | | | | |       | |       | |   |         | | | |     |     |
+-+ +-+ + + + + + + + + +-+ + + +-+-+-+-+-+ +-+ +-+-+ +-+ + +-+ +-+ + +-+-+-+ + +-+ + + + + +-+ + + +
|   |   | |   | | | |     | | |   |   |   | | |   | | | | |   | |   | | | |   |   |     | | |   | | |
+-+-+-+-+ +-+ + + +-+-+-+ + +-+-+ +-+ +-+ + + + +-+ +-+ +-+-+ + +-+-+-+ + +-+-+-+ +-+ + + + + + +-+-+
|         | |   |     |     |   | |       | |                 | |       | |     | |   | | |   |     |
+ +-+-+ +-+ + +-+-+-+ +-+ +-+-+ +-+-+ +-+-+ +-+-+-+ + +-+-+ +-+-+-+ +-+-+ + +-+ + +-+ +-+ + + + + + +
| | |           |   |       | |   | |       |   |   |   | |   | | |   |   | | | |   | |   | | | | | |
+ + + + + +-+-+ + +-+ +-+-+ + +-+ + + +-+-+ +-+ + + + +-+ +-+ + + + + + +-+ + +-+-+-+ +-+-+-+-+-+ +-+
| |   | |   |   | | |     |     |         | |   | | |   |   | |   | |               |   |       |   |
+-+ +-+-+-+ +-+ + + +-+ +-+-+ +-+-+-+ + + +-+ +-+ + + + + +-+ + + + +-+-+-+-+ +-+ + +-+ +-+-+-+ + + +
|   |   | | | |     | | |     |   | | | | |       | | |     | | |   | | |     |   | |       | | | | |
+ +-+ +-+ +-+ +-+ + + + +-+ +-+ +-+ +-+ +-+ + +-+-+-+-+ +-+-+ +-+ + + + +-+-+-+-+ +-+ +-+-+-+ + + +-+
|   |   | |   | | | | | |         |       | | | |   |       | |   | |     | |   |         |   |     |
+-+-+ +-+ +-+ + +-+ + + +-+ +-+ +-+-+-+ + + +-+ +-+ +-+ +-+-+-+-+ +-+-+-+ + + +-+ +-+-+-+ + +-+-+ +-+
|     |           |   | |   | |   |   | | |   |   | |         |   |       |   |   |     | |   |     |
+-+ +-+-+-+-+ +-+-+-+-+ + +-+ + +-+ +-+-+ +-+-+ +-+ +-+-+ + +-+-+-+ +-+ +-+ + + +-+-+-+ + +-+ +-+ +-+
| | |   |   | | | |   | |   |   |   |       |   |   |   | | | | |   | |   | |   |       |   |     | |
+ + + + + +-+ + + + + +-+ + +-+ + +-+ +-+-+-+ + +-+ + + + +-+ + +-+ + +-+-+-+-+-+ +-+-+-+ +-+-+ + + +
| |   |   |     |   |     | |   |         | | |       |   |     |     |       |     |   |   |   |   |
+ + +-+-+ + +-+ +-+-+ +-+-+-+ +-+ +-+-+-+ + +-+-+-+ +-+ + +-+ +-+-+ + + + + +-+-+-+ + + +-+-+ +-+ + +
|   |   |   | |         | |     |   |         |     |   |     |     | | | |   | |     |       |   | |
+ +-+-+ +-+-+ +-+ +-+ +-+ +-+-+-+ +-+ +-+ +-+-+-+ + +-+-+-+-+-+ +-+ +-+ +-+-+-+ +-+ + +-+-+-+ +-+-+-+
| |               | |     | |   | |   |   | | |   |   |   | | | | |   |   |   |   | |   | |   |     |
+ +-+ +-+-+-+ + +-+ + + +-+ +-+ + +-+ +-+-+ + +-+-+ +-+ +-+ + +-+ + + +-+ + +-+ + +-+ +-+ + +-+ +-+-+
|   |       | |   | | |     | | | |       |                 |       |   |   |   | |   |       | |   |
+ +-+ +-+-+-+-+-+ + + +-+-+ + + + +-+ +-+ +-+ + +-+-+ +-+ +-+-+-+-+ + + +-+ +-+ +-+ + +-+-+-+-+ + + +
|   | |   |     | |       |   | |   | |   |   |     |   | |   |     | |     | |     |   |   |   | | |
+ +-+ + +-+-+ +-+-+-+-+ +-+-+ + + +-+ +-+ +-+ + +-+ +-+ +-+ + + +-+-+-+-+-+ + +-+ +-+-+-+ + +-+ + +-+
|   |     |   | |       | |     |   |   |     |   | |       |         | | |     |     | | |         |
+ +-+-+ + +-+ + +-+-+ +-+ +-+-+ +-+-+-+ +-+-+ + +-+ +-+-+ +-+ +-+-+ +-+ + +-+-+ + +-+ + + +-+ + + +-+
|   | | |   |     |       |   | |   |     |   |   |     |   |     | |   |   |   |   | | | |   | |   |
+ +-+ + +-+-+ +-+-+-+ + +-+ +-+ + +-+ + + +-+-+ +-+ +-+ +-+-+-+ +-+ + +-+-+ +-+-+-+-+ + +-+ +-+ +-+ +
| | | |   |     | | | | | |           | | | |     | |   |   |     | |             |         |   |   |
+ + + +-+-+ +-+-+ + +-+-+ + +-+-+ + +-+-+ + + + +-+ +-+-+-+ +-+-+ + + +-+-+ +-+-+-+-+ +-+-+ + +-+-+-+
|     |           |     |   | |   |     |   | | |   | |     | |   |   |     | |   | |     | | |   | |
+-+ +-+-+-+-+ +-+ + + +-+ +-+ +-+ +-+-+-+-+-+ + +-+ + + + +-+ + +-+ +-+-+ + + +-+ + +-+-+ +-+-+ + + +
| | |           | | |   |     |           |   | |     | | |   | | |   |   |   |   |         |   |   |
+ +-+-+-+ +-+-+-+ + +-+-+ +-+-+-+ + + +-+-+ +-+-+-+-+-+-+ + + +-+ +-+-+-+-+-+ +-+ +-+ +-+ +-+-+ +-+ +
|   |     |       |       |   |   | |   |   | |         | | | |             |     |   |     |     | |
+-+ + +-+-+ +-+-+ + + + + + +-+-+ + +-+ + +-+ + +-+-+-+ + +-+ +-+-+-+-+-+ +-+-+-+ +-+-+-+ +-+-+-+ +-+
|   | |   |     | | | | | | |   | | | | |         | |       | |     |     |   |   |   |   | |   |   |
+ +-+ + +-+-+-+-+ + +-+-+-+ + +-+-+-+ +-+-+ +-+ +-+ +-+-+-+-+ +-+ +-+ +-+ + + +-+ +-+ +-+ + + + + + +
| |             |     | |           | | | |   |   | |           | |   | | | |   |           | | | | |
+ + +-+-+ +-+ +-+ + +-+ +-+ +-+-+ + + + + +-+-+ +-+ +-+ + + +-+ + + + + + + +-+-+ + +-+ +-+-+-+ + +-+
|       | |   | | |         |     |   | |   | |   |     | | | |   | | |   | |   | |   | |   |     | |
+ +-+-+-+ +-+ + +-+ +-+-+ +-+-+-+-+ +-+ + +-+ +-+ + +-+-+-+ + +-+-+ +-+-+ + + +-+-+-+ + + +-+ +-+-+ +
|       |   |   |     | |         |   | | | |   |   |     | |       |       |   |     | |     | |   |
+ +-+-+-+-+-+-+-+-+ + + + +-+-+-+-+ +-+ + + +-+ + +-+ + + + + +-+ +-+ +-+-+-+ + +-+-+-+-+-+ +-+ + +-+
|   | | | | |       |   | |         |             |   | | |   |   | |   | |   |         |           |
+-+ + + + + + + +-+ + + +-+-+ + +-+-+-+-+-+-+-+ + +-+-+ +-+-+ + +-+ +-+ + + +-+-+-+-+ +-+ +-+-+ +-+ +
|     |     | |   | | | |   | | |   | | | |   | | | |     |   | | |       |   | |   | | | |   | |   |
+ + + +-+ +-+-+-+ +-+ +-+-+ + + + + + + + +-+ + +-+ +-+ +-+-+-+ + +-+-+-+ + +-+ +-+ +-+ + +-+ + +-+ +
| | | |   |       |     |   | |   | |   | |       | | | |       | |       |           | | |     | | |
+ + +-+ +-+ + +-+ +-+-+-+ +-+-+ +-+-+ +-+ + +-+ + + + + +-+-+ +-+ + +-+ + +-+-+-+ +-+-+ +-+ + +-+ + +
| | |       | | |   |     | | |       |   | | | | |     |     |     | | | |         | | |   | | |   |
+-+-+-+ +-+-+-+ + +-+-+-+ + + +-+-+-+ +-+ + + +-+ + + +-+-+ +-+-+ + + + +-+-+ +-+ + + + + +-+ + +-+ +
|   |       |   |   |             | |   | | |   |   | |     | |   |   | |   |   | |   | | |     |   |
+ +-+ +-+-+ +-+ +-+ + + +-+ +-+ +-+ +-+-+ + + +-+-+-+-+-+ + + +-+-+-+ + +-+ + + +-+ + + + + + +-+-+ +
|   | |   | | |       |   |   |       |     |     |     | | |       | | | |   |   | |     | |   |   |
+ + + +-+ +-+ + + + +-+-+-+-+ +-+ +-+-+ + + + + +-+-+ +-+ +-+-+-+-+ + +-+ +-+ +-+ + +-+ +-+ +-+-+-+ +
| |     |   |   | |         | | |     | | | | |       |       |     |     |     | | | | |     |   | |
+-+ + +-+ +-+ + +-+ + +-+ +-+ + +-+ + +-+-+ +-+-+ +-+-+ +-+ +-+-+ +-+ + +-+-+ + + +-+ +-+-+ + + +-+-+
|   |   |   | | | | |   | | | |     |   |   | |     |     |         | |       | | |   | | | | |   | |
+ +-+-+ + +-+ +-+ +-+-+-+ + + +-+ +-+-+ +-+-+ +-+ + +-+ + +-+-+ + +-+-+-+-+ +-+-+ +-+ + + +-+ + +-+ +
| |   |   | | |       |     | |   |           |   | |   |   | | |         |     | | |       |       |
+ + +-+-+ + +-+-+ + +-+ +-+-+-+ +-+-+-+-+ +-+-+-+-+ + +-+ + + +-+ +-+ +-+ + +-+-+-+ + + +-+-+-+ +-+-+
|   | | | | | |   |   |   | |   |   |   |     | |   |   | |     | | | |   | |       | | |     |     |
+-+ + + + + + +-+ + +-+ + + + +-+ + + +-+-+ +-+ +-+ +-+ +-+ +-+-+-+ +-+-+ + + +-+ +-+-+ +-+-+ +-+ + +
| | |   |   |     | |   | |   |   |       |   | |         |   | |     | | |   | |     |           | |
+ +-+ + + +-+ + +-+-+ + + + +-+-+ + +-+-+ + + + +-+ + + + +-+-+ + + + + +-+-+ + +-+ +-+-+ +-+-+ +-+-+
| | | |   |   |   |   | | |       | | |   | |     | | | | |     | | | |   | |     |     |   | | |   |
+ + +-+-+ +-+ +-+-+-+ +-+-+ +-+ +-+ + + + + + + + +-+-+ +-+-+-+ + +-+-+ +-+ + +-+-+-+-+-+-+ + + + +-+
|     | | |       |       | | |   | |   | | | | | | |             | |       | |   |           |     |
+-+ +-+ + + +-+ +-+-+-+ +-+ + +-+-+-+ + +-+-+-+ +-+ + + +-+-+-+ +-+ +-+-+-+ +-+-+ +-+-+ + +-+-+-+-+-+
| |   |     |   |   |     | |       | | | | | |   |   | |     |     |       |     |   | |       |   |
+ + +-+ +-+-+ + +-+ + +-+-+ +-+-+ +-+-+ + + + + + +-+ + +-+-+ +-+ +-+ +-+-+-+-+-+ + + +-+-+-+ +-+ +-+
|   | | | |   |     |   | | |       | |     |   |   | |   |     | |   | |     |     |     | | |     |
+-+ + +-+ +-+ +-+-+-+-+-+ + +-+-+-+ + + + + + +-+-+-+ +-+-+-+ + +-+ +-+ + + + +-+-+-+-+ +-+ + + +-+-+
|   |   |       |     |     |     | | | | | |     |     |     | |     | | | |       |   |       |   |
+-+ + +-+ + + + + + +-+ +-+-+-+ + + + + +-+-+-+ + + +-+ +-+-+-+ +-+-+ + + +-+ +-+-+-+-+ + +-+ + + +-+
|         | | |   | | | | | |   | |         |   | |   | |       |       |   | | | | |   | | | | | | |
+-+-+ + +-+ +-+ +-+-+ + + + + +-+-+ + +-+ +-+-+ +-+-+-+ + + +-+ + +-+-+ +-+ +-+ + + +-+ + + + +-+ + +
|   | |   |   | |   | |         |   |   |   |   |   | | | |   |     |     |   |         | |   |     |
+ + +-+ + +-+ + + +-+ + + + +-+ + +-+-+ + + + +-+ +-+ + +-+ +-+-+-+ + +-+-+ + + +-+ + +-+-+-+ +-+ +-+
| |     |   | | | |   | | | |   |     | | | |   | |   | |     |     |       |     | | |             |
+ +-+-+-+-+ +-+-+ + + +-+ + +-+-+ +-+ +-+ +-+ +-+ +-+ +-+ +-+ + +-+-+-+-+-+ + +-+ +-+ + + + +-+-+ +-+
| | |   | | |       |     |     | |   |     |         |     | |   | |       |   |   |   | | |       |
+ + + +-+ +-+ + + + +-+ +-+-+-+ +-+-+-+ +-+ +-+-+-+ +-+ + +-+-+ + + +-+ + + + +-+-+-+-+ +-+-+-+ +-+ +
|         |   | | |   | |           |     |     |     | |   |   | |     | | |         |       | |   |
+-+-+-+-+-+-+-+-+-+-+-+-+-+-+-+-+-+-+-+-+-+-+-+-+-+-+-+-+-+-+-+-+-+-+-+-+-+-+-+-+-+-+-+-+-+-+-+-+-+-+