+-+-+-+-+-+
|     |   |
+-+ +-+ +-+
|         |
+ +-+-+-+ +
| | |     |
+ + +-+ + +
|   |   | |
+ +-+ +-+-+
| |       |
+-+-+-+-+-+