+-+-+-+-+-+-+-+-+-+-+-+-+-+-+-+-+-+-+-+-+-+-+-+-+-+-+-+-+-+-+-+-+-+-+-+-+-+-+-+-+
|     |     |       |       |       |       |   |       |   |                   |
+-+-+ +-+-+ + + +-+ + + +-+ +-+ +-+ +-+-+ + + + + +-+-+ + + + + + +-+-+-+-+-+-+ +
|   |     |   | |   | |   |   | | |   |   | | |       | | |   | | |     | |     |
+ +-+-+-+ +-+-+ + +-+-+-+ +-+ + + +-+ + +-+ + +-+-+-+ + + +-+-+ +-+ +-+ + + +-+-+
|       |   |   | |       | |   |   |   | | | |     | | | |   | |   | | |       |
+ +-+ +-+-+ + +-+ + +-+-+-+ +-+-+ + +-+-+ + +-+ +-+ + + + + + + + +-+ + +-+-+-+ +
|   | |   | | |     |     |       |       |     |   | |   | | | | |   |   |     |
+-+ + + + + + +-+-+-+ +-+ +-+-+-+ +-+-+-+ +-+-+-+ +-+ +-+-+-+ + + + +-+-+ +-+ +-+
| | |   | | |         | |       |   |   | |     | | | |       |   |     |   |   |
+ + +-+-+ + + +-+-+-+-+ +-+-+-+ +-+-+ + + + +-+ + + + + + +-+-+-+-+-+ + +-+ +-+-+
|   | |   | |     |     |     |       | |   | |   |   | |             |   |     |
+ +-+ + + + +-+-+ + +-+ +-+-+ +-+-+-+-+ + +-+ +-+-+ +-+-+-+-+ + +-+-+-+-+-+-+ + +
| |   | | |     |   |         |   | |   | | |   |   |       | | |           | | |
+ + +-+ +-+-+-+ + +-+-+-+-+-+ + + + + +-+ + + + + +-+-+ +-+ +-+ + +-+-+-+-+ +-+ +
| | |   |       | |   |   |     |   |   | | | |   |     |       | | |     |   | |
+ + + + + +-+-+-+-+ + + + +-+-+ +-+-+-+ + + + +-+-+-+ +-+-+-+-+-+ + + +-+ +-+ + +
|   | | |   |       | | |   |   |     | | |       |   |           |   | |   |   |
+-+-+ +-+-+ +-+-+ +-+ + +-+ + +-+ +-+ + + +-+-+-+ + + + + +-+-+-+-+ +-+ +-+ +-+ +
|   |     |     | |   | | | |   |   |   |   | |     | | | |   | |       |     | |
+ + +-+-+ +-+-+ + + +-+ + + +-+ +-+ + +-+-+ + + +-+-+-+ + + + + + +-+-+-+ +-+-+ +
| | |   |     |   |     | |   | |   | |   | |   |       | | | |   |       |     |
+ + + + + + +-+-+-+-+-+-+ +-+ + + +-+-+ + + +-+ + +-+ +-+-+ + +-+ + +-+-+-+ +-+-+
| |   |   | |       |     |   | |       | |   | | |   |     |   | |       |     |
+ +-+-+-+-+-+ +-+-+ + + +-+ +-+ +-+-+-+-+ +-+ +-+ +-+-+ +-+-+-+ +-+-+-+ + +-+-+ +
|   |       | |   |   |     |   |       |   |   | |     |     |       | |     | |
+ + + +-+-+ + +-+ +-+-+-+-+-+ +-+-+-+ +-+-+ +-+ + + +-+-+-+-+ +-+-+-+ +-+ +-+ + +
| |   |   | |   |           |       | |   | | | | |   |     |   |   |   | |   | |
+ +-+-+ + + +-+ + +-+ +-+-+ +-+-+-+ + + + + + + + +-+ + +-+ + + +-+ +-+ + + +-+ +
| |   | |   |   | |   |           | | | |   | |   | | | | |   |   |   | | |     |
+ + + + +-+ + +-+ + +-+ +-+-+-+-+-+ + + +-+-+ +-+ + + + + +-+-+-+ + + + +-+-+-+-+
| | | | |   |   | |   | |   |       | |     |   |   | | |     |   | | |         |
+ + + + + +-+-+ +-+ + + + + + +-+-+-+ +-+-+ +-+ +-+ + + + + + + +-+ + +-+-+-+-+ +
| | |   |     |   | | |   | |   |         |   |   | |   | | | |   | |     |   | |
+-+ +-+-+ +-+-+-+ + + +-+-+ +-+ +-+-+-+-+ +-+ + + + +-+-+ + +-+-+ + +-+-+ + + + +
|   |     |       | | |       |       |     | | |     |   |     | | |     | |   |
+ +-+ +-+-+ +-+-+-+ + +-+-+-+ +-+-+-+ + +-+-+ +-+-+-+-+ +-+-+ + + +-+ +-+ + +-+ +
| | | |   | | |   | | |     | |       |     |           | |   | |     |   |   | |
+ + + +-+ + + + + + + + +-+ + + +-+-+-+-+-+ +-+-+-+-+-+-+ + +-+-+ +-+-+ +-+-+ +-+
| |       | | | |   |   | | | |           | |             | |     |   |     |   |
+ + +-+-+-+ + + +-+-+-+-+ + +-+-+-+-+-+-+ + + +-+-+-+-+-+ + + +-+-+ + +-+-+-+-+ +
| |   |     |             |             | | | |   |       | |     | | |       | |
+ +-+-+ +-+-+ +-+-+-+-+-+ +-+-+ +-+-+-+-+ + + +-+ + +-+-+-+ +-+-+ + + + +-+-+ + +
| |   | |     |       |   |   | |         |       |       |     | | |   |   |   |
+ + + + +-+ +-+ +-+-+ +-+-+ + + + +-+-+-+-+-+-+-+-+-+-+-+ +-+-+ + + +-+-+-+ +-+ +
| | | |   | |   |   |       |   | |   |     |           |     | | |       | |   |
+ + + +-+ +-+ +-+-+ +-+ +-+-+-+-+ +-+ + + + + +-+-+-+-+ + +-+ + + +-+-+-+ + + +-+
| | | |   |   |   |     |   |   |   |   | | |   |       |   | | | |   |   | |   |
+ + + + +-+ + + + +-+ +-+ + + + +-+ + +-+ + +-+ + +-+-+-+-+ + + + + +-+ +-+ +-+ +
|   | | |   | | |   | |   |   |   | | |   | |   |         | | |     |   |     | |
+-+-+ + + +-+-+ +-+ +-+ +-+-+ +-+ + + + +-+ + +-+-+-+-+-+ + +-+-+-+ + +-+ +-+-+ +
|     | | |   | | |   | |   |   | | | | |   | |   |     |   |     | |   |     | |
+ +-+-+ + + + + + +-+ + + + +-+ + + +-+ + +-+ + + + +-+ +-+ + +-+ +-+-+ +-+ + + +
| |     |   |       |   | | |   |       |     | |   |   |   | | | |   |   | |   |
+ + +-+-+-+ +-+-+-+ +-+-+ + + +-+-+-+-+-+-+-+ + +-+-+ +-+ +-+ + + + + +-+ + +-+-+
| | |     | |     | |     | | |   |       | | | | |   |   |   | |   | |   | |   |
+ + + +-+ +-+ +-+ +-+ +-+-+ +-+ + + +-+-+ + + + + + +-+-+-+ +-+ +-+-+ + +-+ + +-+
|   |   |   |   |     |   |     | | |     |   | |   |     | | |     | | | | |   |
+ +-+ + +-+ +-+ +-+-+-+ + +-+-+-+ + + +-+-+ +-+ + +-+ +-+ + + + + + + + + + +-+ +
|   | | | |   |       | |       |   | |   |   | | |   | | | |   | | |   | |     |
+-+ +-+ + +-+ + +-+-+ +-+-+ +-+ +-+-+ +-+ +-+ + + +-+ + + + + +-+ +-+-+-+ +-+-+ +
| | |   |   | |     |     |   |     |   |   | | |     | | | |   |       |     | |
+ + + +-+ + + +-+-+-+-+-+ + +-+-+-+ +-+ + +-+ + +-+-+-+ + + +-+ +-+-+ + + + +-+ +
|   | |   |   |           | |         | |     |     |     |   | |     | | | |   |
+ +-+ + +-+-+-+ +-+-+-+-+-+-+ +-+-+ +-+ + +-+-+-+-+ + +-+-+ + + + +-+-+ + + + +-+
|     | |       |           |   |   |   |   | |     |   |   | | | |   |   | | | |
+-+-+-+ + +-+-+-+ +-+ +-+-+ +-+ +-+-+ +-+-+ + + +-+-+-+ +-+ + +-+ + +-+-+-+ + + +
|   |   |     |     | |   |     |   |   | | | | |     |   | | |   | |       |   |
+-+ + +-+ +-+ +-+-+ +-+ + +-+-+-+ + +-+ + + + + + +-+ +-+ +-+ + +-+ + +-+-+-+-+ +
|   |   |   | |     |   |         | |   |   | | |   | |       |   | |   |       |
+ +-+-+ +-+ + + +-+ + +-+-+-+-+-+-+ + +-+ +-+ + +-+ + +-+-+-+-+-+ + +-+ + +-+-+-+
|     |   | | | |   | |   |       | | |   |   |     |   |         |     |   |   |
+ + +-+-+ +-+ + +-+-+ + +-+ + +-+-+ + + +-+ + +-+-+-+-+ + +-+ +-+-+-+-+-+-+ +-+ +
| |     |     |     | |     |     |   | |   |   |     | |   |     |       |   | |
+ +-+-+ +-+-+-+-+-+ + +-+-+-+-+-+ +-+-+ + +-+-+ +-+-+ + + +-+-+-+ + +-+ +-+-+ + +
| |   | |           |         |   |       |           | | |     | |   |     |   |
+ + + + + +-+ + +-+-+-+-+-+-+ + + +-+ +-+-+-+ +-+-+-+-+ + + +-+ + +-+ +-+-+ +-+ +
| | | |   |   | |     |       | |   | |     |   |       | |   |   |   |   |   | |
+ + + +-+-+ +-+-+ + +-+ +-+-+-+ +-+ +-+ +-+ +-+-+ +-+-+-+ +-+ +-+-+ +-+ + +-+ + +
|   |     |       |             |       |         |         |           |   |   |
+-+-+-+-+-+-+-+-+-+-+-+-+-+-+-+-+-+-+-+-+-+-+-+-+-+-+-+-+-+-+-+-+-+-+-+-+-+-+-+-+