+-+-+-+-+-+-+
|     | | | |
+-+ + + + + +
| | |     | |
+ + +-+ + + +
|   |   |   |
+-+ +-+ + + +
|     | | | |
+-+ +-+-+ +-+
|       |   |
+-+ +-+ + + +
|   |   | | |
+-+-+-+-+-+-+