+-+-+-+-+-+-+-+-+-+-+-+-+-+-+-+-+-+-+-+-+-+-+-+-+-+-+-+-+-+-+-+-+-+-+-+-+-+-+-+-+-+-+-+-+-+-+-+-+-+-+
|                                                                                                   |
+ + +-+-+-+-+ + + +-+ + +-+-+ +-+ + + + +-+-+-+ + +-+ + +-+ + +-+-+ +-+ + +-+-+ +-+-+-+ +-+-+ +-+ + +
| |         | | |   | |     |   | | | |       | |   | |   | |     |   | |     |       |     |   | | |
+ + + +-+-+ + + + + + +-+ + + + +-+ + +-+-+-+-+ + + +-+-+-+-+-+ + +-+-+-+-+-+ + + + + +-+-+ +-+-+-+-+
| | |     | | | | | |   | | | |   | |         | | |           | |           | | | | |     |         |
+ + + + + +-+ + + + + +-+-+-+-+-+ + + + + + +-+-+-+ +-+ +-+-+ + + +-+-+ + + +-+ +-+-+ + +-+ + + + + +
| | | | |   | | | | |           | | | | | |       |   |     | | |     | | |   |     | |   | | | | | |
+ +-+ + + + + + +-+ + + +-+-+ +-+-+ +-+ +-+-+ +-+ + +-+ + + + + + + +-+ + +-+ + + + +-+ +-+ +-+-+-+ +
|   | | | | | |   | | |     |     |   |     |   | |   | | | | | | |   | |   | | | |   |   |       | |
+ +-+ + +-+-+-+-+ +-+ +-+ +-+-+ + + + +-+-+-+-+ + + + + + +-+-+-+-+ +-+-+-+-+ + +-+ + +-+ + + + + +-+
|   | |         |   |   |     | | | |         | | | | | |         |         | |   | |   | | | | |   |
+ +-+ +-+-+ +-+-+-+ + +-+-+ +-+ +-+-+ +-+-+ + +-+-+-+-+ +-+ + +-+ + +-+-+-+-+-+ +-+ + +-+ + +-+-+-+-+
|   |     |       | |     |   |     |     | |         |   | |   | |           |   | |   | |         |
+ +-+-+ + + + + + +-+ + +-+ +-+-+ +-+ +-+-+-+ + +-+-+ + +-+ +-+-+-+-+-+ +-+-+ +-+-+ + +-+-+-+-+-+-+ +
|     | | | | | |   | |   |     |   |       | |     | |   |           |     |     | |             | |
+ + +-+ + + + + +-+-+ + + +-+-+ + +-+-+-+ + +-+-+ +-+ +-+ +-+-+-+-+-+-+ +-+ + + + + +-+-+-+ + +-+-+ +
| |   | | | | |     | | |     | |       | |     |   |   |             |   | | | | |       | |     | |
+ +-+-+ + + +-+-+ + + +-+-+ + + +-+ +-+ +-+-+ + + + + + +-+-+-+ + + +-+ +-+ + + +-+-+-+-+ +-+-+ + + +
|     | | |     | | |     | | |   |   |     | | | | | |       | | |   |   | | |         |     | | | |
+ +-+-+-+ +-+ + +-+-+ +-+-+-+-+ + + +-+-+-+-+-+-+ + + + +-+-+-+-+-+-+-+ + +-+ + +-+-+ +-+ + + + + + +
|       |   | |     |         | | |             | | | |               | |   | |     |   | | | | | | |
+ + +-+ + +-+ +-+-+ + +-+ + +-+-+ + + + +-+ +-+-+ +-+ + + +-+ +-+-+ + +-+ + +-+ +-+ +-+-+-+-+ + +-+-+
| |   | |   |     | |   | |     | | | |   |     |   | | |   |     | |   | |   |   |         | |     |
+ + + + + +-+ + +-+-+-+ +-+-+-+ +-+-+ + +-+-+-+-+-+-+-+-+-+ + +-+ +-+-+-+-+-+-+ + + +-+-+ + + +-+ + +
| | | | |   | |       |       |     | |                   | |   |             | | |     | | |   | | |
+ +-+-+ +-+-+-+-+ +-+ + + +-+ +-+-+ + +-+ +-+-+-+ +-+-+ +-+ + +-+ +-+ + +-+-+-+-+ + + + + +-+-+-+-+ +
|     |         |   | | |   |     | |   |       |     |   | |   |   | |         | | | | |         | |
+ + +-+-+ +-+ +-+ +-+ + + + +-+-+-+ + + +-+-+ + +-+ +-+-+-+-+ + +-+-+-+ + + + +-+-+ + +-+ +-+-+-+ + +
| |     |   |   |   | | | |       | | |     | |   |         | |       | | | |     | |   |       | | |
+ + + + +-+ + +-+ + +-+ + + +-+ +-+ +-+-+-+ +-+ +-+ +-+ +-+ + +-+-+-+-+-+-+ +-+-+ +-+-+-+ +-+-+-+ + +
| | | |   | |   | |   | | |   |   |       |   |   |   |   | |             |     |       |       | | |
+ +-+-+ + + + + +-+-+-+-+ + +-+ + + +-+-+ +-+-+ +-+ +-+ + + + + + +-+-+ +-+-+ + + +-+-+-+ +-+ +-+ +-+
|     | | | | |         | |   | | |     |     |   |   | | | | | |     |     | | |       |   |   |   |
+ +-+-+ + + +-+-+ + + + + + + + + +-+ + +-+ + + +-+ +-+-+ +-+ +-+ +-+-+ + + +-+ +-+ + +-+-+-+ +-+-+ +
|     | | |     | | | | | | | | |   | |   | | |   |     |   |   |     | | |   |   | |       |     | |
+ + +-+-+ + +-+ + +-+-+-+ + +-+ +-+ +-+-+-+ + +-+-+ + +-+-+-+-+ +-+-+-+-+ + +-+ +-+ +-+-+-+-+-+-+-+-+
| |     | |   | |       | |   |   |       | |     | |         |         | |   |   |                 |
+ +-+-+ + +-+-+ + + +-+ + +-+ +-+-+ + + +-+ + +-+ + + + + + + + + +-+-+-+-+ + +-+-+ +-+-+ + + + +-+-+
|     | |     | | |   | |   |     | | |   | |   | | | | | | | | |         | |     |     | | | |     |
+ +-+ + +-+ + +-+ + +-+-+ +-+-+-+-+ +-+ + + + + + +-+-+-+ +-+ +-+ +-+ +-+-+ +-+-+ + +-+ + +-+ +-+-+ +
|   | |   | |   | |     |         |   | | | | | |       |   |   |   |     |     | |   | |   |     | |
+ +-+-+-+-+-+ +-+-+ +-+-+ + + +-+-+ + + + + + + + +-+-+-+-+ +-+-+ + + +-+ +-+ + +-+-+ +-+-+ + +-+ + +
|           |     |     | | |     | | | | | | | |         |     | | |   |   | |     |     | |   | | |
+ + +-+-+-+-+ +-+-+ +-+ + + +-+ +-+ + + +-+-+ +-+ + +-+ + + +-+ +-+-+ +-+ +-+-+ +-+-+-+-+ + +-+-+-+ +
| |         |     |   | | |   |   | | |     |   | |   | | |   |     |   |     |         | |       | |
+ +-+-+ +-+ +-+-+ + + + +-+ +-+-+-+-+-+-+-+ + +-+-+ +-+-+-+ +-+ +-+ +-+ +-+-+ + +-+-+ +-+ +-+ +-+-+ +
|     |   |     | | | |   |               | |     |       |   |   |   |     | |     |   |   |     | |
+ + +-+ +-+ +-+-+-+-+-+ + +-+-+-+ + + + +-+ +-+-+ +-+-+ + + + + + + +-+-+-+ +-+-+ + + + +-+-+-+-+-+ +
| |   |   |           | |       | | | |   |     |     | | | | | | |       |     | | | |           | |
+ +-+-+-+ + + + +-+ +-+-+-+-+-+ + +-+ + +-+ +-+ + + + +-+ + + + +-+-+-+ +-+ +-+-+ +-+-+ +-+-+ +-+ +-+
|       | | | |   |           | |   | |   |   | | | |   | | | |       |   |     |     |     |   |   |
+ + + +-+-+ + +-+ +-+-+-+-+-+ + +-+-+-+-+-+ + +-+-+ + + + +-+ +-+-+ + + +-+-+ +-+-+-+-+-+-+ +-+ + +-+
| | |     | |   |           | |           | |     | | | |   |     | | |     |             |   | |   |
+ + + + + +-+-+-+-+-+ + + + + + + +-+ + + + + + +-+ +-+ + + + + + +-+-+-+-+-+ +-+-+ +-+-+-+ + +-+-+ +
| | | | |           | | | | | | |   | | | | | |   |   | | | | | |           |     |       | |     | |
+ + +-+-+-+ + +-+-+-+ +-+ +-+-+ +-+ + +-+-+-+-+ + + +-+-+ +-+ +-+ + + +-+-+-+-+-+ +-+-+-+ +-+ +-+-+ +
| |       | |       |   |     |   | |         | | |     |   |   | | |           |       |   |     | |
+ + +-+-+-+-+ + +-+ + + + + +-+ +-+ +-+ +-+ + +-+ +-+ +-+ + + + + +-+-+ +-+-+ +-+-+-+-+ + +-+ +-+ +-+
| |         | |   | | | | |   |   |   |   | |   |   |   | | | | |     |     |         | |   |   |   |
+ + + +-+-+ + +-+ + +-+ + + +-+ + +-+ + + + + +-+-+-+-+-+-+ + +-+-+ +-+-+ + + + + +-+ +-+ + +-+-+-+-+
| | |     | |   | |   | | |   | |   | | | | |             | |     |     | | | | |   |   | |         |
+ + + + + +-+-+ +-+-+ +-+ +-+ + + + + +-+-+ + +-+-+ +-+ + +-+ +-+ +-+ +-+-+ +-+ + +-+ + + + +-+ + + +
| | | | |     |     |   |   | | | | |     | |     |   | |   |   |   |     |   | |   | | | |   | | | |
+ + + +-+ +-+ + +-+ + +-+ +-+ +-+-+-+ + +-+-+ + +-+-+-+-+-+ +-+-+ +-+-+ + + +-+-+ +-+-+-+ + + + +-+-+
| | |   |   | |   | |   |   |       | |     | |           |     |     | | |     |       | | | |     |
+ +-+ +-+-+ +-+ + + +-+-+ +-+ + + + + +-+ + +-+-+ +-+ + +-+-+ +-+-+ + + + +-+ +-+ + +-+ + +-+ +-+-+ +
|   |     |   | | |     |   | | | | |   | |     |   | |     |     | | | |   |   | |   | |   |     | |
+ + + +-+-+-+ +-+-+ + + +-+ +-+ + + +-+-+-+ +-+-+-+-+ + + + + + + +-+ +-+-+-+ +-+ + +-+ +-+ + + + + +
| | |       |     | | |   |   | | |       |         | | | | | | |   |       |   | |   |   | | | | | |
+ +-+-+ +-+-+ +-+ + + +-+-+-+-+ + +-+-+-+ + + +-+-+-+-+ +-+ + +-+ +-+-+-+-+ + + + +-+-+ + +-+-+ + +-+
|     |     |   | | |         | |       | | |         |   | |   |         | | | |     | |     | |   |
+ + +-+ + +-+-+ +-+-+-+-+-+ + +-+-+ + +-+-+ +-+-+-+ +-+ + +-+-+-+-+ +-+ + + +-+ +-+ +-+ +-+ +-+ + +-+
| |   | |     |           | |     | |     |       |   | |         |   | | |   |   |   |   |   | |   |
+ +-+-+ +-+-+ +-+-+ +-+-+-+ + + + +-+ + +-+ + +-+ + +-+-+-+ +-+-+-+-+ + +-+-+ +-+ +-+ +-+-+-+ +-+-+ +
|     |     |     |       | | | |   | |   | |   | |       |         | |     |   |   |       |     | |
+ +-+-+ + +-+ + + + + +-+-+ +-+-+ +-+ +-+-+ +-+ +-+-+ + +-+-+-+-+-+ +-+-+ +-+ + + +-+-+ +-+-+ +-+ +-+
|     | |   | | | | |     |     |   |     |   |     | |           |     |   | | |     |     |   |   |
+ + + +-+ +-+-+-+ + +-+-+ + +-+ +-+ + +-+-+ +-+-+ +-+-+-+ +-+-+ +-+ + +-+-+ +-+ + + +-+-+-+-+ + + +-+
| | |   |       | |     | |   |   | |     |     |       |     |   | |     |   | | |         | | |   |
+ +-+ + +-+-+ +-+-+ +-+-+ +-+-+-+ +-+-+-+ +-+-+-+ + + +-+ +-+-+-+-+ +-+-+ +-+ +-+ + +-+-+-+-+-+-+-+-+
|   | |     |     |     |       |       |       | | |   |         |     |   |   | |                 |
+ +-+-+-+-+-+-+ + + +-+-+ + + +-+ + +-+ +-+-+ +-+-+-+ + +-+-+-+ + +-+-+-+ +-+ +-+ + +-+-+-+-+-+ +-+ +
|             | | |     | | |   | |   |     |       | |       | |       |   |   | |           |   | |
+ + + +-+ +-+-+-+ +-+ +-+ + + +-+ +-+ +-+ + + +-+-+-+-+-+ +-+ + +-+ +-+ +-+ +-+ + + +-+-+ + + + +-+ +
| | |   |       |   |   | | |   |   |   | | |           |   | |   |   |   |   | | |     | | | |   | |
+ + + + + +-+-+-+ + +-+-+ + + + +-+-+ + +-+-+-+-+ +-+-+-+-+ +-+-+-+ +-+ +-+ +-+-+-+-+ +-+-+ +-+ +-+-+
| | | | |       | |     | | | |     | |         |         |       |   |   |         |     |   |     |
+ + + +-+ + + + + +-+ + +-+-+-+-+-+-+ +-+-+-+ + +-+-+ +-+-+-+ +-+ +-+-+ +-+-+ +-+-+-+-+-+ +-+ + + + +
| | |   | | | | |   | |             |       | |     |       |   |     |     |           |   | | | | |
+ + + +-+ + + + + +-+-+-+ + + +-+ + +-+ + + +-+-+-+ +-+-+-+ +-+ + +-+-+ + + +-+-+-+-+-+ + + +-+ +-+ +
| | |   | | | | |       | | |   | |   | | |       |       |   | |     | | |           | | |   |   | |
+ + + +-+ + + +-+ +-+ +-+-+ + +-+ + +-+-+ + + + +-+ +-+ +-+-+-+-+ + + +-+-+ + + +-+ + +-+-+ +-+ +-+-+
| | |   | | |   |   |     | |   | |     | | | |   |   |         | | |     | | |   | |     |   |     |
+ + + + +-+ + +-+-+ +-+ +-+ + + +-+ + +-+ + + + + +-+ + +-+ +-+-+ +-+-+-+-+ +-+-+-+-+-+ + + +-+ +-+-+
| | | |   | |     |   |   | | |   | |   | | | | |   | |   |     |         |           | | |   |     |
+ +-+-+-+ +-+-+ + + +-+ + +-+ +-+ +-+ + + +-+-+ + + + + +-+-+-+-+ + + +-+-+-+-+ + +-+-+-+-+ +-+-+ +-+
|       |     | | |   | |   |   |   | | |     | | | | |         | | |         | |         |     |   |
+ + +-+ +-+ +-+-+ +-+-+-+-+-+ +-+ +-+-+-+ + + + +-+-+ +-+ + +-+-+ +-+-+-+ + + + + + + + + +-+ + + + +
| |   |   |     |           |   |       | | | |     |   | |     |       | | | | | | | | |   | | | | |
+-+-+-+-+-+-+-+-+-+-+-+-+-+-+-+-+-+-+-+-+-+-+-+-+-+-+-+-+-+-+-+-+-+-+-+-+-+-+-+-+-+-+-+-+-+-+-+-+-+-+