+-+-+-+-+-+-+-+-+-+-+-+-+-+-+-+-+-+-+-+-+-+-+-+-+-+-+-+-+-+-+-+-+-+
| |     |     |   | |     |         |   |   | | |   |   |   |     |
+ + + +-+ +-+ + +-+ + + +-+ + +-+-+ + +-+-+ + + +-+ +-+ +-+ +-+-+ +
| | |     |     |   | |   | |     |   |   | |   |   |         |   |
+ +-+-+ +-+-+ +-+ +-+-+-+ +-+-+ +-+ + +-+ + + +-+ +-+ +-+-+-+-+-+ +
|   |   |   |   |             | | | |               |         | | |
+-+ + +-+ +-+-+ + +-+-+-+ +-+-+-+ +-+ + + + + + +-+ + + +-+ +-+ + +
|           | | |   | |             | | | | | |   | | |   |   |   |
+-+-+-+ +-+-+ +-+ + + + + + +-+-+ +-+-+-+-+-+ +-+-+ + +-+-+ +-+ +-+
|         |       | | | | |   | |       | |   |   | |     | |     |
+ + +-+ + + +-+-+-+-+ + +-+-+ + + +-+-+-+ +-+-+-+ + + +-+-+ +-+ +-+
| | |   |   | | |     |     | |   |     |   |   |     |         | |
+ +-+-+-+-+-+ + + +-+ + +-+-+-+-+ + +-+-+ +-+ +-+ + + + +-+-+ + + +
|         |       |   |       | | | | |       |   | | | |     | | |
+ +-+ +-+ + + +-+-+-+-+-+-+-+-+ + + + +-+ +-+ + + +-+ +-+-+-+-+-+ +
| |   | |   | |     |       | |     |       | | | |       |     | |
+ +-+ + +-+ +-+-+-+ + + +-+-+ + +-+-+-+ + +-+-+-+-+-+-+-+ + + + + +
|   |     |     |   | | |     |   |   | |       | |       | | |   |
+-+-+-+-+ + +-+ + +-+-+ +-+ + + +-+ +-+-+ +-+ +-+ + +-+-+-+ + +-+-+
|   |     | | |   |   | |   | |   | | |     | | |   |     | |   | |
+ +-+-+ +-+ + +-+ + + + + + + + +-+ + + + + + + +-+ +-+ +-+-+ +-+ +
|   |     | |     | |     | | |     |   | | | | |   | | |   |     |
+ + +-+-+ +-+-+-+ +-+ + + +-+-+ +-+ + +-+ +-+ + + + + + + +-+ +-+ +
| | |       | |       | |   |     |     | |   |   | |     |   |   |
+ +-+-+-+ +-+ +-+ + + +-+-+-+-+ + +-+-+-+-+ + + +-+ +-+ + +-+-+ +-+
| |   |   |       | |     |   | | |   | | | | | |   |   | | |     |
+ + + + + +-+-+ +-+-+-+ + + + + +-+ + + + +-+ + +-+-+ + + + +-+ + +
|   |   |   | | |     | | | | | |   | | | |   |     | | |       | |
+ +-+ +-+-+ + + +-+-+ + + + +-+-+-+-+ + + + +-+ +-+-+ + + +-+ +-+-+
| | | |     |     | | | | |     |       |   |     |   | | |       |
+-+ +-+-+ +-+ +-+ + + + +-+ + +-+ + + +-+ + + +-+ + + + +-+-+-+-+-+
|   |   |   |   | | | | |   | |   | | |   | | |   | | | | | |     |
+ +-+ +-+ +-+-+ +-+ + + + +-+ +-+ + + + +-+ +-+-+ + + +-+ + +-+-+ +
|   |   | |   |   | | | | |   |   | | | |   |       |       | | | |
+ + + + + + +-+-+ + + + + + +-+ +-+ +-+-+-+ + + + +-+-+-+-+ + + + +
| |   |       | |   |     |       | | | |     | | | |     | |   | |
+-+ + + + + + + +-+-+-+ +-+-+ + +-+-+ + +-+ +-+-+ + +-+-+ + +-+ + +
|   | | | | |   |       |     | | | | | | |     | |   | | | |     |
+-+ + + +-+ +-+ +-+ +-+-+-+-+-+-+ + + + + + +-+ +-+-+ + + + + +-+-+
|   | |   | |   |     | | |   | |   |   |     |     |           | |
+ +-+-+ +-+ + + +-+-+-+ + + +-+ +-+ +-+ + +-+ +-+-+-+-+ +-+-+ +-+ +
|   |   |   | | |   |   |   |   |         |   |       |   | |     |
+-+ +-+-+-+ + +-+-+ + +-+ + + +-+-+ +-+-+-+-+ +-+-+-+ +-+ + +-+ +-+
|   |     | |   |     |   |     | |       |   | |             |   |
+ +-+-+ +-+-+ + + +-+-+-+-+ +-+-+ + +-+ +-+-+-+ +-+-+-+-+ +-+-+ + +
| |       |   | |     |           | | |       |     |   |   | | | |
+ + + +-+ +-+-+ +-+ +-+ +-+-+-+ + + + +-+-+ +-+ +-+ + +-+-+-+ +-+ +
|   |   |     | |   | | | |   | | |       | |   | |   |   |     | |
+ +-+-+-+-+-+ +-+ + + +-+ + +-+ + + + +-+-+ +-+ + + +-+-+ +-+ + +-+
| |     |       | |     |   |   | | |   | |   |   |   | |   | |   |
+ +-+-+ +-+-+ +-+ + + +-+-+ + +-+ +-+ + + + + +-+-+-+ + +-+ +-+-+ +
| |       |       | |           |   | | |   | |           | |     |
+-+-+-+ + + +-+-+ +-+ +-+-+ +-+ +-+ + +-+ + +-+ + +-+-+-+ + + +-+ +
| | |   | |   |   |     | | | |   | |   | | |   |       |   | | | |
+ + + +-+-+-+ +-+-+-+-+ + +-+ + +-+-+-+ + + +-+-+ +-+ +-+-+-+-+ + +
| |           |   |     | |   |   | |   | |   |     | |   |       |
+ + +-+-+-+-+ + +-+ +-+ + + +-+ + + +-+-+ + +-+ + + + +-+ + +-+ +-+
|   |   |         | | | | |   | | |       |     | | | |   |   | | |
+-+ + + + + +-+ +-+ + +-+ +-+ + +-+ + + +-+ +-+-+ + + + +-+-+ +-+ +
|     | | | |     | |   |       |   | | | |   | | | |   | |       |
+-+ + + + +-+-+ + +-+-+ +-+-+-+ +-+-+-+-+ + + + +-+ +-+-+ + + +-+ +
|   | | |     | | |               |   | |   |   |   | |   | |   | |
+-+ +-+-+ +-+-+-+-+-+-+ +-+-+ + + + +-+ +-+-+ +-+ +-+ + +-+ + +-+-+
|   | |     | |   |     | |   | |   |   |   |   | |   |     |     |
+ +-+ +-+-+ + + + + +-+ + + + +-+-+ + +-+ +-+ +-+ + + + +-+-+ + + +
|     |       | |     |   | |   |   |         |     |     |   | | |
+-+-+-+-+-+-+-+-+-+-+-+-+-+-+-+-+-+-+-+-+-+-+-+-+-+-+-+-+-+-+-+-+-+