+-+-+-+-+-+-+-+-+-+-+-+-+-+
|                   |.|.|.|
+-+-+-+-+-+-+-+-+-+-+-+-+-+
|.|.|.|.|.|.|.|.|.|.|.|.|.|
+-+-+-+-+-+-+-+-+-+-+-+-+-+
|.|.|.|.|.|.|.|.|.|.|.|.|.|
+-+-+-+-+-+-+-+-+-+-+-+-+-+
|.|.|.|.|.|.|.|.|.|.|.|.|.|
+-+-+-+-+-+-+-+-+-+-+-+-+-+
|.|.|.|.|.|.|.|.|.|.|.|.|.|
+-+-+-+-+-+-+-+-+-+-+-+-+-+
|.|.|.|.|.|.|.|.|.|.|.|.|.|
+-+-+-+-+-+-+-+-+-+-+-+-+-+
|.|.|.|.|.|.|.|.|.|.|.|.|.|
+-+-+-+-+-+-+-+-+-+-+-+-+-+
|.|.|.|.|.|.|.|.|.|.|.|.|.|
+-+-+-+-+-+-+-+-+-+-+-+-+-+
|.|.|.|.|.|.|.|.|.|.|.|.|.|
+-+-+-+-+-+-+-+-+-+-+-+-+-+
|.|.|.|.|.|.|.|.|.|.|.|.|.|
+-+-+-+-+-+-+-+-+-+-+-+-+-+
|.|.|.|.|.|.|.|.|.|.|.|.|.|
+-+-+-+-+-+-+-+-+-+-+-+-+-+
|.|.|.|.|.|.|.|.|.|.|.|.|.|
+-+-+-+-+-+-+-+-+-+-+-+-+-+
|.|.|.|.|.|.|.|.|.|.|.|.|.|
+-+-+-+-+-+-+-+-+-+-+-+-+-+