+-+-+-+-+-+-+-+-+
| |   |   | | | |
+ + +-+ +-+ + + +
|       |   |   |
+-+ + +-+-+ + +-+
| | |     |     |
+ +-+-+ +-+-+ +-+
|       |   |   |
+ +-+-+ + + +-+ +
| |   |   |     |
+-+ + +-+-+ +-+ +
|   | |       | |
+-+ +-+ +-+ +-+ +
|   |   | |   | |
+-+ + + + + +-+-+
|     |   |     |
+-+-+-+-+-+-+-+-+