+-+-+-+-+-+-+-+-+-+-+-+-+-+-+-+-+-+-+-+-+-+-+-+-+-+-+-+-+-+-+-+-+-+-+-+-+-+-+-+-+-+-+-+-+-+-+-+
|                                                                                             |
+ +-+-+-+ + +-+-+ + +-+-+-+-+ +-+-+ +-+-+-+ + + +-+-+-+-+-+ + +-+ + + +-+ +-+-+-+-+-+ + + + + +
|       | |     | |         |     |       | | |           | |   | | |   |           | | | | | |
+ + +-+-+ +-+-+-+ + +-+ + + + +-+ +-+ +-+-+-+ + +-+ + + +-+ +-+-+-+ + + + +-+-+-+-+ +-+-+ +-+-+
| |     |       | |   | | | |   |   |       | |   | | |   |       | | | |         |     |     |
+ + +-+-+-+ +-+-+ +-+ +-+-+ +-+ + + + + + + + + + + +-+ +-+ + + +-+-+ +-+ +-+ + +-+ + +-+ +-+-+
| |       |     |   |     |   | | | | | | | | | | |   |   | | |     |   |   | |   | |   |     |
+ + + +-+-+ +-+ +-+ +-+-+-+-+ +-+ + +-+-+-+-+ + + + +-+ +-+-+ + + + + +-+ +-+-+-+ + +-+ +-+-+ +
| | |     |   |   |         |   | |         | | | |   |     | | | | |   |       | |   |     | |
+ + +-+ + + +-+-+-+ +-+ +-+-+-+-+-+-+-+ + +-+ + + +-+-+ + + +-+-+ +-+-+-+-+ +-+ +-+-+ +-+ + + +
| |   | | |       |   |               | |   | | |     | | |     |         |   |     |   | | | |
+ +-+ + +-+-+-+-+ + +-+ +-+ + + +-+-+-+-+ + + + +-+-+ +-+-+ + + +-+ + +-+ + + + + +-+ +-+ + + +
|   | |         | |   |   | | |         | | | |     |     | | |   | |   | | | | |   |   | | | |
+ +-+ + +-+ + + + +-+-+-+-+ + +-+-+ + + + + + +-+ + + + + +-+ +-+ +-+-+-+-+ + + + + + + + +-+ +
|   | |   | | | |         | |     | | | | | |   | | | | |   |   |         | | | | | | | |   | |
+ + +-+-+ + +-+ + +-+ + +-+ + + + + +-+ +-+-+ + + +-+ +-+-+ +-+-+-+-+-+ +-+-+ +-+ +-+ +-+-+ +-+
| |     | |   | |   | |   | | | | |   |     | | |   |     |           |     |   |   |     |   |
+ + + +-+ +-+-+ + +-+-+-+-+ +-+-+-+-+ + + +-+ + +-+ +-+ + + + +-+-+ + + +-+ +-+ +-+ + + +-+ + +
| | |   |     | |         |         | | |   | |   |   | | | |     | | |   |   |   | | |   | | |
+ +-+ + +-+-+-+-+ + + + + +-+ +-+ + + + + + +-+ +-+ +-+ + + +-+-+ + + + + +-+-+ +-+-+ + + +-+ +
|   | |         | | | | |   |   | | | | | |   |   |   | | |     | | | | |     |     | | |   | |
+ + +-+-+ +-+ +-+-+-+-+-+-+-+-+ + + +-+-+-+-+-+-+-+-+-+-+-+ +-+ +-+ +-+ +-+ +-+-+ +-+ + + +-+-+
| |     |   |                 | | |                       |   |   |   |   |     |   | | |     |
+ +-+ +-+ +-+-+-+ + + + +-+-+-+-+ + +-+-+ +-+-+ + + + +-+-+-+ + + +-+ +-+-+ +-+-+-+ +-+-+-+ +-+
|   |   |       | | | |         | |     |     | | | |       | | |   |     |       |       |   |
+ + + +-+ +-+-+ +-+ + + + +-+ +-+ +-+ +-+-+-+-+ + + +-+ +-+ +-+ +-+-+ + + + + + +-+-+ + + +-+ +
| | |   |     |   | | | |   |   |   |         | | |   |   |   |     | | | | | |     | | |   | |
+ + + + + + +-+-+-+ + +-+ +-+ +-+-+ +-+-+-+ + +-+-+ +-+-+ +-+-+ +-+ + + +-+-+-+ +-+-+-+-+-+ +-+
| | | | | |       | |   |   |     |       | |     |     |     |   | | |       |           |   |
+ +-+ + +-+-+ +-+-+-+-+-+-+-+ +-+-+-+ + +-+-+ +-+ + +-+-+ + +-+ +-+-+-+ + +-+ + +-+ +-+-+ + + +
|   | |     |               |       | |     |   | |     | |   |       | |   | |   |     | | | |
+ + +-+ + +-+-+-+ +-+-+ + + +-+ + +-+ +-+ +-+-+ + +-+ + +-+ +-+-+-+ +-+ +-+-+-+-+-+-+ + +-+-+ +
| |   | |       |     | | |   | |   |   |     | |   | |   |       |   |             | |     | |
+ +-+ + + +-+ +-+-+-+ + + + +-+-+ + + + +-+-+ + +-+ +-+-+-+ +-+ + + + +-+ + + + +-+ + + +-+-+-+
|   | | |   |       | | | |     | | | |     | |   |       |   | | | |   | | | |   | | |       |
+ +-+-+ + +-+-+ + + + + +-+ +-+-+ + + + + + + +-+ + + +-+-+-+ +-+ + +-+ + +-+-+-+ +-+ +-+-+ + +
|     | |     | | | | |   |     | | | | | | |   | | |       |   | |   | |       |   |     | | |
+ +-+-+-+-+ +-+-+ + + +-+ + +-+ + + + +-+ +-+ + + +-+ + + + + +-+-+-+-+-+-+-+ +-+-+ +-+ + +-+ +
|         |     | | |   | |   | | | |   |   | | |   | | | | |               |     |   | |   | |
+ +-+-+ + +-+ +-+ + +-+ +-+-+ +-+-+ +-+-+ + + +-+ + + + +-+-+-+ +-+ + + +-+-+ +-+-+ + +-+ +-+-+
|     | |   |   | |   |     |     |     | | |   | | | |       |   | | |     |     | |   |     |
+ +-+ + + +-+ + + + + +-+ + +-+-+ +-+-+ +-+-+-+ + +-+-+-+ +-+ +-+-+-+-+-+-+-+ +-+-+ +-+-+-+-+ +
|   | | |   | | | | |   | |     |     |       | |       |   |               |     |         | |
+ + +-+-+-+ + +-+-+-+-+ +-+-+-+-+-+ +-+ + + + +-+ + + +-+-+ + +-+-+ +-+ +-+-+-+ + + +-+ +-+-+-+
| |       | |         |           |   | | | |   | | |     | |     |   |       | | |   |       |
+ +-+ + + + + + + +-+-+-+-+ + +-+-+-+ +-+-+-+ + + + +-+ +-+ +-+-+ +-+-+-+-+ + +-+-+ +-+-+ +-+-+
|   | | | | | | |         | |       |       | | | |   |   |     |         | |     |     |     |
+ + +-+-+ + + +-+-+ +-+-+ + + + + + + + + + + + +-+-+ + +-+-+ + + +-+-+-+ + +-+-+-+-+ + + + +-+
| |     | | |     |     | | | | | | | | | | | |     | |     | | |       | |         | | | |   |
+ + + + +-+-+ + + + + + + + + +-+-+ +-+-+-+ + +-+ + + +-+-+-+ + + + + +-+-+-+-+-+-+-+-+ +-+-+ +
| | | |     | | | | | | | | |     |       | |   | | |       | | | | |                 |     | |
+ + +-+ +-+ + + + +-+-+ +-+-+ +-+-+-+-+-+ +-+ +-+ + + + +-+-+-+ + +-+ + +-+-+-+ + +-+ + +-+-+ +
| |   |   | | | |     |     |           |   |   | | | |       | |   | |       | |   | |     | |
+ +-+-+ + + + +-+-+-+-+ + + + + +-+-+ + + +-+-+-+ +-+-+-+-+-+ +-+ + +-+ + +-+ +-+ +-+-+-+ + + +
|     | | | |         | | | | |     | | |       |           |   | |   | |   |   |       | | | |
+ + +-+-+ +-+-+ + + + + + + +-+-+-+-+-+-+-+-+-+ + + + + +-+-+ + + + + + + + +-+ +-+-+ + + + +-+
| |     |     | | | | | | |                   | | | | |     | | | | | | | |   |     | | | |   |
+ +-+ + +-+-+-+ +-+-+ +-+-+ + + +-+ + + +-+ +-+ +-+ +-+-+-+-+-+ + +-+ + +-+ + +-+-+-+-+ + + +-+
|   | |       |     |     | | |   | | |   |   |   |           | |   | |   | |         | | |   |
+ + + +-+ + + +-+-+-+ +-+ +-+ + +-+ +-+ + +-+-+ + +-+ +-+ + + +-+ + + +-+-+-+-+ +-+-+-+ +-+-+-+
| | |   | | |       |   |   | |   |   | |     | |   |   | | |   | | |         |       |       |
+ +-+-+ + +-+ + +-+-+ +-+ +-+ +-+ + +-+ +-+-+ +-+-+ + + + + + +-+-+ + + +-+ +-+-+-+-+ +-+ + +-+
|     | |   | |     |   |   |   | |   |     |     | | | | | |     | | |   |         |   | |   |
+ +-+ +-+ +-+-+-+ + + +-+-+-+ +-+ + + +-+-+ + + +-+-+-+-+-+ + + +-+ +-+-+-+ +-+ +-+-+-+-+-+-+ +
|   |   |       | | |       |   | | |     | | |           | | |   |       |   |             | |
+ +-+-+ +-+ +-+ + +-+-+ +-+-+-+ + + + +-+-+ +-+-+ + + +-+ +-+-+ +-+ +-+ + +-+-+ + + + + + + +-+
|     |   |   | |     |       | | | |     |     | | |   |     |   |   | |     | | | | | | |   |
+ + +-+-+ + + + +-+-+-+-+ + + +-+ + +-+ + + +-+ + + + +-+ + +-+ +-+-+-+-+ + +-+-+ +-+-+ +-+-+-+
| |     | | | |         | | |   | |   | | |   | | | |   | |   |         | |     |     |       |
+ + +-+ +-+ + +-+ +-+-+-+-+ +-+ + + +-+-+ +-+-+-+-+-+ + +-+ +-+ + +-+ + + + +-+-+-+ + + + + + +
| |   |   | |   |         |   | | |     |           | |   |   | |   | | | |       | | | | | | |
+ +-+-+-+ +-+ +-+ +-+-+-+ + + +-+-+ + + + +-+-+ +-+-+ + + +-+-+-+-+-+ +-+ + + + + + +-+-+ + +-+
|       |   |   |       | | |     | | | |     |     | | |           |   | | | | | |     | |   |
+ + + + + +-+ + +-+-+ + +-+-+ +-+ +-+ +-+-+-+ + +-+-+-+-+ +-+ + +-+-+ + +-+-+-+-+ +-+-+-+ + + +
| | | | |   | |     | |     |   |   |       | |         |   | |     | |         |       | | | |
+ + +-+-+ +-+-+-+-+ +-+-+ + +-+ + + + + +-+ + + + +-+-+ +-+ +-+-+ +-+-+-+ +-+-+ +-+-+ + +-+-+ +
| |     |         |     | |   | | | | |   | | | |     |   |     |       |     |     | |     | |
+ +-+-+ +-+ + +-+-+-+ + +-+-+-+-+ + +-+ +-+-+ + + +-+-+-+-+-+-+-+-+-+-+ +-+ +-+-+ +-+ +-+-+-+-+
|     |   | |       | |         | |   |     | | |                     |   |     |   |         |
+ +-+ + +-+-+-+-+ +-+ +-+-+ +-+-+-+-+ +-+ +-+ + + +-+-+ +-+ +-+-+-+-+-+ +-+-+ +-+ + + +-+ + + +
|   | |         |   |     |         |   |   | | |     |   |           |     |   | | |   | | | |
+ +-+-+-+ + +-+ +-+-+ +-+ +-+-+-+-+-+ + + +-+ + +-+ +-+-+ +-+ +-+ +-+ +-+ + +-+-+-+ + +-+-+-+-+
|       | |   |     |   |           | | |   | |   |     |   |   |   |   | |       | |         |
+ +-+ +-+-+ + +-+-+ + +-+-+-+-+ + + +-+-+ +-+-+-+-+-+-+ + + + + + +-+-+-+-+ +-+ + + +-+ +-+-+-+
|   |     | |     | |         | | |     |             | | | | | |         |   | | |   |       |
+ +-+-+-+-+-+ + + +-+ +-+ + + + + +-+-+-+ +-+ +-+-+-+ +-+-+-+-+-+ +-+ +-+ + + +-+-+ +-+-+ +-+-+
|           | | |   |   | | | | |       |   |       |           |   |   | | |     |     |     |
+ + + + + +-+ + +-+-+ +-+ +-+ +-+-+ +-+ + + +-+-+ +-+ + + +-+-+-+ + + + + +-+ +-+ + +-+ + + +-+
| | | | |   | |     |   |   |     |   | | |     |   | | |       | | | | |   |   | |   | | |   |
+ +-+-+-+-+-+-+-+ +-+-+ + + + + +-+-+-+-+-+-+-+-+-+ + + + + +-+-+-+-+ +-+-+ + + +-+ + + + +-+ +
|               |     | | | | |                   | | | | |         |     | | |   | | | |   | |
+ + +-+ +-+ + + + +-+ +-+ + + +-+-+ +-+-+ + + + + +-+-+ + +-+ + +-+ + + +-+-+ + +-+-+-+-+-+-+-+
| |   |   | | | |   |   | | |     |     | | | | |     | |   | |   | | |     | |               |
+-+-+-+-+-+-+-+-+-+-+-+-+-+-+-+-+-+-+-+-+-+-+-+-+-+-+-+-+-+-+-+-+-+-+-+-+-+-+-+-+-+-+-+-+-+-+-+