+-+-+-+-+-+
|     |   |
+-+ +-+ +-+
|         |
+ +-+ +-+-+
| | |     |
+ + + +-+ +
|   | |   |
+ +-+-+-+ +
|   |     |
+-+-+-+-+-+