+-+-+-+-+-+-+-+-+-+-+-+-+-+-+-+-+-+-+-+-+-+-+
|                                           |
+ +-+ + + +-+ +-+ + + + + + + + + + + + + + +
| |   | |   |   | | | | | | | | | | | | | | |
+ + + +-+ +-+ + + + + +-+ + + + +-+ + +-+ + +
| | |   |   | | | | |   | | | | |   |   | | |
+ + +-+-+-+ +-+ +-+-+ + + + + +-+ +-+-+ + + +
| | |       |       | | | | | |       | | | |
+ +-+ + + +-+-+ + +-+ + + + +-+ + +-+ + + + +
| |   | | |     | |   | | |   | | |   | | | |
+-+-+-+ +-+-+ +-+ + +-+-+-+ + + + + +-+ + + +
|         |     | | |       | | | | |   | | |
+ + + +-+-+ +-+ + + +-+-+-+ + +-+ + + + + +-+
| | |   |     | | |   |     |   | | | | |   |
+ +-+ + + + + +-+-+ + +-+ + + +-+-+-+ + + + +
| |   | | | |     | |   | | |       | | | | |
+ + + + + +-+-+-+ +-+-+ + +-+-+ + + +-+ + + +
| | | | |       | |     | |     | |   | | | |
+ + +-+ + + +-+-+ + + + + + + +-+ +-+-+ +-+ +
| | |   | |     | | | | | | | |   |       | |
+ + +-+-+ + + +-+-+ + + + +-+ + +-+ + +-+ +-+
| |     | | |     | | | |   | |   | | |     |
+ +-+-+-+ + +-+ + + + +-+ + +-+-+ + + + + + +
| |       |   | | | | |   |   |   | | | | | |
+-+ + + + + +-+ + + +-+ +-+ +-+-+-+ +-+-+ + +
|   | | | | |   | | |   |       |   |     | |
+ + + +-+-+ +-+ + + + +-+ + + + + +-+ +-+ + +
| | | |     |   | | | |   | | | | |     | | |
+ + + + +-+ + + +-+ + +-+-+-+-+ + + +-+-+-+ +
| | | |   | | | |   |       |   | | |       |
+ + + + +-+-+-+ +-+-+-+-+-+ + +-+ + + +-+-+ +
| | | | |                 | |   | | |     | |
+ + + +-+ + + + + + +-+-+ + + +-+ + + + +-+ +
| | |   | | | | | |   |   | |   | | | | |   |
+ + + + +-+ + + +-+ +-+-+ + + + + + +-+ + + +
| | | |   | | | |   |     | | | | | |   | | |
+ + +-+-+ +-+ + + + +-+ + + + + + +-+ + + + +
| | |       | | | |   | | | | | | |   | | | |
+ +-+ + + + +-+ + + + +-+ + + +-+-+ + + + + +
| |   | | | |   | | |   | | |   |   | | | | |
+ +-+-+-+ +-+ +-+ + + + +-+-+-+ +-+ + + + + +
|       | |     | | | |       | |   | | | | |
+ +-+-+-+ + + + + + + +-+ +-+ +-+ + +-+ + + +
|     |   | | | | | |   | |   |   |   | | | |
+-+-+-+-+-+-+-+-+-+-+-+-+-+-+-+-+-+-+-+-+-+-+