+-+-+-+-+-+-+-+-+-+-+-+-+-+-+-+-+-+-+-+-+-+-+-+-+-+-+-+-+-+-+-+-+-+-+-+-+-+-+-+-+-+-+-+-+-+-+-+
| |     |   |               |   |                 |       |             | |         |     |   |
+ +-+ + + + + +-+-+-+ +-+-+-+ + + +-+-+ +-+-+ +-+ +-+-+ + + +-+ +-+-+-+ + + +-+-+ + + + + +-+ +
| |   |   | | |     |         |   |   | |   | | |       | |   |     | | | | |     | | | | |   |
+ + +-+-+-+ + +-+ + +-+-+-+ +-+-+-+ + +-+ + + + +-+-+-+-+ +-+ +-+-+ + + + + + +-+-+ + + + + + +
| |   | |   |   | | |     | |     | |     |   |     |   |   |   |   |   |   | |   | | | |   | |
+ +-+ + + +-+-+ + +-+ +-+ + + +-+-+ +-+-+-+-+-+ +-+ + +-+-+ +-+-+ +-+ +-+-+-+ + +-+ + + +-+-+ +
| |   | | |   | | |   |   |   |     |   |       |     |   |   |   | |         | |   | |     | |
+ + +-+ + + + + + + +-+ +-+-+-+ +-+-+-+ + +-+ +-+-+-+-+ + +-+ + +-+ +-+-+-+-+-+ + +-+ +-+-+ + +
| | |   | | | | | |   |       |   |     |   |           |   | |   |     |         |   |   | | |
+ + +-+ + + +-+ + +-+ +-+-+-+ + + + + + +-+ +-+-+-+-+-+-+-+ + + + +-+ +-+ +-+-+-+-+-+-+ + + + +
| |   | | | |   |   | |     | | | | | | |   |       |       | | | |   |   |   |     |   |   | |
+ +-+ + + + + +-+ + + +-+ +-+ + + +-+ +-+ +-+-+-+ + + +-+ +-+ +-+ + + + +-+-+ + + + + +-+-+-+ +
|     |   |   |   | | |   |   | |   |   |         | | |   |   |   | | |     |   | |   | |     |
+-+-+-+ +-+ +-+ +-+ + + +-+ +-+-+-+ + + +-+-+-+-+-+ + +-+-+ +-+ +-+ +-+-+-+ +-+-+ +-+-+ + +-+-+
|     |   |   | |   | |     |       | |   |     |   |     |     |   |   |   |   | |     |   | |
+ +-+ +-+ +-+ + +-+-+ + +-+-+ +-+-+-+ + +-+ +-+ + +-+-+-+ +-+-+-+ + + + + +-+ + + +-+-+ +-+ + +
|   |   |   |   |     |       |   |   |     | | |       |         |   |   |   |   |   |   | | |
+-+-+ + +-+ +-+ + +-+-+-+-+-+-+ +-+ +-+-+-+-+ + +-+-+-+ +-+-+-+-+-+-+-+-+-+-+ +-+-+ + + + + + +
|     |   |   | |       |     |     |   |     |         | |                   |     | | | |   |
+ +-+-+-+ +-+ +-+ +-+-+ + +-+-+ +-+-+ + +-+-+ +-+-+-+-+-+ + +-+-+-+ +-+-+-+-+-+ +-+-+ +-+ +-+ +
| |     |   |   | |   | | |     |     | |         |         |     | |     |     |   |   |   | |
+ + +-+ +-+-+-+ + + +-+ + + +-+-+-+-+ + + +-+-+-+ +-+-+-+-+-+ +-+ + + +-+ +-+-+ + + +-+ + + + +
| |   |       | | |   | |             |   |     |       |     | | |     |   |   | | |   | | | |
+ +-+ +-+-+ + + + +-+ + + +-+-+-+-+-+-+-+-+ +-+ +-+-+-+ + +-+-+ + + +-+-+-+ + +-+ +-+ +-+ + + +
| |   | |   | | |     | |   |   |     |       |       | |   |     | |     | |   |         | | |
+ + +-+ + +-+ + +-+-+-+ +-+ + + +-+-+ + +-+-+-+-+ +-+ + +-+ + +-+-+ + +-+ + + + +-+-+-+-+-+ + +
|   |   |   | | |     |   | | | |   |       |   | |   |     | |     | |     | |           | | |
+ +-+-+ +-+ +-+ + +-+ +-+ +-+ + + + +-+-+-+-+ + +-+ + +-+-+-+ +-+ +-+ +-+-+-+ +-+-+-+-+-+ +-+ +
| |     |   |   | | |   |     | | |           | |   |       |   |   |   |   | |     |   |   | |
+ + +-+-+ +-+ +-+ + +-+ +-+-+-+ + +-+-+-+ +-+-+ + +-+-+-+-+-+-+ +-+-+ + + + + +-+ + + + +-+ + +
|   |   |   |   | |     |   |   | |       |   |   |     |     |     | | | | |     |   | |   | |
+ +-+ + + + +-+ + + +-+-+ + + +-+ +-+-+-+-+ + + +-+ +-+ + + + +-+-+ + + +-+ +-+-+-+-+-+ + +-+ +
| |   | | |   |   |       | | |     |       | | |   | | | | |   |   | |   |           | |     |
+ + +-+ +-+-+ +-+-+-+-+-+-+ + + +-+ + +-+-+-+ +-+ +-+ + + + +-+-+ +-+ +-+ + +-+-+-+-+-+ +-+-+-+
| | | |         |     | |   | | |   | |   | |     |   | | |       | |   | |         |   |     |
+-+ + +-+-+ +-+-+ + + + + +-+ +-+ +-+ + + + +-+-+-+-+ + + +-+-+-+-+ +-+ + +-+-+-+-+ + +-+ +-+ +
|   |   |   |     | |   | |     |   |   | |   |       |   |     |   |   |         |       |   |
+ +-+ + + +-+ +-+-+ + +-+ + +-+ +-+ +-+-+ + +-+ + +-+-+-+-+ + + + + + +-+-+-+-+-+ +-+-+ +-+-+-+
| |   | | | | |   | | |   | |   |     |   |     | |         | |   | |     |     |     | |     |
+ +-+-+ + + + + +-+ + + +-+-+ +-+ + +-+ +-+ +-+-+ + +-+-+-+-+ +-+-+ +-+-+ +-+-+ +-+-+ +-+ +-+ +
| |   | |   | | |   | |     |   | | |   | | |   | |     |   |     |     |   |     | |     |   |
+ + + + +-+ + + + +-+-+-+-+ +-+ + +-+ +-+ + + +-+ +-+-+ + + +-+-+ +-+-+ +-+ + +-+ + +-+-+ + +-+
| | | |     |   |         |     | |   |       |       |   | |   |   |   | |   | | | |   | |   |
+ + + +-+ +-+-+ +-+-+-+ + +-+-+-+ + +-+ +-+-+-+ +-+-+ +-+-+ + + +-+ +-+ + +-+-+ + + + + +-+-+ +
|   |   | | |   |   |   |       |   |   |     | |   |   | | | |   |   |   |       | | |   |   |
+-+-+-+ + + + +-+-+ + +-+-+ +-+-+ +-+-+-+ +-+ + + + +-+ + + +-+ + +-+ +-+ + +-+-+-+ + +-+ + +-+
|       |   |     | |   |   |   |     |   | | |   | |     |   | | |   |   |   |     | | | |   |
+ +-+-+-+-+ +-+-+ + +-+ +-+-+ + +-+-+ + +-+ + + +-+ +-+ +-+-+ +-+ + +-+-+-+-+ + +-+-+ + + +-+ +
| |             | |   | |     |       | |   | |   |   | |   |     |   |         |     |   |   |
+ + +-+-+-+-+-+ + +-+ + + +-+-+-+-+-+-+ + + + +-+-+ + +-+ + + +-+-+-+ + +-+-+-+ + +-+-+ +-+ + +
| |     |     | |     |   |           | | |   |   | | |   | | |     |     |   | |     |     | |
+ +-+-+-+ +-+ + +-+-+ +-+-+-+-+-+ +-+ + +-+-+ + + +-+ + +-+ + + +-+ +-+-+-+ + +-+ +-+ +-+-+-+-+
|       | | | | |   | |       |   | | |     |   |     |   |   | |   |     | |   |   | |       |
+ +-+-+ + + + + + + + +-+-+ + + +-+ + +-+ + +-+-+-+-+ +-+ +-+-+ + +-+ +-+ + +-+ +-+ + + +-+-+ +
| |     |   | | | | |   |   |   |   |   | |   |   |   | | |   | |     | |   |   |   | |   |   |
+ + +-+ + +-+ + + +-+-+ + +-+-+-+-+ +-+ + +-+ + + + +-+ + +-+ + +-+-+-+ +-+-+ +-+-+ + + +-+ + +
| | | | | |   |   |   |   |         | | | | | | | |     |     |   |   |     |     | |   |   | |
+-+ + + + + +-+-+-+ + +-+-+ +-+ +-+ + + + + + + + +-+-+-+ +-+-+ + + + + +-+ +-+-+ +-+-+-+ +-+-+
|   |   | |     |   |     | |   |     | |   | | |       | |   | | | |   | |     |       | |   |
+ +-+-+ + +-+-+ + +-+-+ + + + +-+-+-+ + +-+-+ + +-+-+-+ + + + +-+ + +-+-+ +-+ +-+-+-+-+ + + + +
|     | | |     | | |   | | | |     | |     | | | |   |   | |     |   |     |       |   |   | |
+ +-+ +-+ + +-+-+ + + +-+-+ + + +-+ +-+-+-+ + + + + + +-+-+ +-+ +-+-+ +-+-+ +-+-+ +-+ +-+ +-+ +
|   |     | |     | |     | | |   |       | | | | | |     | |   |   |       |   | |   |     | |
+-+ +-+-+-+ + +-+-+ +-+-+ + + +-+ +-+-+-+ + + + + + +-+-+ + +-+-+ + +-+-+-+ +-+ + + +-+-+-+-+ +
|   |   |   |     |   |   | |   | |   | |   | | | |     | |   |   | |     |   | | |     |     |
+ +-+-+ + + +-+-+ + +-+ + + +-+ + + + + +-+-+ + + + +-+-+ +-+ + +-+ + + +-+-+ + + +-+-+ + +-+ +
| |   | | |     |   |   | | | | |   |   |     | |   |       |   |   | | |     | |     | |   | |
+ + + + + +-+-+-+-+ + +-+-+ + + +-+-+-+ + + + + +-+-+ +-+-+ +-+-+ +-+ +-+ +-+-+ + +-+ + + + + +
|   |   |         | |     | | |       | | | | |       |         | |       |   | | |   | | | | |
+-+-+-+ +-+-+-+-+ + +-+-+ + + +-+-+ +-+ + + +-+-+-+-+ +-+-+-+-+-+ + +-+-+-+ + + + +-+-+ + + +-+
| |     |       | |   |   | |     |     | |     |     |   |       | |       |   | |     | |   |
+ + +-+-+-+ + +-+ +-+ + +-+ + +-+-+-+-+-+ +-+-+ + +-+-+ + + +-+-+-+ +-+-+ +-+-+ + + +-+-+ +-+ +
|   |     | |   |     |     |     |       |     | |   | |   |     | |   |   |   | | |   | |   |
+ +-+ +-+ + +-+ +-+-+-+-+-+-+ +-+ + +-+-+-+ + +-+ + +-+ +-+-+-+ + + + + +-+ + +-+ + + + + + +-+
| |   |   | |     |     |       |   |     | | |   |   |   |     | |   |     |   |   | |   |   |
+ +-+ + +-+ + +-+ + +-+ +-+-+-+ +-+-+-+ + + +-+ +-+ + +-+ +-+ +-+-+-+-+-+-+-+-+ +-+-+ +-+-+-+ +
|     |   | |   |   | |       | |       | |   | |   |   |   |         |       | | |         | |
+-+-+-+-+ +-+-+ +-+-+ +-+-+-+ + +-+-+ +-+ +-+ + +-+-+-+ +-+ +-+-+-+ +-+ +-+ +-+ + + +-+-+-+ + +
|       |       |   |         |     |   |   |       |     |       |     | |   | |   |   |   | |
+ +-+-+-+-+-+-+-+-+ + +-+-+-+-+-+-+ +-+ +-+-+-+-+-+ + +-+ +-+-+-+ + +-+-+ +-+ + +-+-+ + +-+-+ +
| |               | |           |     | |   |   | |   | |   |     |     |   | | |     |       |
+ + +-+-+-+ +-+-+ + +-+-+-+-+-+ +-+-+ + + + + + + +-+-+ +-+ + +-+-+-+-+ + + + + + +-+-+-+-+-+ +
| | | |     |   |       |     |   | |   | |   | |         | | |       | | | | |   |     |     |
+ + + + +-+ + + +-+-+-+ + +-+-+-+ + + +-+ +-+-+ + +-+ +-+-+ + + +-+ + + +-+ + +-+-+ +-+ + +-+-+
|   | |   | | |     |     |     | |   |   | |   |   | |   | | |   | | |     |     | |   |     |
+ +-+ +-+ +-+ +-+-+ +-+-+-+ + +-+ +-+-+ +-+ + +-+-+ + + + + + + +-+ +-+-+-+ +-+ +-+ + + +-+-+ +
|       |   | |   |         |   | |     |         | |   |   | | |   |       |   |   | | |     |
+-+-+-+ +-+ + +-+ +-+-+-+-+-+-+ + + +-+-+ +-+-+-+ +-+ +-+-+-+ + + +-+ +-+-+-+ +-+ +-+ +-+ +-+-+
| |   | | | |   |   |         |   |   |   |   | |   |   |     | |     |     |   |   |     |   |
+ + + + + + +-+ + + +-+ +-+-+ +-+-+-+ +-+-+ + + +-+ +-+ + +-+-+ +-+-+-+ +-+ +-+ +-+ +-+-+-+-+ +
|   |   | |     | |     |     |     |       | |   | |   |   | | |       | |   |   |         | |
+ +-+-+-+ +-+-+-+ +-+-+-+ +-+-+ +-+ +-+-+-+-+ + + + +-+-+-+ + + +-+-+ +-+ +-+ +-+ +-+-+-+-+ + +
|                 |             |             | |           |         |         |             |
+-+-+-+-+-+-+-+-+-+-+-+-+-+-+-+-+-+-+-+-+-+-+-+-+-+-+-+-+-+-+-+-+-+-+-+-+-+-+-+-+-+-+-+-+-+-+-+