+-+-+-+-+-+-+-+-+-+-+-+-+-+-+-+
| |   |   |           |       |
+ + + + +-+-+ +-+ +-+-+ +-+-+-+
| | |     |   |   | |     |   |
+ + +-+-+ +-+-+-+ + +-+ + + +-+
|       |   | |   |     |   | |
+-+ +-+-+-+ + + +-+-+-+-+-+ + +
| |     | |     | |   |     | |
+ +-+-+-+ +-+-+ + +-+ +-+-+ + +
|     |     |   |   |         |
+-+ +-+ +-+-+ + + +-+-+ +-+ + +
|     |       |           | | |
+ +-+ +-+ +-+ +-+-+ + +-+-+-+ +
|   |     |   |     |     |   |
+ + + +-+ + +-+ +-+-+-+ + +-+-+
| | | | | |   | | |     | |   |
+ +-+-+ +-+ +-+-+ + +-+ + +-+ +
| |       | |   |   |   | |   |
+ +-+-+-+ + + +-+-+ + + +-+ +-+
|   |   |         | | |   | | |
+-+-+-+ + +-+-+ +-+-+-+-+ + + +
| |     |     |   |   |       |
+ + +-+-+-+-+-+ +-+-+ +-+ +-+ +
|       |   |   |   |     | | |
+ +-+-+-+ +-+-+ + +-+-+-+ + + +
|           |     |   | | |   |
+-+ +-+-+ + +-+ +-+ +-+ + +-+ +
|       | |           |   |   |
+ + + + +-+ + +-+-+ + +-+-+ +-+
| | | | |   | |     | |       |
+-+-+-+-+-+-+-+-+-+-+-+-+-+-+-+