+-+-+-+-+-+-+-+-+-+-+-+-+-+-+-+
|                             |
+-+-+ + + +-+-+-+ + + +-+ + + +
|     | |   |     | | |   | | |
+ + + +-+-+ + + +-+ + + + + + +
| | |     | | |   | | | | | | |
+-+ + + + +-+ + + + + + +-+ + +
|   | | | |   | | | | | |   | |
+-+ + + + + + + + +-+ + + + + +
|   | | | | | | |   | | | | | |
+ +-+ + + + + + + +-+-+ + +-+ +
| |   | | | | | |   |   |   | |
+ + + + + + +-+ + + +-+-+-+ + +
| | | | | | |   | |   |     | |
+ + + + + +-+ + + +-+ + + + + +
| | | | | |   | | |   | | | | |
+ + + +-+-+ + +-+-+ + + + + + +
| | | |     |     | | | | | | |
+ + +-+ + + +-+ + + + + +-+ + +
| | |   | |   | | | | |   | | |
+ + +-+-+ + +-+ + +-+ + + + + +
| |   |   |   | | |   | | | | |
+-+ +-+ +-+ +-+ + +-+-+ + + +-+
|     | |     | |     | | |   |
+ + + +-+ + + + + + + +-+ + + +
| | | |   | | | | | |   | | | |
+ +-+ + + + + + + + +-+-+ + + +
| |   | | | | | | |   |   | | |
+ + + +-+-+ +-+ +-+ +-+ + + + +
| | | |       |   |   | | | | |
+-+-+-+-+-+-+-+-+-+-+-+-+-+-+-+