+-+-+-+-+-+-+-+
|     | |     |
+ +-+-+ + + + +
|   |     | | |
+ +-+-+-+-+ +-+
|             |
+ + +-+-+ +-+-+
| | |     |   |
+-+ + +-+ + + +
| | | |     | |
+ + +-+ +-+-+-+
|   |         |
+-+ + + +-+-+-+
|   | |       |
+-+-+-+-+-+-+-+