+-+-+-+-+-+-+-+-+-+-+
|   |       |       |
+-+ + +-+ + +-+-+ + +
|   | |   |       | |
+ +-+ + +-+-+-+-+-+ +
|   | |   |     |   |
+-+ +-+-+ + + +-+ +-+
| |     | | |       |
+ +-+-+ + +-+-+-+-+ +
|   |   |       | | |
+ + + +-+ +-+-+ + + +
| |   |   |     | | |
+ +-+-+-+-+ +-+-+ + +
| |         | |     |
+ +-+ +-+-+-+ + +-+-+
|   |   |     |     |
+-+ +-+ + + +-+-+-+ +
| |   | | | |       |
+ +-+ + + + + +-+-+-+
|       | |         |
+-+-+-+-+-+-+-+-+-+-+