+-+-+-+-+-+-+-+-+-+-+-+-+-+-+-+-+-+-+-+-+-+-+-+-+-+-+-+-+
|   | |   | | |   |   |   |       |   |   | |     |   | |
+ +-+ +-+ + + +-+ + + + +-+-+-+-+ +-+ + +-+ +-+ +-+ + + +
|         |   | | | |     |         |       |       |   |
+ + +-+-+ +-+ + + + + +-+-+ + + +-+ + +-+ +-+ + +-+ +-+-+
| | |       |       |   |   | |   |     | |   |   |     |
+ +-+ +-+-+ +-+ + +-+-+ +-+ +-+-+ +-+-+-+-+ +-+ +-+ + + +
| |   | | | | | |   |     |   |   | | |     |   | | | | |
+ +-+-+ + + + +-+-+-+-+-+ + +-+-+-+ + +-+-+-+ + + + +-+-+
| |       |       |     |               |     |   |   | |
+ + +-+ +-+ + + +-+-+-+ + +-+-+-+-+-+ +-+-+ +-+ + +-+ + +
| | |   |   | |   |   |   | | |   |     |   | | |   |   |
+-+-+ +-+ +-+ + + +-+ + +-+ + +-+ + + +-+-+ + + +-+-+ +-+
| | |     | | | | | |   |       |   |         | |     | |
+ + +-+ + + +-+-+ + + +-+-+ +-+ +-+-+-+ +-+ + +-+-+-+-+ +
|     | |   |     |       | | | | |   | |   |       | | |
+ + + + +-+-+-+-+ +-+-+ +-+ + + + +-+ + + +-+-+ +-+-+ + +
| | | |       | | |   |     |   | | |   |   | |   |     |
+-+ +-+ +-+-+-+ + + +-+ +-+-+-+ + + +-+-+-+-+ + +-+ + +-+
| |     |       |           |   |   |   |   |       |   |
+ +-+ +-+-+-+-+ + + + +-+-+ +-+ + + + +-+-+ + +-+ + + +-+
| |     |   |     | |   | | |   | |     | |   |   | |   |
+ + +-+-+-+ +-+ +-+-+ + + + +-+ +-+-+-+ + + +-+-+-+ +-+ +
| |     | |     | | | |   |   | | |   | |   | | |   |   |
+ +-+ +-+ +-+ +-+ + +-+-+-+-+-+-+ +-+ + +-+-+ + + +-+-+-+
|     |   |         | |     |     |     |       | |     |
+-+ +-+-+ + +-+ +-+ + +-+ +-+ +-+ + +-+ + + +-+ + +-+ +-+
|   |   |   |   |       |   |   | | |     |   |   | |   |
+-+ + +-+-+ + +-+-+-+ + + +-+ +-+-+ +-+-+ +-+ + +-+ + +-+
|     |   | | | |     |   | |   |   |     |   |     |   |
+-+-+-+-+ +-+-+ +-+-+-+-+ + +-+ + + + +-+-+-+-+ +-+-+-+ +
|   |   | |   |   | |     |   |   | | | |   | | | | |   |
+ +-+-+ + +-+ + +-+ + +-+-+ + +-+ +-+ + + +-+ + + + + +-+
|   |       |           |   |   | | |       | | |   |   |
+ +-+-+ + +-+-+ +-+-+ +-+ + +-+-+ + +-+-+ +-+ +-+ +-+ + +
|       |   |   | |   |   |   |         | |   | |   | | |
+-+ +-+ +-+-+-+-+ + +-+ +-+-+ + +-+ + +-+-+ + + + + + + +
|     |   |   |     | |   | | | |   | |     |   | |   | |
+-+-+-+ + + + + + + + + + + + +-+ +-+-+-+-+ +-+-+-+-+ + +
| |     | | | | | |   | |   | |           | |         | |
+ + + +-+-+-+ +-+-+-+-+-+-+-+ + +-+ +-+ +-+ + + +-+-+-+-+
| | | |     |   |   |   |     | |     |       |   |     |
+ +-+ +-+ +-+ +-+-+ + + +-+-+ +-+-+ +-+-+-+ + +-+ + +-+-+
| | | | |     |   | | | | | |       |       | |       | |
+ + + + + + +-+ +-+ +-+ + + +-+-+ +-+ + +-+-+-+-+-+-+ + +
|         |   |     |   |     |   | | | | |   | |   | | |
+-+ + +-+ + + + +-+ + +-+-+-+ +-+-+ + + + +-+ + +-+ + + +
|   | |   | | | |   |     |           |             |   |
+ +-+-+ +-+-+ + +-+ + + +-+ + +-+ + + +-+-+-+ +-+-+-+ +-+
| | | |   |       |   | |   | | | | | | |       |     | |
+ + + + +-+ +-+-+ +-+-+-+ + +-+ +-+-+ + + +-+ +-+-+-+-+ +
| |       | | |       | | | |   |   |   | |   | |       |
+-+-+-+ +-+ + +-+-+ + + +-+ + +-+-+ +-+-+-+-+ + +-+ + +-+
|   | | |       |   |       | |         | | | |     |   |
+-+ + + + + +-+-+ + +-+-+ + + + +-+ + +-+ + + + +-+-+ + +
|       | | |     | |     |       | |   |       |     | |
+-+-+-+-+-+-+-+-+-+-+-+-+-+-+-+-+-+-+-+-+-+-+-+-+-+-+-+-+