+-+-+-+-+-+-+-+-+-+-+-+-+-+-+-+-+-+-+-+-+-+-+-+-+-+-+-+-+-+-+-+-+-+-+-+-+-+-+
| |               | |   |         |   |     | |     | | |   |   |       |   |
+ + + +-+-+-+-+ +-+ +-+ + +-+-+-+ + +-+-+-+ + +-+-+ + + + +-+ +-+ +-+-+ + + +
|   |   |     |   |   |       | |   |           |       |   | |   | | |   | |
+-+-+ + + +-+-+ +-+ +-+-+-+-+-+ +-+ +-+ +-+ +-+ + +-+ +-+ + + + + + + +-+-+ +
|   | | |   |     |     |     | | |     |     | | | |   | | | | |   |     | |
+ +-+-+ + +-+ +-+ + + +-+ +-+ + + +-+ +-+-+-+-+-+ + +-+ + +-+ +-+ + + + +-+ +
|     |   | | |   | |       |     |     |       | |   | |         | | | | | |
+ + +-+-+-+ + +-+ + +-+-+-+ +-+-+-+-+ +-+-+ +-+ +-+ + + +-+-+ + +-+-+ +-+ +-+
| |       |   | | |   |     | | |   |     | |     | |       | |     |     | |
+-+-+-+-+ +-+ + +-+-+ + +-+ + + + + + +-+ +-+-+ + + +-+ + + + + +-+-+ +-+-+ +
|     | |       |   | | |   | | | |     |       | |   | | |   |     |   |   |
+ +-+ + + + +-+-+ + +-+-+ +-+ + +-+-+-+ + +-+-+ +-+-+-+ +-+-+-+ + + + +-+ +-+
| |       | |     |           |   |   | |     | |       |       | |   |     |
+-+-+ +-+ +-+-+-+ +-+-+-+ + + + +-+-+ + + +-+-+ +-+-+ + +-+ +-+-+-+-+ + +-+ +
| | | |   |       | | | | | |   |   |   | |   |   |   |   |     | |   |   | |
+ + + +-+-+-+ +-+-+ + + + +-+ + +-+ +-+-+-+-+ +-+ +-+-+ +-+ +-+-+ + +-+ +-+-+
|       |     |   |   |   |   |   |         |       |     |   | | | |     | |
+-+ +-+ +-+ +-+-+ +-+ +-+-+ + +-+ +-+-+ +-+ +-+-+-+ + +-+-+-+ + + +-+ +-+ + +
|     |   |   | |           | | | |   |   |   |   |   | |   | | |   |   |   |
+-+ + +-+-+-+ + +-+-+-+-+-+ +-+ + + + +-+-+ +-+-+ +-+ + +-+ + + + + + +-+ + +
|   |       | | |       |   |   | | |   |   |       |       | | | |   | | | |
+ + + +-+-+ +-+ +-+-+-+ + +-+-+ +-+ + +-+-+ + +-+ + + +-+ + +-+ + +-+-+ + + +
| | |   |   | | | |   |         |   |   |       | |   |   |       |       | |
+ +-+-+-+-+ + + + + +-+-+ +-+-+-+-+ + + + +-+-+-+-+ + +-+ + +-+-+ +-+ +-+-+-+
| |       |   |     | |     |   |   | | |     |     | | | | |   | |   |     |
+ + +-+ +-+-+ + +-+ + +-+ + + +-+-+ +-+-+-+ +-+-+-+-+-+ +-+ +-+ +-+ +-+ +-+ +
| | | | |       |       | |   |   |       |   |     | |   | | | | |       | |
+ +-+ + + + +-+ +-+ +-+-+-+ + + + + + +-+-+-+ +-+ +-+ +-+ + + + + +-+-+-+-+ +
| |       |   | |   | | | | |   | | |     |     |   |   |         |       | |
+ +-+-+-+ +-+-+-+-+ + + + + + + +-+-+-+ +-+-+ +-+-+ + +-+-+-+ + +-+-+-+ +-+ +
|   |       | | |           | | |         |     |   | | | |   |     | |   | |
+-+-+ +-+ +-+ + + +-+-+-+-+ + +-+ + +-+ + +-+-+-+ +-+ + + + + +-+-+ + + + +-+
|     |   |   |     | |     |   | | | | |     |   |   |     | |       | |   |
+-+ + +-+-+ + +-+-+-+ +-+-+ + +-+ + + + + + +-+-+ + + + +-+ +-+ +-+ + + + + +
| | |     | | | |         | |     | | | | | |   |   |   |     | | | |   | | |
+ + +-+ + + +-+ + +-+-+-+-+ + +-+ +-+ +-+-+-+ +-+-+ +-+-+-+ + +-+ + +-+ + +-+
| |   | |       | |   |   | | |   | |         | | |   | |   | |   |   | |   |
+ + +-+ + + +-+ + +-+ +-+ +-+-+-+ + + + +-+ +-+ + + +-+ + +-+-+-+ +-+-+ + + +
| | |   | | |   |           |   |   | | | |   |         |     |   | | | | | |
+ + +-+ +-+-+-+ + + +-+-+ + + +-+-+-+-+-+ + +-+ +-+-+ + +-+-+-+ +-+ + + +-+-+
|   | | |       | |   |   |               |       | | | |       |     | | | |
+ +-+ +-+-+-+ +-+-+ +-+-+-+ +-+ +-+-+-+-+ +-+ + +-+ +-+-+-+-+-+ + +-+-+-+ + +
| |   | |   | |       | |     |     | | |     | | | |   |   |     |       | |
+ + +-+ + + +-+-+-+-+-+ + +-+-+ +-+ + + +-+ +-+ + + + +-+ +-+-+ +-+-+ +-+ + +
|         |           |   | |     | |       |   | |   |     |   |       | | |
+-+-+-+ + +-+-+ +-+ +-+ +-+ +-+ +-+-+-+-+ + +-+-+ + +-+-+ +-+ +-+-+-+ +-+-+ +
| | | | |   |   |     | | |     |   |     |         | |   |     |     | |   |
+ + + +-+-+ + + +-+-+ + + +-+-+-+ +-+ +-+-+-+-+ +-+-+ + +-+-+-+ +-+ +-+ +-+ +
|     | |   | |     |       |   |   |       |     |     |   | |   |       | |
+ + +-+ +-+-+-+ + + + +-+-+ +-+ + +-+-+-+-+-+ + +-+ + +-+ + + +-+ + +-+-+ + +
| |     |   | | | | | | |     |     |         |   | | | | | |         |     |
+ +-+ + + +-+ + +-+-+-+ + +-+ + +-+ + +-+-+-+ + + + +-+ + + + +-+ +-+-+ + +-+
|   | |     |       |       |     | |   |     | |   | |   |     | | | | |   |
+-+ +-+-+-+ + +-+-+-+-+ +-+ +-+ +-+-+-+-+ +-+-+-+-+ + +-+ +-+-+-+-+ + + +-+ +
|   | | | |   |       | |   |     |       |   |     |         | |     | |   |
+-+ + + + +-+-+-+ +-+-+ + +-+-+-+-+-+-+-+ + +-+ +-+-+-+ +-+ +-+ +-+-+ + + + +
| |   | | |           | | | |       | | |     | |     |   |       |   | | | |
+ +-+-+ + + +-+-+-+-+-+-+-+ + + +-+ + + + +-+-+-+-+ + +-+-+-+ + +-+ +-+-+ +-+
|   |               |     |   | |       |     |     | |   | | | |   |   |   |
+ +-+-+-+ +-+ +-+ +-+ +-+ +-+ +-+-+ + + +-+ +-+-+ + +-+-+ + + + + +-+-+ +-+ +
| |         | | |       | |     | | | |       |   | |   |   | |   | | | | | |
+ + + + +-+ +-+ +-+ +-+-+-+ +-+-+ +-+-+ + + + + + + + + +-+ + +-+ + + + + +-+
|   | | |   |     |             |     | | | | | | |   | |   |   |     |     |
+ + +-+ +-+-+-+-+ + +-+ +-+-+ + +-+-+ +-+ + +-+ +-+ +-+-+ +-+ + +-+ +-+ + +-+
| |   |       |     |   |     | |     | | |     |         |   | | |     |   |
+-+ +-+ +-+-+-+-+ +-+-+ +-+-+ +-+-+-+ + + +-+-+ +-+-+ +-+-+ + + + +-+-+-+ + +
| | |       | |   |     |   |     | | |   |   | |           | |   |   |   | |
+ + +-+ +-+ + + +-+ +-+ + +-+ +-+-+ + + +-+-+ +-+-+-+ +-+-+-+ + +-+ +-+-+ + +
|     | | | |   |   |     | | | | |     | |   |     |   |   | | | | | |   | |
+-+-+-+-+ +-+-+-+ +-+-+-+ + +-+ + +-+ + + + + + +-+-+ +-+ + + +-+ + + +-+ +-+
|       |             | |     |     | | | | |       | |   |   |   |       | |
+ +-+-+ +-+ + +-+-+ +-+ +-+ +-+ +-+-+-+-+ +-+ + +-+ +-+-+ +-+ + + +-+ +-+-+ +
| |         |   | |     |   |     |       | | |   | |     |     | | | |     |
+-+-+ +-+ + + +-+ +-+ +-+-+ +-+ +-+ + +-+ + + +-+-+ + + +-+ + + +-+ + + +-+ +
|       | | |       |   |         | | |         |     |   | | |   |       | |
+-+-+-+-+-+-+-+-+-+-+-+-+-+-+-+-+-+-+-+-+-+-+-+-+-+-+-+-+-+-+-+-+-+-+-+-+-+-+