+-+-+-+-+-+
|         |
+ +-+ +-+ +
|   |   | |
+ +-+-+-+-+
|         |
+ +-+-+-+-+
|         |
+ +-+ +-+-+
|   |     |
+-+-+-+-+-+