+-+-+-+-+-+
|   | |   |
+ +-+ + + +
| |     | |
+ +-+-+ + +
| |     | |
+ +-+ +-+ +
| |   |   |
+ + + + +-+
|   | |   |
+-+-+-+-+-+