+-+-+-+-+-+-+-+-+-+-+-+-+-+-+-+-+-+-+-+-+-+-+-+-+-+-+-+-+-+-+-+-+-+-+-+-+-+-+-+-+-+-+-+-+-+-+-+-+-+-+
| |   |   |         |   |           |   |       |     |     | |                   |                 |
+ + + + + + +-+ +-+ +-+ + +-+-+ +-+-+ + + +-+ +-+ + + +-+ + + + +-+-+ +-+-+-+-+ +-+ +-+-+-+ +-+-+ + +
| | | | | |   |   |     | |   |       |   | |     | |   | | |     |   |         |   |     |     | | |
+ + + + + +-+ +-+ +-+ +-+ + + +-+-+-+-+-+-+ +-+-+-+ +-+ + + + +-+-+ +-+-+-+-+-+-+ +-+ +-+ +-+-+-+ + +
|   | | | |     |   | |   | |   |           |     | | | | | | | |   |               |   |     |   | |
+-+-+ + +-+ +-+-+-+ +-+ +-+ +-+ + +-+-+-+ + +-+-+ + + + + + + + + + + +-+-+-+-+-+-+-+-+ +-+-+ + +-+ +
|   | |       |   | |   |   | |     |     |   |   | | | | | |   | | |     |       |     |   |   |   |
+-+ + +-+-+ +-+ + + + +-+ +-+ +-+-+-+ +-+-+-+ + +-+ + + + + +-+-+ +-+-+-+ +-+ +-+-+ +-+-+ + +-+-+ +-+
|   |     | |   | | |   |     |       |       | |   |     |     |       |   | |     |     | |   |   |
+ + +-+-+ +-+ +-+ + +-+ +-+-+ + +-+ +-+-+-+ +-+ + +-+ +-+-+-+-+ +-+ +-+-+-+ + + +-+-+ +-+-+ + + +-+ +
| |     |     |   |         | |   | |     |     |   | |       |     |     | | |       | |   | |   | |
+ +-+-+ +-+-+-+ +-+-+-+-+-+ + +-+ + + +-+ +-+ +-+-+ +-+ +-+-+ +-+-+-+ + +-+ + +-+-+-+-+ + +-+ +-+-+ +
| |   |     |   |       |   |   | | | | | |   |   |     |   |   |     |   | |       |   | |   |     |
+ +-+ +-+ +-+ +-+ +-+-+ + +-+-+-+ +-+ + + +-+-+ + +-+ +-+ + +-+ + +-+-+-+ + +-+ +-+ + + + + + + +-+-+
|   |   | |   |       | |     |   |   |       | |   | |   |   | | |     | |   | |     | | | | |   | |
+ + + +-+ + +-+-+-+-+ + +-+-+ + +-+ +-+-+-+-+ + +-+ + + +-+-+ + + + +-+ + +-+ + +-+-+-+ + +-+ +-+ + +
| | |     | |         |   |     |   |   |     |   | | | |   |   | | |   |     |       | |   |       |
+ + +-+-+-+ + + +-+ +-+-+ +-+-+ + +-+ + +-+ +-+ + + +-+ + + +-+ + +-+ + +-+-+-+-+ +-+ + +-+ + +-+-+ +
| | |       | | |   |   |   |   |     |   |   | | |     | | |   |     |   |     | |   | | | | |   | |
+ + + +-+-+-+ + +-+-+ + +-+ + +-+-+-+ +-+ +-+ + + +-+-+ + + + +-+-+-+-+-+ + +-+ +-+ +-+ + + + + + + +
| | | |   |   |       | | | | |     |   | |   | | |     | | |     | |   |   | | |   |   | | | | | | |
+-+ + +-+ + +-+-+-+-+-+ + + +-+ +-+ +-+-+ + +-+-+ +-+-+-+ + +-+-+ + + + +-+-+ + + +-+ +-+ + +-+ + +-+
|   |   | |   |     | | | |     | |       | |   |   |   | |   |     | |     |   |   |     |     |   |
+ +-+-+ + +-+ + +-+ + + + +-+-+-+ +-+-+-+-+ + + + + + + + +-+ +-+-+-+ +-+-+ + +-+-+ +-+ +-+-+-+-+-+ +
|       |   | | | | | | |             |   |   | | |   | |   |         | |   |     | |   |       |   |
+ +-+-+-+ +-+ + + + + + +-+-+-+-+-+ + + + +-+-+ + +-+-+ +-+ +-+-+-+-+-+ + +-+-+-+ + +-+-+ + +-+-+ + +
| | |       |   |     |       |   | | | | |   | | |       |   |     |   |   |   | |       | |     | |
+ + + +-+-+ + +-+-+ +-+-+ +-+ + + +-+ + + + + + +-+ +-+-+ +-+ +-+ + + + +-+ + + + + +-+-+-+ + +-+-+ +
| |       |   |   | |   |   |   |   | | | | |   |   |       |   | |   | |   | |   |   |   | | |   | |
+ + +-+-+-+ +-+ + +-+ + +-+ +-+-+-+ + + + + +-+-+ +-+-+-+-+-+-+ + +-+-+ + + + +-+-+-+ + + + + +-+ + +
| |   |   | |   | |   | |   |       |   |   |             |   | | |     | | | |   | |   | | | |   | |
+ +-+-+ + +-+ +-+ + +-+ +-+ + +-+-+-+ +-+-+-+-+ +-+-+ +-+ + + + +-+ + +-+ + + + + + + +-+-+ + + +-+ +
|       |     | |   | |   | | |     |   |     | |   | | |   | | |   | |   | |   | |   |     | |   | |
+-+-+-+-+-+-+-+ +-+-+ +-+ + + + + + +-+ +-+ + +-+ + + + +-+-+ + + +-+-+ +-+-+-+-+ + +-+ +-+-+ +-+ + +
| |                     | | | | | | | |   | |     | | |     | | |     |         | |   |     |   |   |
+ + +-+-+ +-+-+-+-+-+-+-+ + + + + + + +-+ + +-+-+-+ + + +-+ + + + +-+ +-+-+ +-+-+ +-+-+-+-+ +-+ +-+-+
|   |   |   |   |         | | | | |   |   |     |   | | |   | | | |       |   |   |   |   |   |     |
+ +-+ + +-+ + + + +-+-+-+-+-+ + + +-+ + +-+-+ + + +-+ +-+ +-+ + + + +-+-+ +-+ + +-+ + + + +-+ +-+-+ +
|   | |     | |   |           | | |   | |   | | |   |   |   |   | | |   |   |   |   |   |       |   |
+-+-+ +-+-+ + +-+-+-+-+ +-+-+-+ + + +-+ + + +-+ +-+ +-+ +-+ +-+-+-+ + + +-+ +-+-+ + +-+-+-+-+-+-+ +-+
|     |     |     |     |     | | |   |   |   |   | | | |   |       | | |   |     |       |     |   |
+ +-+-+-+ +-+-+-+ + +-+-+-+-+ + + +-+-+-+-+-+ +-+ + + + + + +-+-+ +-+ + + +-+-+-+-+ +-+-+ + +-+ +-+ +
|   |   |     | |   |       | | |           | |   | |   | |       |   | | |   |   |     | |   |     |
+ + + + +-+-+ + +-+-+-+ +-+ + + +-+-+-+-+ + + + +-+ + +-+ +-+-+-+-+ +-+ + + + + + +-+-+-+ +-+ +-+-+-+
| |   |     | |         | | |   |   |   | | | | |   | | |   |     |   | |   |   | |       |   |     |
+ +-+-+-+-+ + + +-+-+ +-+ + +-+ + + + + + + + + + +-+ + + + + + +-+ + + +-+-+-+-+ + +-+-+-+ +-+ +-+ +
| |     |   | |   |   |   |   |   | | | | | |   |   | |   | | | |   | |     |     | |     | |     | |
+ + + +-+ +-+ +-+-+ +-+ + +-+ +-+-+ +-+ + +-+-+-+-+ + +-+-+ +-+ + +-+ +-+-+ + +-+-+ + +-+ + + +-+-+ +
|   | |   |   |     |   |   |   |       |       |   |     |   |   |   |   | | |     |   |   | |     |
+-+-+-+ +-+-+ + +-+-+-+ +-+ +-+ +-+-+-+-+-+-+ +-+ +-+-+-+ +-+ + +-+ + + + +-+ + + + +-+ +-+ + + +-+ +
|       |   | | |       | |   | |       |   | |   |   | |   | |   | | | | |   | | |   | |   | |   | |
+ +-+-+-+ + + + + + +-+-+ +-+ + + +-+-+ + + + + +-+ + + +-+ + +-+-+ +-+ + + +-+-+ +-+ + +-+-+ +-+ +-+
|   |   | | |   | |     |   | |   |   |   |   |   | |   | | |     |   | | | |   | | | |         |   |
+ + + + + + +-+-+ +-+-+ + +-+ +-+-+ + +-+-+-+ +-+ + +-+ + + +-+-+ + + + + + + + + + + +-+-+-+-+-+ + +
| |   | | |     | |     |     |   | |       | |   |   | | |     | | |   | | | | | |         |   | | |
+ +-+-+ + +-+-+ + + +-+-+-+-+-+ + + +-+-+-+ + + +-+-+ + + +-+-+ + +-+-+ + + + + + +-+-+-+-+ + + + + +
|   | |   |     | | |           | | |   | |   | |     |   |     |     | |     |   |     |   | | | | |
+-+ + +-+-+ +-+-+ + + +-+-+-+-+-+ + + + + +-+-+ + + +-+-+-+ +-+-+-+-+ + +-+-+-+-+-+ +-+ + +-+ + +-+ +
|   |   | | |     | | |       |   | | | |   | | | |   |   |   |       |     |       | | |   | |   | |
+ +-+ + + + +-+-+-+ + +-+ +-+ + +-+ + + + + + + + +-+ + + +-+ + +-+-+-+-+-+ + +-+-+-+ + + +-+ +-+ + +
| |   |   |       |   |   | | |       | | |   | |   |   | |   |   |       | |     |   | | |   |   | |
+ + +-+-+ +-+-+-+ + +-+ +-+ + +-+-+-+-+ + +-+ + +-+-+-+ + + +-+-+ + +-+ +-+ +-+-+ +-+ + + + +-+ +-+ +
|   | |   |   |   |     |   | |       | | |   |       | |         | |   |   |   |   |   | | | |   | |
+-+-+ + +-+ +-+ +-+-+-+-+ +-+ + +-+-+ + + + +-+-+-+-+ +-+-+-+-+-+-+ + +-+ +-+-+ +-+ + +-+-+ + +-+ + +
|     |     |   |         |   | | |   |   | |       |       |   |   |   |   |     | |       |   |   |
+ + +-+-+-+ + +-+-+ +-+-+ + +-+ + + +-+-+-+ + +-+-+ +-+-+-+ + + +-+-+-+ +-+ + +-+ + +-+-+-+-+ +-+-+ +
| |       | |     |     | | |   | |   |   | |   | |   |   | | | |         | | |   | |     |     |   |
+ +-+-+ +-+ +-+-+ +-+-+ + + + +-+ +-+ + + + +-+ + +-+ + + + + + + +-+ +-+-+ + + +-+ + + +-+ +-+ + +-+
| |   | |   |   | |     |   |   |   | | | | |   |   |   |   | | |   | |       | |   | |       | | | |
+ + + + + +-+ +-+ + +-+-+-+-+-+ + + + + + +-+ +-+ + +-+-+-+-+ + +-+ + + +-+-+-+-+ +-+ +-+-+-+-+ + + +
|   | |   |   |   |   |       | | | |   |     |   | |     |   |     | |   |   |   |   |     |   |   |
+-+-+ +-+-+-+ + +-+-+-+ +-+ + + +-+ +-+-+-+-+-+ + +-+ + + + +-+-+ +-+-+-+ + + + +-+-+ + +-+-+ + +-+ +
| |   |       |         |   | |   | |         | | |   | | |     | |       | |   |   |   |     | |   |
+ + +-+ +-+-+ +-+-+-+-+-+ +-+ +-+ + + + +-+-+ +-+ + +-+ + + +-+ +-+ +-+-+-+ +-+-+ + +-+-+ +-+-+ + +-+
| |     |   | |     |   |   | | | | | |     |   |     | | |   |     | |   |   |   |       |     | | |
+ +-+-+-+ + + + +-+ +-+ +-+ + + + + + +-+-+ +-+ +-+-+-+ + +-+ +-+-+-+ + + + + + +-+-+-+-+-+ +-+-+ + +
|     |   | | |   |   | |   |   | |   |   | | |         |   |     |   | | | | | |       | |     |   |
+ + +-+ +-+ + +-+ +-+ + + +-+ +-+ + +-+ +-+ + +-+-+-+-+-+-+ +-+-+ + +-+ + +-+ + + +-+-+ + +-+ +-+-+ +
| |     | | | |   | |   |   | |   |     |   |       |     | | |   | |   |     |   |     |   | |     |
+ +-+-+-+ + + + +-+ +-+ +-+ +-+ +-+-+-+ + +-+ +-+-+ + + +-+ + + +-+ + +-+-+-+-+ +-+ +-+-+-+ + + +-+-+
| |       |   | |     |   |     |       | | | |   |   |     | | |   |   |   |   | |       |   | |   |
+ +-+-+ + +-+-+ + +-+ +-+ +-+-+-+-+-+-+-+ + + + + +-+-+-+-+-+ + + + +-+ + + + +-+ +-+-+-+ + +-+ +-+ +
| |   | |       |   | | |   |     |       |     |       |       | |   | | |   |     |     |   | |   |
+ + + + +-+-+-+-+ + + + +-+ + +-+ + +-+-+-+-+-+-+-+-+-+ +-+-+ +-+-+ + + +-+ +-+-+ + + +-+-+-+-+ + + +
| | | |     | |   | | |   | | |   | |           |       |   |       | |   | |     | |     |     | | |
+ + + +-+-+ + + +-+ + +-+ + + + +-+ + +-+-+-+-+ +-+ +-+-+ + +-+-+-+-+-+-+ + + + +-+ +-+-+ + +-+-+ +-+
|   |       |   |   | |   |   |   | |   |     |   |   |   | |     |       | | |   |   |   | |       |
+-+-+-+-+-+-+-+-+ +-+ + + +-+-+-+ + +-+ + + + +-+ +-+ + +-+ + +-+ + +-+-+-+ +-+-+ +-+ + +-+ + +-+-+ +
| |               |     |     |   |     | | |   |   |   | |   | |   |     |     | |   | |   | |     |
+ + +-+-+-+-+ +-+ +-+-+-+-+-+-+ +-+ +-+-+-+ +-+ +-+ +-+-+ +-+-+ +-+-+ + +-+-+-+ + +-+-+ + +-+-+ +-+ +
| | |     |   |   |       |   | | |       | |     |     |         |   |       | | |   | | |     | | |
+ + + +-+ + +-+-+ + +-+-+ + + + + +-+-+-+ + + +-+-+ +-+ + +-+-+ +-+ +-+-+ +-+ + + + + + + + +-+-+ + +
| | | |   |     | |     |   | | |       |   | |   |   | |   | |   |     |   | | | | | | | | |     | |
+ + + + +-+-+-+ +-+-+-+ +-+-+ + + +-+-+ +-+-+ + + +-+ + +-+ + +-+ +-+-+ +-+ +-+ + + + + + + + + +-+ +
| | | | |     | |   |     |   | |     |       | |   | |   | | |       |   | |   | | |   |   | |   | |
+ + + + +-+ + + + + + +-+-+ + + +-+-+-+-+ +-+-+ +-+ + +-+ + + + +-+-+-+-+ + + +-+ + +-+-+-+-+ +-+ + +
| |   |   | | |   |   |     | |     |   |   |   | | |   | | | |           | | |   |       |   | |   |
+ +-+-+-+ +-+ +-+-+-+-+ +-+-+-+-+-+ + + +-+-+ +-+ + +-+-+ + + +-+-+-+-+-+-+ + + + +-+-+-+ + +-+ +-+-+
|                     |               |       |           |               |     |       |           |
+-+-+-+-+-+-+-+-+-+-+-+-+-+-+-+-+-+-+-+-+-+-+-+-+-+-+-+-+-+-+-+-+-+-+-+-+-+-+-+-+-+-+-+-+-+-+-+-+-+-+