+-+-+-+-+-+-+-+
|             |
+ + + + +-+-+-+
| | | |       |
+ + + + +-+ +-+
| | | |   |   |
+ + + +-+-+-+-+
| | |         |
+ + +-+ +-+ +-+
| |   |   |   |
+ +-+-+ + +-+-+
|     | |     |
+ +-+ +-+-+-+-+
|   |         |
+-+-+-+-+-+-+-+