+-+-+-+-+-+
|         |
+ + + + + +
| | | | | |
+ +-+ +-+ +
|   |   | |
+ +-+ + + +
|   | | | |
+ + +-+ + +
| |   | | |
+-+-+-+-+-+