+-+-+-+-+-+-+-+-+-+-+
|                   |
+ + + +-+ + +-+-+ + +
| | |   | |     | | |
+ + +-+ +-+-+ +-+ +-+
| |   |     |   |   |
+ +-+ +-+-+ + + + +-+
|   |     | | | |   |
+ +-+ +-+-+-+-+-+-+-+
|   |               |
+ +-+-+-+ + + + + + +
|       | | | | | | |
+ +-+ + +-+-+ + + + +
|   | |     | | | | |
+ +-+-+-+-+ +-+ + +-+
|         |   | |   |
+ + + +-+ +-+-+-+ + +
| | |   |       | | |
+ +-+-+-+-+-+ +-+ + +
|           |   | | |
+-+-+-+-+-+-+-+-+-+-+