+-+-+-+-+-+-+-+-+-+-+-+-+-+-+-+-+-+-+-+-+-+-+-+-+-+-+-+-+-+-+-+-+-+-+-+-+-+
|                                                                         |
+ + +-+ + + + + +-+ + +-+-+ +-+-+ + + +-+ + + +-+-+ + +-+-+ + +-+ + + +-+ +
| |   | | | | | |   |     |     | | | |   | | |     | |     | |   | | |   |
+ +-+ + +-+ + + + + +-+ + + +-+ + + +-+-+ + + + +-+ +-+-+ + + + + + +-+ + +
|   | | |   | | | |   | | |   | | | |     | | | |       | | | | | |   | | |
+ + + + + + + + +-+-+ + +-+ + + +-+-+ +-+ +-+ + + + + + +-+-+ +-+ + + + + +
| | | | | | | | |     |   | | |   |     | |   | | | | | |       | | | | | |
+ +-+ +-+-+-+ + + +-+ +-+ +-+ +-+ +-+ +-+ +-+-+ + + + +-+-+ + + +-+ +-+ + +
| |         | | |   |   | |   |     |   | |     | | |   |   | | |   |   | |
+-+ + + + + +-+ +-+-+-+ + + +-+ + + +-+ +-+-+ + +-+ + + +-+ + + + + + +-+ +
|   | | | | |     |     | | |   | | |     |   |   | | | |   | | | | |   | |
+ + + + +-+ + + + +-+ +-+ +-+ +-+-+ +-+-+ +-+ +-+-+ + + + +-+ + + +-+-+-+-+
| | | | |   | | |   | |     |   |     |   |   |     | | |   | | |         |
+ +-+ + + +-+ +-+-+ + + +-+ + + +-+ +-+ +-+ + + + + + +-+ + +-+ + +-+ + + +
|   | | | |   |     | | |   | |   |   |   | | | | | |   | | |   |   | | | |
+ +-+ + +-+ +-+ + +-+ + + + + + + + +-+ + +-+ + + + +-+ +-+ + + + +-+ + + +
| |   | |     | | |   | | | | | | |   | | |   | | | |     | | | |   | | | |
+ +-+ +-+-+-+ + + + + + + +-+ +-+-+ + +-+-+-+ +-+ +-+-+ + +-+ +-+-+ + +-+ +
| |         | | | | | | | |   |     |     |   |       | |   |     | | |   |
+ + + +-+ +-+-+-+ + + +-+ + + +-+ + + + + + + +-+-+-+ + + +-+ + + + +-+-+ +
| | |   | |       | |   | | | |   | | | | | |       | | |   | | | |     | |
+ + + +-+ + + + + + +-+ + + +-+-+ +-+ + +-+ + + + + + + + + +-+ + + + +-+ +
| | | |   | | | | | |   | |   |     | |   | | | | | | | | |   | | | | |   |
+ +-+ + + + + + +-+ +-+ +-+-+ +-+-+ + + +-+-+ + + +-+ + + + +-+ + + +-+-+ +
| |   | | | | | |     | |       |   | | |     | | |   | | |   | | | |     |
+-+-+ +-+-+ + + + +-+ +-+-+-+ + +-+-+-+-+ +-+-+ +-+ + + +-+ + + + +-+ +-+-+
|         | | | |   |     |   |   |         |     | | | |   | | | |       |
+ + +-+ +-+ + +-+ + + +-+-+ + + + + +-+ + + + +-+ +-+ +-+-+ +-+ +-+ +-+-+ +
| |   | |   | |   | |   |   | | | |   | | | |   |   |     |   |   |     | |
+ + + + + +-+-+-+ + + + + + + + + + + + +-+-+-+ +-+-+ + +-+-+ +-+ + + + + +
| | | | |       | | | | | | | | | | | |     |   |     |     | |   | | | | |
+-+ +-+ +-+-+ + + + + + +-+-+ +-+-+ +-+ +-+-+ +-+-+ +-+ + + +-+-+ +-+ + + +
|   |       | | | | | | |       |     | |       |     | | | |     |   | | |
+ + + + +-+-+ +-+-+ + +-+-+ +-+-+ + + + + + +-+ +-+-+ + + + +-+-+ + +-+-+ +
| | | | |         | |     | |     | | | | |   | |     | | |     | | |     |
+ + + + + + + + + +-+ + +-+ +-+ +-+-+ +-+ +-+ + + + +-+ + +-+ + +-+-+-+ +-+
| | | | | | | | | |   | |   |       | |   |   | | | |   | |   |   |       |
+-+-+ +-+-+ + +-+-+ +-+-+ + + + + + + + +-+-+-+ + + +-+-+ + + +-+-+ +-+ + +
|     |     |   |   |     | | | | | | |     |   | | |     | |     |   | | |
+-+ + +-+ + + + +-+ + +-+ + + +-+ + + + + + +-+ +-+ + + +-+ + +-+ +-+-+-+ +
|   | |   | | | |   |   | | |   | | | | | | |     | | |   | |   |       | |
+ + + +-+ + + + + + + + +-+-+-+-+ + +-+-+ + + + + + +-+ +-+ +-+ + + +-+ + +
| | | |   | | | | | | |         | |     | | | | | |   |   |   | | |   | | |
+ + + +-+ + + + + + + +-+ + + +-+ + + +-+-+ + + +-+ + + + + + +-+ +-+-+-+ +
| | |   | | | | | | | |   | | |   | |   |   | | |   | | | | | |     |     |
+ +-+ +-+ + + + + + + + + + + +-+ +-+-+ +-+-+ + + + + + + +-+-+-+ + +-+-+ +
| |     | | | | | | | | | | |   | |       |   | | | | | |     |   | |     |
+ + +-+-+-+ +-+ +-+ +-+-+-+ +-+ + + + + + + + +-+ + + + +-+ + + +-+ +-+ +-+
| |       | |     |       | |   | | | | | | |   | | | | |   | | |   |     |
+ + +-+ +-+ +-+ +-+-+-+ +-+ + +-+-+-+-+-+-+ + + + + + + + +-+ + + + +-+ + +
| |   | |     | |       |   |             | | | | | | | | |   | | | |   | |
+-+-+ +-+ +-+ +-+-+-+ + + + + + + + + + + + + + + +-+ + +-+ + + + + + +-+ +
|       | |     |     | | | | | | | | | | | | | | |   | |   | | | | |   | |
+ + + + +-+-+ + +-+ + + + + + + + + + + +-+ +-+ + +-+ + + + + + + +-+-+-+ +
| | | |   |   | |   | | | | | | | | | | |     | | |   | | | | | |     |   |
+ + + + +-+ +-+ + + +-+ + + + +-+-+ +-+ + +-+-+ + + + + + + + +-+ + + +-+ +
| | | |   |   | | | |   | | | |       | | |     | | | | | | |   | | | |   |
+ +-+-+ + + + +-+ +-+ + + + + + +-+-+ + + +-+ +-+ +-+-+ +-+-+-+-+ +-+ + + +
|     | | | | |   |   | | | | |   |   | |   |   |     |   |       |   | | |
+ +-+-+-+ + +-+ + + +-+ +-+ + + + + + + + + + +-+-+-+ + + + + + + + +-+ + +
|   |     | |   | | |     | | | | | | | | | | |       | | | | | | | |   | |
+ +-+-+ + + + + + + + +-+-+-+ +-+ +-+ + + + +-+ + + + +-+ +-+ +-+-+ + + + +
|   |   | | | | | | | |       |   |   | | | |   | | |   | |   |     | | | |
+ + + +-+-+ + + +-+ + + +-+-+ +-+ + +-+-+ +-+ +-+ + + + + + +-+-+ + + + + +
| | |   |   | |   | | |     |   | | |       | |   | | | | |     | | | | | |
+ + + + + +-+-+ + + + +-+-+ + +-+-+ +-+ + +-+ + + + +-+ +-+ + + + + + +-+ +
| | | | | |     | | |   |   |     | |   |   | | | | |     | | | | | | |   |
+ +-+ + + + +-+-+-+ + + +-+ +-+-+-+-+ + + + + +-+-+-+-+-+ +-+ + + + +-+ + +
| |   | | |     |   | | |   |         | | | |   |           | | | | |   | |
+ + +-+ + + + + +-+ +-+-+-+-+-+-+ + + + + + +-+ +-+ + + + + + + + +-+ + + +
| |   | | | | | |   |             | | | | | |   |   | | | | | | | |   | | |
+-+ + + +-+ +-+ +-+ + + +-+-+-+ +-+ + + +-+-+-+ + + + + + +-+ + +-+ + +-+ +
|   | |   | |   |   | | |         | | |     |   | | | | | |   | |   | |   |
+-+-+-+-+-+-+-+-+-+-+-+-+-+-+-+-+-+-+-+-+-+-+-+-+-+-+-+-+-+-+-+-+-+-+-+-+-+