+-+-+-+-+-+-+-+
|             |
+-+-+-+-+ +-+-+
| |         | |
+ + +-+-+-+-+ +
|       |     |
+ + +-+ + + + +
| | |   | | | |
+-+ +-+ + +-+-+
| | |     | | |
+ + +-+ +-+ + +
|   | |     | |
+ +-+ + +-+ + +
|     |   |   |
+-+-+-+-+-+-+-+