+-+-+-+-+-+-+-+-+-+-+-+-+-+
| |   |           |.|.|.|.|
+ + + + +-+-+-+-+ +-+-+-+-+
|   |   |     | |       |.|
+-+-+-+-+-+ + + +-+-+-+ +-+
|     |     | |   |     |.|
+ + + +-+ +-+ + + + +-+-+-+
| | |     |     | |   |.|.|
+ + +-+-+-+-+-+-+ +-+ +-+-+
| |             |   | |.|.|
+ +-+-+-+-+-+-+ +-+ + +-+-+
|   |         | |   | |.|.|
+-+ + +-+-+ +-+ + +-+ +-+-+
|   | |     |   |   | |.|.|
+ +-+-+ +-+ + +-+-+-+ +-+-+
| |     |   |   |   |     |
+ + + + +-+-+-+ + + +-+-+ +
| | | | |     |   | |.|   |
+ +-+ +-+ + +-+-+-+ +-+ +-+
|   |     |       | |   | |
+-+ + +-+-+-+-+ + + + +-+ +
| | |         | | |   |   |
+ + +-+-+ +-+-+ + +-+-+-+ +
| | |     |   | | |.|   | |
+ + +-+-+-+ + + + +-+ + + +
|           |   |     |   |
+-+-+-+-+-+-+-+-+-+-+-+-+-+