+-+-+-+-+-+-+-+-+-+-+-+-+-+-+-+-+
|                               |
+-+ +-+ + +-+-+-+ +-+ + + + +-+ +
|     | | |       |   | | | |   |
+ + +-+-+ + + + + + + + + + +-+ +
| |     | | | | | | | | | | |   |
+ + + + +-+ +-+ +-+ + + +-+ + + +
| | | | |   |   |   | |   | | | |
+ + + +-+ + + +-+ +-+-+-+ + +-+-+
| | |   | | | |   |       |     |
+-+-+ +-+-+ + + + + + +-+ + +-+ +
|     |     | | | | |   | |   | |
+-+ +-+ + + + + +-+ + + + +-+ +-+
|     | | | | |   | | | | |     |
+ +-+ +-+ + +-+ + +-+ + + +-+ + +
| |   |   | |   | |   | |   | | |
+ +-+ +-+-+ + +-+-+ +-+-+ + + + +
| |     |   |   |       | | | | |
+-+ + + + + + +-+ +-+ + +-+ + + +
|   | | | | | |     | | |   | | |
+ + +-+-+ +-+ + +-+-+ + + + + +-+
| | |       | |     | | | | |   |
+ +-+ +-+ + + + + + + + +-+ + + +
| |   |   | | | | | | | |   | | |
+ +-+ +-+ + + + + + + +-+ +-+ + +
| |     | | | | | | |   | |   | |
+ + +-+-+ + + + + + + +-+ +-+ + +
| | |     | | | | | | |   |   | |
+ +-+-+ +-+ + + + +-+ + +-+-+ +-+
|     |   | | | | |   | |       |
+ +-+ + + +-+ + + + + + + + +-+-+
|   | | |   | | | | | | | |     |
+-+-+-+-+-+-+-+-+-+-+-+-+-+-+-+-+