+-+-+-+-+-+
|       | |
+-+ + + + +
| | | |   |
+ +-+ + + +
|     | | |
+ +-+ +-+ +
| | |   | |
+-+ + + + +
|     | | |
+-+-+-+-+-+