+-+-+-+-+-+-+-+-+-+-+-+-+-+-+-+-+-+-+-+-+-+-+-+-+-+-+-+-+-+-+-+-+-+-+-+-+-+-+-+-+-+-+-+-+-+-+-+-+-+-+
| | | |   |   |   |   |     |     |   |       | |   | | | |       | |   |     |     |   |     |     |
+ + + + +-+-+ +-+ + + +-+-+ +-+-+ + +-+-+-+ +-+ +-+ + + + +-+-+-+ + + +-+ +-+ + + +-+ + +-+-+ + +-+ +
|   |   |           |       |     | |                 |           |     | |   | | | | |     |     | |
+-+ +-+ + +-+-+-+ +-+-+-+-+-+ +-+-+ +-+-+-+-+-+-+-+ +-+ +-+-+-+-+ +-+ +-+ +-+-+ + + +-+-+ +-+-+ + + +
|     |   |     |         | |       |   |   |   |     |     | | |       |     | | |             | | |
+ +-+-+-+-+-+-+ + +-+ +-+ + + +-+-+ +-+ + + +-+ +-+ +-+ +-+-+ + +-+-+-+-+ +-+-+ + + + + +-+-+-+ +-+-+
|   |   |       | |     |   | | |         |       | | | |   |   | | | |     |   | | | |       | |   |
+-+ + + +-+-+-+ +-+ +-+ + + +-+ +-+-+ + +-+-+ + + + + + + +-+ + + + + + +-+-+ +-+-+ +-+ +-+ + +-+ + +
|   | | |     |     |   | | |   |     |   |   | |   |         | |         |     |   |   | | | | | | |
+ +-+ +-+-+ + +-+-+ +-+ +-+ + + +-+ +-+ +-+-+ +-+-+ +-+ +-+-+-+ + +-+-+-+ +-+ + + +-+-+-+ +-+-+ + +-+
| | |       |       |     | | |   | | |   | |     | |   |   | |   | |     |   | |   |   | |   | |   |
+ + +-+ +-+-+-+-+-+ + +-+-+ + + +-+-+ +-+-+ + + +-+ +-+-+ +-+ + +-+ + +-+-+ +-+-+ + + + + + + + + +-+
|                 | |     |   | | |   |   |   |   |   |   |   | |     |     |   | |   |     |   |   |
+ + + +-+-+-+-+-+-+-+ + +-+-+ + + + + +-+ + +-+-+-+-+-+-+ + +-+-+-+ +-+ + + + +-+ + +-+-+ + + +-+-+ +
| | | |   |   |       | | |   |     | |         |     |     |   | | | | | |       | |     | |   |   |
+-+ + + +-+ +-+ +-+-+ +-+ +-+-+ + +-+ + +-+-+ + +-+-+ + + +-+ + + + + +-+-+-+-+-+ +-+-+ +-+ + +-+ + +
|   | | |   | | |   |       |   | | |       | |         | | | |   | |   | | |   |   | | | | | |   | |
+-+-+-+ +-+ + +-+-+ +-+-+-+-+-+ +-+ +-+-+ +-+-+-+-+-+-+ +-+ + +-+-+ + + + + + +-+-+-+ +-+ + +-+-+ +-+
| |         |   |   |                   |     |   | |     |   | |     |   |   | |           |       |
+ +-+ + +-+ + +-+ +-+-+ +-+ +-+ +-+ +-+ +-+-+-+ +-+ + +-+-+ +-+ +-+-+-+ + + +-+ +-+-+-+-+ +-+ +-+-+ +
|     | |       |   | |   |   |   | |     |   |             | |     |   |   |   |   |       |   |   |
+ +-+-+ +-+ + + +-+ + + +-+-+-+ + + + +-+-+ +-+ +-+-+ + + + + + + +-+ +-+ +-+ +-+-+ +-+ + + + +-+ +-+
| | |   |   | | |     |     | | | | |         |   | | | | |     |   |   |               | | |   |   |
+ + + + +-+-+ + +-+-+ + +-+-+ +-+-+-+ +-+-+ +-+-+ + + +-+ + + +-+-+-+ +-+-+ + +-+ + +-+ +-+-+-+-+-+ +
|   | |     | |   | | | |   |   | |     |     | |   | | | | | |     |     | |   | | | | | | |       |
+-+-+-+-+-+ +-+ + + + +-+-+ + + + +-+-+ + + +-+ +-+-+-+ +-+-+-+ +-+-+-+-+-+-+-+-+-+ + + + + + +-+-+-+
|           |   | | |   |     | |       | |       |   |   |   | | |   |           | |               |
+-+-+-+-+-+-+ + +-+ +-+ + + +-+ +-+ +-+-+-+-+-+ +-+ +-+ +-+ +-+ + +-+ +-+-+ +-+ +-+ +-+-+-+ +-+-+-+-+
| | |       | | |     |   |   |     | | |   | | |     |           |       | |   |   |     |         |
+ + + +-+ + +-+ +-+-+ +-+ +-+ +-+-+-+ + + + + + + + +-+-+ +-+-+ +-+-+-+ +-+ + + + + +-+ +-+-+-+-+-+-+
|   | |   |   |   |   |   |   |     |   | |     | | |       |   |   |   |   | |   | |   |   | |     |
+-+ + +-+-+-+ + +-+ +-+-+ +-+-+-+-+ +-+ + +-+ + + +-+-+ + +-+-+ + + + +-+-+-+-+ + +-+ +-+-+ + +-+-+ +
| |         |   |       | | |     |       | | |   | |   | |   |   |   | |   | | |       |       | | |
+ + +-+ +-+-+ +-+-+ + +-+ + + + +-+ +-+-+-+ +-+-+ + + + +-+-+ + +-+ +-+ +-+ + + +-+ + +-+ +-+ + + + +
| | | |     | |     | | | |   | |               | | | |     |   |       |   |     | |       | | |   |
+ +-+ + +-+-+ +-+-+ + + + + + +-+-+-+ +-+-+-+ +-+ + + +-+-+-+ +-+ +-+-+-+ + + +-+-+ + +-+-+-+-+-+ + +
| |     |     | |   | |   | | | |         |   | |         | | |   | | |   |   |     | |     | |   | |
+ + +-+-+-+-+ + +-+-+ +-+-+ + + + +-+-+-+ +-+-+ +-+-+ + +-+ +-+ +-+ + + + + + + + +-+-+ +-+ + +-+-+ +
|     | |       | | |       |   | |       | |   |     | | |   | | |     | | | | | | |   | | |   |   |
+-+ + + + +-+ +-+ + +-+ + + +-+ +-+-+ +-+-+ + + +-+-+-+ + + +-+ + +-+-+-+-+ +-+-+ + + +-+ + + +-+ +-+
|   | | |   |   |   | | | | | |   | | |   |   | | | |   |     | |       |   |           |     |   | |
+ +-+-+ +-+-+ +-+ +-+ + +-+ + + +-+ + + + +-+-+ + + + + + +-+-+-+-+ + + +-+-+-+-+-+ +-+-+ +-+ + +-+ +
|     | | |       |     |   | |         |   | |       | | |       | | |         | |     | |         |
+ + +-+ + +-+ + + + + + +-+-+ + +-+-+-+ +-+-+ +-+-+ +-+-+ + + +-+ +-+-+ +-+-+ +-+ + +-+ +-+ +-+ + +-+
| |       | | | | | | |   |       |   |     |     |   | |   | |   |   | |     |       |   | | | |   |
+ +-+-+-+-+ +-+-+-+-+-+ + +-+ +-+ +-+ + +-+-+-+ +-+-+ + +-+-+-+ + +-+ + +-+-+-+ +-+-+ +-+-+ + +-+ + +
|   | |   |   |   | |   |   |   | | |     |       | | | | |   | |                   | |   |   |   | |
+-+ + +-+ + +-+ + + +-+ + + + +-+-+ + + + + +-+-+-+ +-+ + +-+ + + +-+-+-+-+-+ +-+ + + +-+ +-+-+-+-+-+
|       |       | |   | | | | |   |   | |       |     |   | |   |     |   | | |   | | | |           |
+-+ +-+ +-+-+-+ +-+-+ +-+-+-+ + + +-+ +-+-+-+-+ + +-+ + +-+ +-+-+-+-+-+-+ + +-+ + +-+-+ + +-+-+ +-+-+
|   |   |   |       |       | | |   | |         |   | |     | |   |     |   |   |   |       |   |   |
+ +-+ + + + + +-+-+ + +-+-+ + + + + + +-+-+ + +-+-+ +-+-+ + + +-+ + +-+-+-+ + + +-+-+-+-+ +-+-+-+ +-+
|   | | | | | | | |   | | |   | | | | |     |             | |         | |   | | |       |     |   | |
+-+-+ + + +-+ + + +-+-+ + + +-+ +-+-+-+ +-+-+-+ + +-+-+-+ +-+-+-+ +-+ + + +-+ +-+ +-+-+ +-+-+ + +-+ +
| | | | |       |       |   | |   |   |     |   | |         |       |   | |   | |   | | |   |       |
+ + + +-+-+-+-+ + +-+-+-+-+-+ + + +-+ +-+ +-+-+ +-+-+ +-+-+-+-+ +-+-+ +-+ +-+ + + +-+ +-+-+ + +-+-+ +
| | |           |   | | |   | | | |     | |   | |         |   | | |         | |           | | |   | |
+ + + + +-+ +-+-+-+ + + + +-+ + +-+ +-+ + +-+ + +-+ +-+-+-+ +-+ + + + +-+ +-+ +-+-+-+ +-+-+ +-+-+ + +
|   | | |                         |   | |     | | |   | |     | | | |   | |     | | |   |     |     |
+ +-+ +-+-+ +-+ +-+-+-+-+ + +-+-+-+-+-+ + + +-+ + + +-+ + +-+-+ + + + +-+-+-+ + + + + +-+-+ +-+-+-+ +
|   |     |   | |       | | | | |       | |   | |     | | |   |   | |     |   |   | |         |     |
+ +-+ +-+ +-+ +-+-+ +-+-+ +-+ + + +-+ +-+ + + +-+-+-+-+ + + +-+-+ +-+-+-+ + + +-+-+ +-+-+-+ +-+-+ + +
|   | |   |   |       | |   | | |   | | | | |   | |   |           | | | |   |       | |         | | |
+ + + +-+ +-+ + + + +-+ + +-+ + +-+ +-+ + + +-+-+ + +-+-+-+ + +-+-+ + + + + + +-+ + + + + + + +-+-+ +
| |   | |   |   | |     | |         | |   |     |         | |       | |   | |   | |   | | | |       |
+-+-+-+ +-+ +-+ + +-+-+-+ +-+-+-+ +-+ +-+ +-+-+-+ + + + + +-+-+-+ +-+ +-+-+ +-+-+ +-+ + + +-+ + +-+-+
|       |   | | |       |   |       | | |       | | | | |   | |   |     |   |       |   | |   | |   |
+ + + +-+-+-+ +-+ + + +-+-+-+-+-+ + + + +-+-+ + +-+-+ +-+ + + + +-+-+-+ + + +-+ +-+-+ +-+-+-+-+ + + +
| | | |       |   | | | |       | |   |       | |     |   |   |         | |   |   |       |   |   | |
+ +-+ + +-+-+-+-+-+-+ + +-+ +-+ +-+-+ + +-+ +-+-+ + +-+-+ +-+ +-+ +-+ + + +-+-+-+ +-+-+-+ +-+ + +-+-+
|   | | |       |         |   |       | |         |   |   | |   | |   | | | | |         | |       | |
+ +-+ + + + +-+ + + + + +-+-+ +-+-+-+ +-+-+-+ +-+-+-+-+ +-+ + +-+ +-+-+ +-+ + +-+ +-+-+-+-+-+-+-+ + +
| |   |   | |   | | | |   |       |   |         |     | |   |   |   |     |         |       |       |
+ + +-+-+ +-+-+ +-+ +-+-+ +-+-+ + +-+ +-+-+-+ +-+ +-+-+-+-+ +-+ + +-+ +-+ +-+-+-+-+ + +-+-+-+ + +-+-+
| | | |   |     |   | | | |     | | |     |   |   | | |       |     |   | |   |     |   |     | |   |
+ + + +-+-+-+ +-+ + + + +-+-+ +-+-+ +-+ +-+-+-+ + + + +-+-+ +-+ +-+-+-+-+-+ + +-+-+-+-+ +-+ + + + +-+
| | | |   |   | | | |     | |   |     |       | |   |                 | | | |     | |     | | | |   |
+ +-+ +-+ + +-+ +-+ + +-+ + + +-+-+ +-+-+-+ +-+ +-+-+-+ +-+-+-+-+-+-+ + + + + +-+-+ +-+ + + +-+-+ +-+
|     |   |           |   | | | |             |               |   | | |     |     |   | |     | |   |
+-+-+ + +-+ + +-+ + + +-+-+ +-+ + + + +-+ +-+-+-+ +-+-+-+ +-+-+-+ + + + + +-+-+-+-+-+ +-+ +-+-+ + + +
|       |   | | | | |   |     |   | |   |               | | |         | | |       |   | |   | |   | |
+-+ + +-+ +-+-+ + +-+ +-+-+ + +-+-+-+ +-+ +-+ + + +-+-+-+-+ + +-+-+ + + + + +-+-+ + + + +-+ + +-+ +-+
|   | | | |   |     |   |   | |     |   | |   | | |     |   |     | | | |   |     | | |   |   | | | |
+ + +-+ + +-+ +-+-+ + +-+ +-+-+ +-+-+ + +-+-+-+ +-+ + +-+-+ + + +-+-+-+ +-+-+-+ +-+-+ + + + +-+ + + +
| |       | | | |   | |   | |   |   | | |   |   |   |   |   | |   |   |   |   |   | | | | |         |
+-+ +-+-+-+ + + +-+ + +-+ + +-+ +-+ + +-+ + + + + +-+-+ +-+ + +-+ +-+ +-+-+ + + +-+ + +-+ +-+-+ +-+ +
| |   |   |     |   |     |             | |   |   |   | | |   | |           |         |           | |
+ + + + +-+ +-+ +-+ +-+-+-+-+ +-+-+ + +-+-+ +-+ +-+-+ +-+ + +-+ +-+-+ +-+-+ +-+ + +-+ +-+-+-+-+ +-+ +
|   | |   | |   |         | | |     | | |     |       |     |         |       | | | |       |     | |
+-+-+-+ +-+-+ +-+ + +-+-+-+ + +-+-+-+ + +-+-+-+ +-+-+ +-+ +-+ + +-+-+ +-+-+-+-+ +-+ +-+ + +-+-+ +-+-+
|       |     |   | |     | | |   | | |   |     |       |   | | |   |   |   |   |       |   |       |
+ + +-+ +-+ + +-+ + + +-+-+ + + +-+ + + +-+-+-+ +-+ +-+-+-+-+-+-+ +-+-+ + +-+ +-+ + +-+-+ +-+-+-+-+-+
| | |       | |   |   | |     |   |     |   | | |   | |   |           |   | | |   |   | |           |
+ + +-+-+ + +-+ + + + + +-+ + +-+ +-+ +-+-+ + + +-+ + + +-+ +-+ +-+ +-+-+-+ + +-+-+-+-+ +-+ +-+ +-+-+
| |     | |   | | | |   |   | |   | | |   | |   |           |   |       |   |     | | | |     |     |
+ + +-+ +-+-+ + +-+ +-+-+-+-+ +-+ + + + +-+ + +-+-+-+ +-+ + +-+ + + +-+ +-+ + +-+-+ + + + + +-+-+ +-+
| | |     | | | |       |     | |       |       | |     | |   | | | | | |         | |     | |   |   |
+ + + +-+-+ + +-+-+-+ + +-+-+ + +-+-+ + + +-+ + + + + +-+-+ +-+-+-+-+ +-+ + +-+ + + + +-+-+-+ +-+ +-+
| | | |               |   |       |   | |   | | |   |   |             |   | |   |   |           |   |
+-+-+-+-+-+-+-+-+-+-+-+-+-+-+-+-+-+-+-+-+-+-+-+-+-+-+-+-+-+-+-+-+-+-+-+-+-+-+-+-+-+-+-+-+-+-+-+-+-+-+