+-+-+-+-+-+-+-+-+-+-+
|                   |
+ + + +-+-+-+ + +-+ +
| | |   |     | |   |
+-+ +-+-+ +-+ + +-+ +
|   |       | |   | |
+ +-+ +-+ + + +-+ + +
|   | |   | | |   | |
+ +-+-+ +-+-+ + + +-+
|   |   |     | |   |
+ +-+ +-+ + + + + + +
|   | |   | | | | | |
+ + + +-+ +-+-+ + +-+
| | |   |   |   |   |
+ +-+ + +-+ + + + + +
| |   |   | | | | | |
+ +-+-+ +-+ + + + + +
|   |     | | | | | |
+ +-+ + + + + +-+ + +
| |   | | | |   | | |
+-+-+-+-+-+-+-+-+-+-+