+-+-+-+-+-+-+-+
|             |
+ + +-+ + + + +
| | |   | | | |
+ + +-+ +-+-+ +
| | |       | |
+ +-+-+ + + +-+
|     | | |   |
+ + + + +-+ + +
| | | | |   | |
+-+ +-+ + + + +
|     | | | | |
+ +-+ +-+-+-+ +
|   |   |     |
+-+-+-+-+-+-+-+