+-+-+-+-+-+
|         |
+-+-+ +-+-+
|   |     |
+-+ + + + +
|     | | |
+-+-+-+ +-+
|         |
+ +-+ +-+ +
|   | |   |
+-+-+-+-+-+