+-+-+-+-+-+-+-+
|             |
+ +-+ + + + + +
| |   | | | | |
+ + + + +-+-+ +
| | | | |     |
+ + + + +-+ + +
| | | | |   | |
+ +-+ + +-+-+ +
| |   |     | |
+-+ + + + + + +
|   | | | | | |
+ + +-+-+ + + +
| | |     | | |
+-+-+-+-+-+-+-+