+-+-+-+-+-+-+-+-+-+-+-+-+-+-+-+-+-+-+-+-+-+-+-+-+-+-+-+-+-+-+-+-+-+-+-+-+-+-+-+-+-+-+-+-+-+-+-+-+-+
|                                                                                                 |
+ + + + + +-+ + + + +-+ + +-+ + + +-+ +-+ +-+-+ +-+-+-+-+-+-+ + +-+-+-+ + + +-+-+-+ +-+ +-+-+-+ + +
| | | | |   | | | |   | |   | | |   |   |     |             | |       | | |       |   |       | | |
+ +-+ +-+ +-+ +-+ + + + + +-+ + + + + + + +-+-+ +-+ + + + +-+ + + + + +-+ + + + + + +-+ + + +-+ + +
|   |   |   |   | | | | |   | | | | | | |     |   | | | |   | | | | |   | | | | | |   | | |   | | |
+ +-+ + +-+ +-+-+-+ + +-+ +-+ +-+ + + +-+-+-+ + +-+ + +-+ + + +-+-+-+ +-+-+ +-+ +-+ +-+-+-+ + +-+ +
|   | |   |       | |   |   |   | | |       | |   | |   | | |       |     |   |   |       | |   | |
+ + +-+ + + + + +-+ +-+-+ + + + +-+-+ + +-+ +-+-+ + + + +-+-+ +-+ +-+ +-+-+-+ +-+-+ +-+ +-+ + + +-+
| |   | | | | |   |     | | | |     | |   |     | | | |     |   |   |       |     |   |   | | |   |
+ +-+-+ +-+ + + + +-+-+-+-+-+ + + +-+ + +-+-+-+ + +-+-+-+-+-+-+ + +-+-+-+-+-+-+-+ + +-+ +-+-+-+ +-+
|     |   | | | |           | | |   | |       | |             | |               | |   |       |   |
+ +-+ + +-+ + + +-+-+ +-+ + + + + +-+ +-+-+-+-+ +-+ +-+-+-+-+-+-+ + +-+ + +-+ + + + + + + + +-+ +-+
|   | |   | | |     |   | | | | |   |         |   |             | |   | |   | | | | | | | |   |   |
+ + + +-+-+ + +-+ + + + + +-+-+-+ + + + +-+ + +-+-+ + + + +-+-+-+ +-+ +-+ + + +-+ +-+ + +-+ + +-+-+
| | |     | |   | | | | |       | | | |   | |     | | | |       |   |   | | |   |   | |   | |     |
+ + +-+-+ + + + + + + +-+ +-+ + + +-+ + + + + +-+ + +-+ +-+-+ + +-+-+-+-+-+ + + + +-+ +-+ + + +-+ +
| |     | | | | | | |   |   | | |   | | | | |   | |   |     | |           | | | |   |   | | |   | |
+ + +-+-+ +-+ + + +-+-+-+ +-+-+ +-+-+-+-+ + + + + +-+ + + + +-+ +-+-+ + +-+-+-+-+ + + +-+ + +-+-+ +
| |     |   | | |       |     |         | | | | |   | | | |   |     | |         | | |   | |     | |
+ +-+-+-+-+ + + +-+-+ + +-+-+-+-+-+-+-+-+-+ + + +-+ + +-+-+ + + + +-+-+ + + + + +-+-+ +-+-+-+-+ +-+
|         | | |     | |                   | | |   | |     | | | |     | | | | |     |         |   |
+ + +-+-+ +-+-+ +-+-+-+-+ + +-+-+ +-+-+ + +-+-+-+ + + +-+ + +-+ + +-+-+ + + +-+ + + +-+-+ +-+-+-+-+
| |     |     |         | |     |     | |       | | |   | |   | |     | | |   | | |     |         |
+ +-+-+-+-+-+-+ +-+-+-+ + + + +-+ +-+-+-+-+ + + +-+-+ +-+ +-+-+ +-+ + + +-+-+-+-+-+ +-+ + + + +-+ +
|             |       | | | |   |         | | |     |   |     |   | | |           |   | | | |   | |
+ +-+-+ + + +-+-+-+-+-+-+-+-+ +-+ + + + +-+-+-+ +-+ +-+-+-+ + + + +-+ + + +-+ +-+-+ +-+ +-+ + + + +
|     | | |                 |   | | | |       |   |       | | | |   | | |   |     |   |   | | | | |
+ +-+ +-+ +-+ + +-+ + +-+ +-+ + +-+-+ + +-+ + +-+ +-+ + + + +-+ +-+ +-+ + + +-+ +-+-+ +-+-+-+-+ +-+
|   |   |   | |   | |   |   | |     | |   | |   |   | | | |   |   |   | | |   |     |         |   |
+ + + +-+ + + + +-+ +-+-+ +-+ + + +-+ + +-+ + +-+ +-+-+-+ + + + + + +-+-+-+ + + + +-+-+-+ + + +-+ +
| | |   | | | |   |     |   | | |   | |   | |   |       | | | | | |       | | | |       | | |   | |
+ + +-+ +-+ + + + +-+ +-+ + +-+ + + + +-+ +-+-+ + +-+-+ +-+-+-+ + + + + +-+-+-+-+-+ + + +-+ +-+ +-+
| |   |   | | | |   |   | |   | | | |   |     | |     |       | | | | |           | | |   |   |   |
+ + + + + + +-+ + +-+ +-+ +-+ +-+ +-+ + + +-+-+-+-+ +-+ + + + + + +-+-+-+-+-+ + +-+ + +-+ + + + +-+
| | | | | |   | |   |   |   |   |   | | |         |   | | | | | |           | |   | |   | | | |   |
+ +-+-+ + + +-+ +-+ +-+ + +-+-+ +-+-+ +-+-+ + + + +-+-+ + + +-+-+-+-+-+-+ +-+-+ +-+ + + +-+-+-+-+-+
|     | | |   |   |   | |     |     |     | | | |     | | |             |     |   | | |           |
+ +-+ + + + + + + + +-+ + + +-+ +-+ + +-+-+ + +-+ + + + +-+-+ +-+-+-+-+-+ +-+ + +-+ +-+-+-+ + +-+ +
|   | | | | | | | |   | | |   |   | |     | |   | | | |     |           |   | |   |       | |   | |
+ + +-+ + + +-+ +-+ +-+-+ +-+ +-+-+-+ + + +-+ +-+-+ +-+-+ + + +-+ +-+-+ +-+ +-+-+ + +-+ + + +-+ + +
| |   | | |   |   |     |   |       | | |   |     |     | | |   |     |   |     | |   | | |   | | |
+ +-+ +-+ + + +-+ +-+-+-+-+-+ + + + +-+ +-+-+ +-+ + + +-+-+ +-+-+ + +-+-+-+-+ +-+-+ +-+-+ + +-+ +-+
|   |   | | |   |           | | | |   |     |   | | |     |     | |         |     |     | |   |   |
+ + + +-+-+ +-+ + +-+-+ + + +-+ + + +-+ +-+ +-+ +-+-+ + + + + + +-+-+ + + + +-+ +-+-+-+-+-+-+-+-+ +
| | |     |   | |     | | |   | | |   |   |   |     | | | | | |     | | | |   |                 | |
+ + + +-+ + + + + +-+-+ +-+-+-+ + + + + +-+-+ + + + + +-+ + + +-+-+ + + + + + + + +-+-+-+ + + + + +
| | |   | | | | |     |       | | | | |     | | | | |   | | |     | | | | | | | |       | | | | | |
+ +-+ + + + +-+-+ +-+ + +-+ +-+-+ + + + +-+ +-+-+ +-+ +-+ +-+-+ + + +-+-+-+ + +-+ +-+-+ +-+ + +-+-+
|   | | | |     |   | |   |     | | | |   |     |   |   |     | | |       | |   |     |   | |     |
+ +-+ +-+-+ +-+-+ +-+ + + + + + + +-+-+ + +-+-+ +-+ + +-+-+-+-+-+-+-+ +-+ + + +-+-+ +-+ + +-+ +-+ +
|   |     |     |   | | | | | | |     | |     |   | |               |   | | |     |   | |   |   | |
+ + +-+-+-+-+-+ +-+-+ + +-+-+ +-+-+ + +-+-+ +-+ +-+ + +-+ + +-+-+-+ +-+ +-+-+ + +-+-+-+ + +-+ +-+ +
| |           |     | |     |     | |     |   |   | |   | |       |   |     | |       | |   |   | |
+ +-+-+ + +-+-+ +-+-+-+ + +-+ +-+-+ + +-+ + +-+-+-+ + + + +-+-+ +-+-+-+-+ +-+ +-+-+ + +-+ +-+-+-+-+
|     | |     |       | |   |     | |   | |       | | | |     |         |   |     | |   |         |
+ +-+-+-+-+-+ +-+-+-+ + +-+ + + + + +-+ +-+ +-+-+-+ + + +-+-+ + +-+-+ + +-+-+ + +-+ + + +-+ + +-+ +
|           |       | |   | | | | |   |   |       | | |     | |     | |     | |   | | |   | |   | |
+ +-+-+-+ +-+-+-+-+ + + +-+-+-+-+ + + + + +-+ + +-+ +-+ + +-+-+-+-+ +-+ + + +-+-+-+ + + + +-+ + +-+
|       |         | | |         | | | | |   | |   |   | |         |   | | |       | | | |   | |   |
+ +-+ + + +-+ + +-+ +-+ + + +-+-+-+-+-+-+-+-+ + +-+-+-+ +-+-+-+-+-+-+ +-+ + + +-+-+ +-+ + + +-+ +-+
|   | | |   | |   |   | | |                 | |       |             |   | | |     |   | | |   |   |
+ + + + +-+-+-+ +-+-+ + +-+-+ + + + + + +-+ +-+-+ + +-+-+ +-+-+ +-+-+-+ +-+-+ +-+ +-+-+-+-+ + +-+ +
| | | |       |     | |     | | | | | |   |     | |     |     |       |     |   |         | |   | |
+ + + + +-+-+ + +-+ + + + +-+-+-+ +-+-+ + +-+ + + +-+ +-+ + + + + + +-+ +-+-+-+-+-+ + +-+ +-+-+ +-+
| | | |     | |   | | | |       |     | |   | | |   |   | | | | | |   |           | |   |     |   |
+ +-+-+-+-+-+-+ +-+-+ +-+-+-+ +-+-+ + +-+-+ + +-+ +-+-+-+-+-+ + + +-+-+-+ + + +-+-+ + + +-+ +-+-+ +
|             |     |       |     | |     | |   |           | | |       | | |     | | |   |     | |
+ + + + +-+ + +-+ + + +-+ + + +-+ + +-+ + +-+ + +-+ + + +-+-+ + + +-+-+-+-+-+ + + + +-+ + +-+-+ +-+
| | | |   | |   | | |   | | |   | |   | |   | |   | | |     | | |           | | | |   | |     |   |
+ +-+-+-+ + +-+-+-+-+-+ +-+ + +-+-+-+-+ +-+-+-+-+ + +-+ + +-+ +-+ +-+-+ + +-+-+-+-+-+ +-+ + + + + +
|       | |           |   | |         |         | |   | |   |   |     | |           |   | | | | | |
+ + + +-+ +-+ + +-+-+-+-+-+-+ + +-+ + +-+-+ + +-+-+-+-+-+ + + +-+ + +-+ + +-+-+-+-+-+ +-+ +-+-+-+-+
| | |   |   | |             | |   | |     | |           | | |   | |   | |           |   |         |
+ + +-+ +-+ + + + +-+-+-+-+-+-+-+-+ +-+ + + +-+ + +-+-+ + +-+ + + +-+ + +-+-+ + + +-+ + +-+-+-+ +-+
| |   |   | | | |                 |   | | |   | |     | |   | | |   | |     | | |   | |       |   |
+ + +-+ + +-+-+ + +-+-+-+-+ + +-+ + +-+ +-+-+ + +-+ +-+ +-+-+-+-+ +-+ +-+ +-+ +-+-+-+-+-+-+-+-+-+-+
| |   | |     | |         | |   | |   |     | |   |   |         |   |   |   |                     |
+ + + +-+ +-+ +-+ + +-+-+-+-+ +-+-+-+-+-+ + +-+ +-+ + + + +-+ + +-+-+ +-+-+ +-+-+ +-+-+-+-+ + + +-+
| | |   |   |   | |         |           | |   |   | | | |   | |     |     |     |         | | |   |
+ + + +-+-+-+-+-+-+-+ + +-+ + + + + + +-+ +-+-+-+-+ +-+-+ +-+-+-+-+ +-+-+ + +-+ +-+ + + +-+ + + +-+
| | |               | |   | | | | | |   |         |     |         |     | |   |   | | |   | | |   |
+ + + + + +-+ +-+ +-+ + +-+ + + +-+-+-+-+-+-+ +-+ +-+ + +-+-+-+-+-+-+-+ + +-+-+ +-+-+ +-+-+ +-+ + +
| | | | |   |   |   | |   | | |             |   |   | |               | |     |     |     |   | | |
+ +-+ +-+-+-+-+ + +-+ + + + +-+ +-+ +-+-+-+-+-+ +-+-+-+-+ + +-+-+ +-+-+ + + +-+-+-+-+ +-+ +-+ + + +
|   |         | |   | | | |   |   |           |         | |     |     | | |         |   |   | | | |
+ +-+ + + + +-+-+-+ +-+-+ + + + + + + +-+-+ + +-+ +-+-+ + + + + +-+-+ +-+ +-+ + + +-+ + +-+ +-+ + +
|   | | | |       |     | | | | | | |     | |   |     | | | | |     |   |   | | |   | |   |   | | |
+ +-+ +-+ +-+-+ + +-+ +-+ +-+-+ +-+ +-+-+-+ + + +-+-+-+ +-+-+-+ + + + + +-+ +-+ +-+-+-+ +-+-+ + +-+
|   |   |     | |   |   |     |   |       | | |       |       | | | | |   |   |       |     | |   |
+ + + +-+-+-+-+ +-+ +-+-+-+ + +-+ + + + + + +-+ + +-+ + + + +-+-+ + + + +-+-+ + + +-+ + +-+ + +-+ +
| | |         |   |       | |   | | | | | |   | |   | | | |     | | | |     | | |   | |   | |   | |
+ +-+-+ + +-+-+ +-+ +-+-+ + +-+-+-+ +-+-+ +-+ +-+-+ + +-+-+-+ +-+ +-+ +-+ + + + + +-+-+ +-+-+ +-+-+
|     | |     |   |     | |       |     |   |     | |       |   |   |   | | | | |     |     |     |
+ +-+-+ + + +-+-+ + + +-+ +-+ + + + +-+ + +-+-+-+-+-+-+ + +-+ + + +-+-+ +-+-+ + +-+ +-+-+-+-+ +-+ +
|     | | |     | | |   |   | | | |   | |             | |   | | |     |     | |   |         |   | |
+ + +-+-+-+ + +-+ + +-+ +-+ + + +-+-+ + + + + +-+ + +-+ + + + +-+-+-+-+ + +-+ + +-+ +-+ +-+ + +-+ +
| |       | |   | |   |   | | |     | | | | |   | |   | | | |         | |   | |   |   |   | |   | |
+-+-+-+-+-+-+-+-+-+-+-+-+-+-+-+-+-+-+-+-+-+-+-+-+-+-+-+-+-+-+-+-+-+-+-+-+-+-+-+-+-+-+-+-+-+-+-+-+-+