+-+-+-+-+-+
| |       |
+ +-+-+ + +
|     | | |
+-+-+ +-+ +
|     |   |
+ +-+-+ + +
| |     | |
+ + +-+-+ +
|   |     |
+-+-+-+-+-+