+-+-+-+-+-+-+-+-+-+-+-+-+-+-+-+-+-+-+-+-+-+-+-+-+-+-+-+-+-+-+-+-+-+-+-+-+-+-+-+-+-+-+-+-+-+
|                                                                                         |
+ +-+ + + +-+ + + + + + + +-+ +-+ + + + +-+ + +-+ +-+ +-+ + +-+ + + +-+ +-+ +-+ +-+ + + + +
| |   | |   | | | | | | |   |   | | | | |   |   |   |   | |   | | | |     | |     | | | | |
+ + +-+-+ +-+-+ +-+ +-+ + + + +-+ + + +-+ + + + + + +-+ + + + + +-+ + + + + +-+ + +-+ + + +
| |   |   |       | |   | | | |   | |   | | | | | |   | | | | |   | | | | |   | |   | | | |
+ + + + + + + + +-+ + + + + +-+ + +-+ + + +-+ + + +-+ + + + + + + + + +-+ +-+ + +-+ +-+ + +
| | | | | | | |   | | | | |   | | |   | |   | | | |   | | | | | | | | |   |   |   | |   | |
+ + + + + +-+ + +-+ + + +-+-+ +-+-+ + + + + + + + +-+ + +-+ + + + + +-+-+ + + +-+ + + +-+-+
| | | | | |   | |   | |   |   |     | | | | | | | |   |   | | | | | |     | | |   | |     |
+-+ + +-+ +-+ + +-+ +-+-+ +-+-+ + + + + + + + + +-+ + + +-+ + + + + +-+ +-+ +-+ + +-+-+ + +
|   |   | |   | |     |     |   | | | | | | | | |   | |   | | | | | |   |     | | |     | |
+ + + + +-+ +-+-+-+ + + + + +-+ + + + +-+ + + +-+-+-+ + +-+-+-+-+-+-+ +-+ + +-+-+ +-+-+-+ +
| | | | |   |       | | | | |   | | |   | | |       | |     |         |   | |           | |
+ + +-+ + + +-+-+-+ + + + +-+-+ + + + + +-+ + +-+ +-+ + + +-+ + + +-+ +-+ + +-+ +-+ + +-+ +
| |   | | |       | | | |     | | | | | |   |   | |   | |   | | | |   |   |   |   | |   | |
+ + + +-+ + + +-+-+ +-+ +-+ +-+ + +-+ + +-+ +-+ + + +-+ +-+ + + + + + + +-+ + + +-+-+ + + +
| | |   | | |     |   |   |   | |   | |   | |   | | |     | | | | | | |   | | | |     | | |
+ + + + +-+-+-+ + + + +-+-+-+ +-+-+ + +-+ +-+ + + + + +-+ + +-+-+ + + +-+ + + + + +-+-+-+-+
| | | |       | | | |       | |     |   |   | | | | | |   |   |   | |   | | | | |         |
+ + + +-+ + + +-+-+ + +-+ + + +-+ + + + +-+-+ +-+-+ + + + + +-+-+-+ + + + + + + + + + +-+ +
| | | |   | | |     |   | | | |   | | | |     |     | | | |     |   | | | | | | | | |   | |
+ + +-+-+ + + + + +-+ + +-+ +-+-+ + + + + + + + + + +-+ +-+-+-+ + +-+ + + + + + + + +-+ +-+
| |   |   | | | |   | | |       | | | | | | | | | | |     |     | |   | | | | | | |   |   |
+ + + + + + + +-+ + + + + + + + +-+-+ +-+ + + + + + + + +-+ +-+ +-+-+ +-+ + + + + + +-+-+ +
| | | | | | |   | | | | | | | |     |   | | | | | | | | |   |   |       | | | | | |   |   |
+ +-+ + +-+ +-+-+ + +-+-+ + + +-+ + +-+ + +-+ +-+-+-+ +-+ + +-+ + +-+-+ + +-+ + +-+-+ + + +
| |   | |       | |     | | | |   |   | |   |   |       | | |   |   |   | |   | |     | | |
+ + + + + + + + + + +-+ + + + + +-+ + + +-+ + + +-+ + +-+ +-+ + + + + + + + + +-+ + + + + +
| | | | | | | | | | |   | | | | |   | | |   | |   | |   |   | | | | | | | | | |   | | | | |
+ + +-+ + +-+ + + + + +-+ +-+ + +-+ +-+ +-+ +-+ + +-+-+ +-+-+ +-+-+ + +-+ + + + +-+ +-+ + +
| |   | |   | | | | |   |   | |   |   | |     | | |     |         | | |   | | | |   |   | |
+ + +-+ + +-+ + +-+ +-+ + + +-+ +-+ + + + +-+ +-+ + +-+ +-+-+ + + + +-+-+ + + +-+-+ + + + +
| |   | | |   |   | |   | | |   |   | | | |     | | |     |   | | |   |   | | |     | | | |
+ +-+ + + + + + + +-+ + + +-+ + + + + + +-+-+-+-+ + + + + +-+ + +-+-+-+ +-+ +-+ + +-+ +-+ +
| |   | | | | | |   | | |   | | | | | |     |     | | | | |   |       | |   |   |   | |   |
+ +-+ + +-+ +-+ + +-+-+-+ +-+ + + + + + + + + + + + +-+-+ +-+ +-+-+ + + + + +-+ + +-+ + +-+
| |   |   | |   | |         | | | | | | | | | | | | |       |     | | | | | |   |   | |   |
+ + + + + + +-+-+ + +-+-+-+ +-+ + + + + + + +-+-+ + + +-+-+-+ + + + + + + + + + + +-+ + + +
| | | | | |     | | |       |   | | | | | |   |   | |       | | | | | | | | | | | |   | | |
+ + +-+ +-+ + +-+ + +-+-+ +-+ + + + + + +-+ + +-+-+ + +-+ + + +-+ +-+ + + + + +-+ + + + + +
| |   | |   | |   | |     |   | | | | |   | |   |   | |   | | |     | | | | |   | | | | | |
+ + + + +-+ + +-+ +-+ +-+ + + +-+-+ + + + +-+ + +-+ + +-+ + +-+ + +-+ +-+ + + + +-+ +-+-+ +
| | | | |   | |     |   | | | |     | | |   | | |   | |   | |   | |   |   | | | |       | |
+ +-+-+-+ + +-+ +-+ +-+ + +-+ + +-+-+-+ +-+-+ +-+ + + +-+-+-+ + + + + +-+-+ + +-+ + + + + +
|   |     | |     |   | | |   | |       |       | | | |       | | | | |     | |   | | | | |
+-+ + + + +-+ + +-+ + + + + + + +-+ + + +-+-+-+-+ +-+-+-+-+-+-+ + +-+ +-+-+ +-+-+-+ +-+ + +
|   | | | |   | |   | | | | | |   | | |       |     |           |   |     | |         | | |
+ + +-+ + + +-+ + +-+ +-+ + +-+ + + +-+-+ + + + + +-+ +-+ + + + +-+ + + +-+ +-+ +-+ +-+ +-+
| |   | | | |   |   | |   |   | | |     | | | | |   |   | | | | |   | |   |   | |     |   |
+ + + + + + +-+ + +-+-+ +-+-+ +-+ +-+ + + + + +-+-+ + + +-+ + + + +-+ +-+ + +-+ +-+-+ +-+ +
| | | | | | |   | |     |       | |   | | | |     | | | |   | | | |   |   | |   |       | |
+-+-+ + + +-+ + + + +-+ +-+ +-+ + + +-+ +-+ +-+ + +-+ +-+ + +-+ +-+ + + + + + +-+-+ + +-+ +
|     | | |   | | | |     |   | | | |     |   | | |     | |   | |   | | | | |   |   | |   |
+ +-+-+ +-+ + + + +-+ + + + + + + +-+ + +-+-+ + + +-+ +-+ + + + + +-+-+ + +-+-+-+-+ +-+ + +
|   |   |   | | | |   | | | | | | |   |     | | | |     | | | | | |     |     |       | | |
+-+-+-+ +-+-+-+ + + + + +-+ + +-+ + + +-+ + +-+ +-+ + + +-+-+ + + +-+ + + + + +-+-+ +-+ + +
|             | | | | |   | |   | | |   | | |   |   | |     | | |   | | | | |   |     | | |
+-+ + + + + + + + +-+-+-+-+ + + + + +-+ + + + + +-+ +-+ + + +-+ + +-+ + + +-+ + +-+ + + + +
|   | | | | | | |     |     | | | | |   | | | |   | |   | |   | | |   | | |   | |   | | | |
+ + + +-+ + + + + + + + + + +-+ + + + +-+-+ + +-+-+ +-+ +-+ + + + + +-+-+ + +-+ + +-+ + + +
| | |   | | | | | | | | | |   | | | |     | |     | |     | | | | |     | |   | | |   | | |
+ + +-+ + + + + + + + +-+ +-+ +-+ + + +-+ + + + + + + + + + + + + +-+ + +-+ + + + + + + + +
| | |   | | | | | | |   | |     | | |   | | | | | | | | | | | | | |   | |   | | | | | | | |
+ +-+ + +-+-+ + + + + + + + + + + +-+-+ + + + + +-+ + +-+ + +-+ +-+-+ +-+-+ +-+-+ + + + + +
|   | | |     | | | | | | | | | |     | | | | |   | |   | |   | |       |       | | | | | |
+ +-+ + + + + + + + + +-+ + +-+ + +-+-+-+-+ +-+ +-+ +-+ + +-+ +-+-+ + + + +-+ + +-+ + + +-+
| |   | | | | | | | |   | | |   |         |   | |     | | |       | | | | |   | |   | |   |
+ + + + + + + + +-+ + + + +-+-+ + + +-+-+-+ + +-+-+ + +-+-+-+ + + +-+ + + + + + + + + + +-+
| | | | | | | | |   | | |   |   | |       | |   |   | |       | |   | | | | | | | | | |   |
+-+ +-+-+ + +-+ + + + + + +-+-+-+ + +-+ +-+ + + + + +-+-+ +-+-+ + + +-+-+ + + + + + + +-+ +
|     |   | |   | | | | |       | |   |   | | | | |   |     |   | |     | | | | | | | |   |
+ + +-+ + +-+ + +-+-+-+-+ +-+-+ +-+ + + + + + + + + +-+ + + +-+-+ + + +-+-+ + + + +-+-+ + +
| |   | |   | |         |     |   | | | | | | | | |   | | |     | | | |     | | |     | | |
+ +-+ +-+-+ + + + + + +-+-+ + + + +-+-+-+ + + + + +-+ +-+-+ + + + + + + + + + + +-+-+ + + +
| |   |     | | | | |   |   | | | |       | | | |   |     | | | | | | | | | | |     | | | |
+ +-+ + + + + +-+ +-+ + + + +-+ + + +-+-+-+ + +-+ + + + + +-+ +-+-+ + +-+ +-+ + + + + + + +
|   | | | | | |   |   | | | |   | | |       | |   | | | | |     |   | |     | | | | | | | |
+ + + + + + + + + + + + + + +-+ + + + +-+ + + + + + + +-+ + +-+-+-+-+ + +-+ + +-+ +-+ +-+ +
| | | | | | | | | | | | | | |   | | |   | | | | | | |   | |   |       |   | |   |   |   | |
+-+-+ + + +-+ + + + +-+-+ +-+ + + +-+ +-+ +-+ + + + + +-+ + + + +-+ + +-+-+ +-+-+-+ + +-+ +
|     | |   | | | |     | |   | |   | |   |   | | | |   | | | | |   | |           | | |   |
+ + + + +-+ + +-+-+ + + + +-+-+-+ + +-+ + + + +-+ +-+ + + + + + + + + + + + +-+ +-+ + +-+ +
| | | | |   |     | | | |   |     |   | | | |   | |   | | | | | | | | | | | |   |   | |   |
+-+ + + + +-+ + + + + +-+-+ + + +-+ + + +-+-+ +-+ +-+ + +-+-+ + +-+-+ + + + +-+ +-+-+-+ + +
|   | | |   | | | | | |     | |   | | |     | |     | | |     |     | | | |   |       | | |
+ +-+ + + + + + + + +-+-+ + + + + +-+-+ + +-+-+-+-+ + +-+-+ + + + + +-+ + + + +-+-+-+ + + +
|   | | | | | | | |     | | | | |   |   |   |       |     | | | | |   | | | | |       | | |
+ +-+ +-+ + +-+ +-+-+-+-+ +-+-+-+-+ + + +-+ +-+-+ + + + +-+ +-+ +-+-+-+ + + +-+ +-+ +-+-+ +
|   |   | |   |         |         | | |   |   |   | | |   | |         | | | |   |       | |
+-+-+-+-+-+-+-+-+-+-+-+-+-+-+-+-+-+-+-+-+-+-+-+-+-+-+-+-+-+-+-+-+-+-+-+-+-+-+-+-+-+-+-+-+-+