+-+-+-+-+-+
| |       |
+ +-+-+-+ +
|         |
+-+-+-+-+ +
|   |     |
+ + + +-+-+
| | |     |
+ +-+-+-+ +
|         |
+-+-+-+-+-+