+-+-+-+-+-+-+-+-+-+-+-+-+-+-+-+-+-+-+-+-+-+
|         |               |             | |
+-+-+-+-+ +-+-+-+-+ +-+-+ +-+ +-+-+-+-+ + +
|   |   | |         |   |   | |       | | |
+ + +-+ + + +-+-+-+-+ +-+-+ + +-+-+ +-+ + +
| |     | |   |             |     | |     |
+ +-+-+-+ + + + +-+-+ +-+-+-+-+-+ + + +-+-+
| |     | | | | |   |     |       |   |   |
+ + +-+ + + + +-+ + +-+-+ +-+ +-+-+ +-+ + +
|   | |   | |     |     |     |       | | |
+ +-+ +-+-+ +-+-+-+-+-+ +-+-+ +-+-+-+-+ + +
| |   |     |   |     |     | |   |   | | |
+ + + + +-+-+ + + +-+ + +-+ +-+ + + + + + +
| | | | |   | | | |   | |   |   |   |   | |
+ +-+ + + + +-+ + + +-+-+ +-+ +-+-+-+-+-+ +
|   | |   |   | | |       |       |       |
+-+ + +-+-+-+ + + +-+ +-+-+ +-+-+-+ +-+-+ +
| | |   |       |   | |     |       | |   |
+ + +-+ + +-+-+-+-+ +-+ +-+-+ +-+-+-+ + +-+
| |   | | |       |     |     |   |   |   |
+ +-+ + + + +-+-+ + +-+-+ + +-+-+ + + +-+ +
| |   | | |   | | |     | | |   |   |     |
+ + +-+ + +-+ + + +-+-+ + +-+ + +-+-+ +-+-+
|   |       | | |     | |     |     |   | |
+ +-+-+-+-+-+ + +-+-+ +-+-+-+-+-+-+ +-+ + +
|   |     |   |     | |   |   |     |   | |
+-+ + +-+ + +-+ + + + + + + + + +-+-+ +-+ +
| | |   |   |   | | |   |   | |   |       |
+ + +-+ +-+-+ +-+ +-+-+-+-+-+ +-+ +-+-+-+ +
| |     |   | | |     |     |   |   |     |
+ +-+-+-+ + + + +-+ + +-+ + +-+ +-+ + +-+-+
|       | |     |   |     |   | |   | |   |
+ +-+-+-+ +-+-+-+ +-+-+ +-+-+-+ + +-+-+ + +
| |           |   |   | |       |   |   | |
+ + +-+-+-+-+-+ +-+-+ + + +-+-+-+-+ + +-+ +
| | | |         |   |   |         |     | |
+ + + + + +-+-+-+ + +-+-+-+-+-+-+ +-+-+ + +
|     | | |       | |         |   |   | | |
+-+-+-+ + + +-+-+-+ + +-+-+-+ + +-+ + + + +
|       | |   |   |   | |     |     | | | |
+ +-+-+-+-+-+ +-+ +-+-+ + +-+-+-+-+-+ +-+ +
|                       |                 |
+-+-+-+-+-+-+-+-+-+-+-+-+-+-+-+-+-+-+-+-+-+