+-+-+-+-+-+-+-+
|             |
+ + + +-+ +-+ +
| | |   |   | |
+-+ + + + + +-+
|   | | | |   |
+ + + + + + +-+
| | | | | |   |
+ +-+ +-+ + + +
| |     | | | |
+ +-+ + +-+ +-+
|   | | |     |
+ + + +-+-+-+ +
| | |     |   |
+-+-+-+-+-+-+-+