+-+-+-+-+-+-+-+-+-+-+-+-+-+-+-+-+-+-+-+-+-+-+-+
|   |   | |       |       | |         |     | |
+ +-+ +-+ + +-+ +-+-+-+ +-+ +-+-+-+ + +-+ +-+ +
|       |   |       |   |     |     |       | |
+ + +-+ + + + + +-+-+ + + +-+ + +-+-+-+ + +-+ +
| | |   | | | |       |     |     | |   |     |
+-+ + +-+-+-+-+-+-+ +-+-+ +-+ + + + +-+-+ +-+-+
|   | |     |   |     |   |   | |       |     |
+ +-+-+-+ + + +-+-+ + +-+-+ +-+ +-+-+ + + +-+ +
| |   |   | |     | |   |   |     |   | | | | |
+ + +-+-+-+ +-+ + +-+ +-+ +-+ +-+ + + +-+ + +-+
|   | |   |     |       | |   |   | | | | |   |
+-+ + + +-+-+-+ +-+ +-+ + +-+-+ +-+-+-+ + + + +
|   | | |   |   |     | |     | | |         | |
+-+ + + +-+ +-+-+-+ +-+ + +-+ +-+ +-+-+-+-+-+ +
|     |   | | |   | |   |   | | |     |       |
+-+ + + +-+ + +-+ + + +-+ +-+ + +-+ +-+-+ +-+-+
| | |   |           | |     |   |             |
+ + +-+ +-+ +-+-+-+ +-+-+-+-+-+-+ + + +-+ +-+ +
| | |   |   |       |         | | | | |   |   |
+ + +-+-+ +-+-+-+ +-+ +-+ +-+-+ + +-+-+-+ +-+ +
|     |   |         | | | | |   |     | | |   |
+-+-+ + +-+ +-+ +-+ + + +-+ + +-+ + +-+ + + + +
|       | |   |   |   |   | | | | | |     | | |
+-+-+-+-+ + + +-+ +-+ + + + + + + +-+-+ + +-+ +
|       |   | |     |   | |         |   |   | |
+-+-+ +-+-+ +-+-+ + + + + +-+ +-+-+-+-+-+-+-+-+
|   |   |     |   | | | |   |   |       | |   |
+ + +-+ + +-+-+-+-+-+-+ + + + +-+-+-+ +-+ +-+ +
| | |       |         | | | | |   | |         |
+ +-+ +-+-+ + +-+ +-+ + +-+ + + +-+ +-+-+ +-+ +
|       |   | |   | | | |   | |         |   | |
+ +-+ +-+-+-+-+-+ + +-+ +-+ +-+-+-+ + +-+ +-+ +
|   |   | |   |   |   |   | |   |   | |     | |
+ +-+ +-+ + +-+-+ + +-+ +-+-+-+ +-+ +-+ + + +-+
|   |   |     |     |   | |       | | | | | | |
+-+ + +-+ + + +-+-+ + + + + +-+ +-+ + +-+ + + +
|   |   | | | |   |   |     |     | |     | | |
+ +-+ +-+-+ +-+ + + +-+ +-+-+-+ + + +-+-+ + + +
|   |         | |   |         | |     | | | | |
+-+-+ +-+ + +-+-+ +-+-+-+ + +-+ +-+-+-+ +-+ + +
|   | | | | |       |     | |       | | |   | |
+ + +-+ +-+-+ +-+-+-+-+ +-+ + +-+ + + + + +-+ +
| |   | |   | | | |     |   | |   |         | |
+ +-+-+ + +-+ + + +-+-+ + +-+-+ +-+-+ + + + + +
|                   |   | |         | | | |   |
+-+-+-+-+-+-+-+-+-+-+-+-+-+-+-+-+-+-+-+-+-+-+-+