+-+-+-+-+-+-+-+-+-+
| |   |           |
+ +-+ + +-+-+-+ + +
|   |   |       | |
+-+ +-+-+ +-+-+-+ +
| |     | |     | |
+ +-+-+ + + +-+ + +
|     |   |   | | |
+ +-+ +-+-+-+ + + +
|   | |   |   | | |
+ + + + + + +-+ + +
| | | | | | | |   |
+ + + + + + + +-+-+
| | | | |   |     |
+-+ + + +-+-+ + + +
|   | |   |   | | |
+ +-+-+-+ +-+-+ + +
|               | |
+-+-+-+-+-+-+-+-+-+