+-+-+-+-+-+
| |       |
+ + +-+-+ +
| |   |   |
+ + + + +-+
| | | |   |
+ +-+ +-+ +
|   | |   |
+-+ + + +-+
|     |   |
+-+-+-+-+-+