+-+-+-+-+-+-+-+-+-+-+-+-+-+-+-+-+-+-+-+-+-+-+-+-+-+
|       |     |         |                   |   | |
+-+-+-+ + +-+-+ +-+-+-+ + +-+-+-+-+-+-+-+ + + + + +
|   |   |     |       | | |       |       |   |   |
+ + + +-+-+-+ +-+-+-+ + + +-+ +-+-+ +-+-+-+-+-+-+ +
| |   |     |         | |     |   | |   |       | |
+ +-+-+ +-+ +-+ +-+-+-+ + +-+-+ + + + +-+ + +-+-+ +
| |     | |   |     | |   |   | |   |     |       |
+ + +-+-+ +-+ +-+-+ + +-+-+ + + +-+-+ +-+-+-+-+-+-+
| |   |     | |   | | |   | |   | |   |           |
+ +-+ + +-+ + + + + + + + + +-+-+ + +-+ +-+-+-+-+ +
|     | |   | | |   | | |   |   |   |   |         |
+-+-+-+ + +-+ +-+-+ + + +-+-+-+ + +-+-+-+ +-+-+-+ +
| |     |   |     |   |   |     | |       | |   | |
+ + +-+-+-+ +-+-+ +-+-+-+ +-+ + + +-+ +-+-+ + + + +
|   | |         | |       |   | |   | |   |   |   |
+ +-+ + +-+-+-+ + + +-+-+-+ +-+-+-+ + +-+ + +-+-+-+
| |   | |       |   |       |     |   |   |   |   |
+ + + + +-+ +-+-+-+-+ +-+ +-+ + + +-+-+ + +-+ +-+ +
| | | |   |   |   |   |   |   | | |     |   |   | |
+ + + +-+ +-+-+ + + + +-+-+ +-+ + + +-+ +-+ +-+ + +
|   | | |       | | |       |   | | |   |   |   | |
+-+-+ + +-+-+-+-+ + +-+-+ +-+ +-+ +-+ +-+ +-+ +-+ +
| |   | |     |   | |   |   | | |   |   |   | |   |
+ + +-+ + +-+ + +-+ + + +-+-+ + +-+ +-+ +-+-+ + + +
| |   |     | |     | |     | | |       |     | | |
+ +-+ + +-+-+ +-+-+-+ +-+-+ + + + +-+-+-+ +-+-+ + +
|   | | |   |       |     |   |   |     |   |   | |
+ + + + + + + +-+-+ +-+-+ +-+-+ +-+ +-+ +-+ +-+ + +
| |   | | | |     | |   | |     | |   |   |   | | |
+ +-+-+-+ + +-+ + +-+ + + +-+ +-+ +-+ +-+ +-+ + + +
|         |   | | |   | |   |       |   |     | | |
+-+-+-+-+-+-+ +-+ + +-+ +-+ +-+-+-+ +-+ +-+-+-+ + +
|           | |   | |     |   |     |   |   |   | |
+ + +-+-+-+-+ + +-+ + +-+-+-+ +-+-+ + +-+ + + +-+ +
| |       |   |     | |     |     | |     | | |   |
+ +-+-+-+ + +-+-+-+-+ + +-+ +-+-+ + +-+-+-+ +-+ + +
|   |   |   |     |   |   |       | |     | |   | |
+-+ +-+ +-+-+ +-+ + + +-+ +-+-+-+-+ +-+-+ + + +-+ +
| |   |         |   | |   | |             |   |   |
+ +-+ +-+-+-+ + + +-+-+ +-+ + +-+-+-+-+-+-+-+-+ +-+
|   |       | | | |   |   | | |     |         | | |
+-+ +-+-+-+ + + + + + +-+ + + + +-+-+ +-+-+-+ + + +
|     |   | | | | | |     | | | |   |   |     | | |
+ +-+ + + + +-+ + + +-+-+-+ + + + + +-+ + +-+ + + +
| |   | | |     | | |   |       | |   | | |   |   |
+ +-+-+ + + +-+-+-+ + + +-+-+-+-+ +-+ + + +-+-+-+ +
| |     |   |       | |           | |   |       | |
+ + +-+-+-+-+ +-+-+-+ +-+-+-+-+-+-+ +-+-+-+-+ +-+ +
|           |                               |     |
+-+-+-+-+-+-+-+-+-+-+-+-+-+-+-+-+-+-+-+-+-+-+-+-+-+