+-+-+-+-+-+-+-+-+-+-+
|                   |
+ + + +-+ +-+-+-+ + +
| | |   |       | | |
+ +-+ + + +-+ + + + +
| |   | | |   | | | |
+ + +-+-+ +-+ + + + +
| |   |     | | | | |
+-+ +-+ + +-+ +-+-+ +
|   |   | |       | |
+ +-+-+ + +-+ +-+ + +
|     | |   |   | | |
+-+-+ + +-+ + +-+ + +
|     | |   | |   | |
+ +-+ +-+-+ + +-+ + +
|   | |     | |   | |
+ + + +-+ +-+-+ +-+ +
| | |   |   |     | |
+ + + +-+-+ + +-+ + +
| | |     | | |   | |
+-+-+-+-+-+-+-+-+-+-+