+-+-+-+-+-+-+-+-+-+-+-+-+-+-+-+-+-+-+-+-+-+-+-+-+-+-+-+-+-+-+-+-+-+-+-+-+-+-+-+-+-+-+-+-+-+-+-+-+-+-+
|                                                                                                   |
+ +-+ + + + + + + + + +-+ +-+-+ +-+ +-+ +-+ +-+-+ + +-+ +-+ + + + +-+-+ + +-+ + + +-+-+ +-+-+-+ + + +
|   | | | | | | | | |   |     |   |   |   |     | |   |   | | | |     | |   | | |     |       | | | |
+ +-+ + + +-+ +-+ + + +-+ + +-+-+ + + +-+ + + + + + +-+-+ +-+-+ + +-+-+-+-+-+-+ +-+-+-+ +-+ + + +-+ +
|   | | |   |   | | |   | |     | | |   | | | | | |     |     | |             |       |   | | |   | |
+ + + +-+-+ + +-+-+-+ +-+ +-+ + +-+-+ +-+ +-+-+-+ +-+ +-+ +-+ + +-+-+-+ +-+ +-+ + + + +-+ +-+ + + +-+
| | |     | |       |   |   | |     |   |       |   |   |   | |       |   |   | | | |   |   | | |   |
+ +-+ + + +-+ +-+-+ +-+-+-+-+-+ +-+-+ +-+-+-+-+-+ +-+ +-+ +-+ + +-+ +-+-+-+-+ +-+-+ + + +-+ + + + + +
|   | | |   |     |           |     |           |   |   |   | |   |         |     | | |   | | | | | |
+ + + +-+-+-+ + +-+-+-+ + +-+-+ + + + +-+ + +-+ + + +-+-+-+-+ +-+-+ +-+ + + + +-+ +-+-+ +-+-+-+-+ +-+
| | |       | |       | |     | | | |   | |   | | |         |     |   | | | |   |     |         |   |
+ + + +-+-+ + + +-+-+-+-+ +-+-+-+ + + +-+ + + + +-+ +-+-+ +-+-+-+ + + +-+-+-+-+-+-+ +-+-+-+ + + + +-+
| | |     | | |         |       | | |   | | | |   |     |       | | |             |       | | | |   |
+ + +-+-+ +-+ + +-+-+ + + +-+-+ + +-+ +-+-+ + + + +-+ +-+-+ + +-+ + +-+-+ + +-+ + + + + + + +-+-+ +-+
| |     |   | |     | | |     | |   |     | | | |   |     | |   | |     | |   | | | | | | |     |   |
+ + +-+ +-+ + +-+-+-+ +-+-+ +-+-+ + +-+ +-+ + +-+-+ +-+ + +-+ +-+-+-+-+ +-+ +-+-+-+ +-+-+ +-+ + + +-+
| |   |   | |       |     |     | |   |   | |     |   | |   |         |   |       |     |   | | |   |
+ + +-+-+ +-+ +-+-+ +-+-+-+-+ + +-+ +-+-+ + +-+ +-+ + +-+ +-+-+-+-+ + +-+ +-+-+-+-+-+ +-+-+-+-+ +-+-+
| |     |   |     |         | |   |     | |   |   | |   |         | |   |           |         |     |
+ + +-+ + +-+ + + +-+-+-+ + + + +-+-+-+-+-+-+-+-+-+-+-+-+-+ + +-+-+-+-+ + +-+-+ + + +-+ +-+ +-+-+-+ +
| |   | |   | | |       | | | |                           | |         | |     | | |   |   |       | |
+ +-+-+ + +-+-+ + + +-+ + + +-+-+ +-+ + + + + +-+ +-+-+ +-+-+-+ +-+ +-+-+-+ +-+ + +-+ +-+ + +-+ +-+-+
|     | |     | | |   | | |     |   | | | | |   |     |       |   |       |   | |   |   | |   |     |
+ + + +-+-+ +-+-+-+-+-+-+ +-+-+-+-+ +-+-+ + +-+ + + + + +-+-+ +-+ + + +-+ +-+ +-+-+-+ +-+ +-+ + + +-+
| | |     |             |         |     | |   | | | | |     |   | | |   |   |       |   |   | | |   |
+ + + +-+-+-+ + + + +-+ + +-+-+-+ + + +-+-+ +-+ +-+-+ +-+-+ + + + + + +-+ +-+-+-+ +-+-+ +-+-+ + + +-+
| | |       | | | |   | |       | | |     |   |     |     | | | | | |   |       |     |     | | |   |
+ + +-+-+ +-+-+-+-+-+-+-+ + + + + +-+ + +-+ +-+ + +-+ + + + + +-+-+-+-+ +-+-+-+ + +-+-+-+-+ +-+ + +-+
| |     |               | | | | |   | |   |   | |   | | | | |         |       | |         |   | |   |
+ +-+ + + +-+ + +-+-+ +-+-+-+ + +-+-+-+ + + + +-+-+-+ + + + + +-+-+-+-+-+-+ + + + +-+-+ + +-+ + +-+-+
|   | | |   | |     |       | |       | | | |       | | | | |             | | | |     | |   | |     |
+ +-+-+-+ + +-+-+-+ +-+-+-+-+-+ +-+-+ + + +-+-+ + + +-+-+-+ +-+ +-+-+-+-+-+ + + + + + +-+ + +-+-+-+-+
|       | |       |           |     | | |     | | |       |   |           | | | | | |   | |         |
+ +-+-+-+-+-+ + +-+ +-+-+ + +-+ + +-+-+-+-+ + +-+-+-+ + +-+ +-+ + + +-+ +-+ +-+-+ + +-+-+ + +-+ + +-+
|           | |   |     | |   | |         | |       | |   |   | | |   |   |     | |     | |   | |   |
+ +-+ + + +-+ +-+-+-+ +-+-+-+ + + + + + +-+ + + + + + + + + +-+ + + +-+-+-+ + +-+ + + +-+ +-+-+ +-+-+
|   | | |   |       |       | | | | | |   | | | | | | | | |   | | |       | |   | | |   |     |     |
+ +-+-+-+-+-+ + + + +-+ +-+ + + + + +-+-+-+-+-+-+ + +-+-+-+-+-+-+ + + +-+-+-+-+ +-+ +-+ + +-+ + + +-+
|           | | | |   |   | | | | |             | |             | | |         |   |   | |   | | |   |
+ + +-+ + +-+-+ +-+-+-+-+-+-+ +-+ + +-+-+ +-+ + +-+-+-+-+-+-+-+ +-+-+ +-+-+-+-+ +-+-+-+-+ + +-+-+ +-+
| |   | |     |             |   | |     |   | |               |     |         |         | |     |   |
+ + + +-+-+ + + +-+ +-+-+ +-+-+-+ +-+ +-+-+ + + +-+-+-+ + +-+ + +-+-+-+ + + +-+-+ + + + +-+ +-+ + +-+
| | |     | | |   |     |       |   |     | | |       | |   | |       | | |     | | | |   |   | |   |
+ +-+ +-+ + +-+ + + + +-+ +-+ +-+ +-+-+-+ +-+-+ +-+-+-+ + +-+-+ + + + +-+ + + + + + + + + + +-+-+ + +
|   |   | |   | | | |   |   |   |       |     |       | |     | | | |   | | | | | | | | | |     | | |
+ + + +-+-+-+-+ +-+-+ +-+ +-+ +-+ + + +-+-+-+ + + + +-+-+ +-+ +-+ + +-+ + +-+ + +-+-+-+-+-+ +-+ +-+-+
| | |         |     |   |   |   | | |       | | | |     |   |   | |   | |   | |           |   |     |
+ + + + +-+-+-+ + + +-+-+ +-+ +-+ +-+ + + + + +-+-+ + +-+ +-+ + + +-+ + + +-+ +-+-+-+ +-+ + +-+-+-+-+
| | | |       | | |     |   |   |   | | | | |     | |   |   | | |   | | |   |       |   | |         |
+ +-+ +-+ +-+ + + +-+ +-+ + +-+-+-+ + +-+ + + + + +-+-+ + + + +-+-+ +-+ +-+-+ + +-+-+ +-+-+ + + + + +
|   |   |   | | |   |   | |       | |   | | | | |     | | | |     |   |     | |     |     | | | | | |
+ + +-+-+ +-+-+ + +-+ + + +-+-+-+-+-+ +-+-+-+ +-+ + +-+ + + +-+-+-+-+-+-+ +-+-+ + + + + +-+ +-+ + +-+
| |     |     | |   | | |           |       |   | |   | | |             |     | | | | |   |   | |   |
+ +-+ +-+-+ +-+-+ + +-+ + +-+ +-+ + +-+ + + +-+-+-+-+ + + + + +-+ + +-+ + +-+ + +-+-+-+-+ +-+ +-+ + +
|   |     |     | |   | |   |   | |   | | |         | | | | |   | |   | |   | |         |   |   | | |
+ +-+ +-+-+ + + + + +-+ +-+ + +-+ + + + +-+ + +-+-+ + + +-+ + +-+ + + + + +-+ + +-+ + +-+-+ + +-+ + +
|   |     | | | | |   |   | |   | | | |   | |     | | |   | |   | | | | |   | |   | |     | |   | | |
+ + + +-+ + + + +-+-+-+ + +-+-+ + +-+ + +-+ + +-+ + + + + +-+-+ + + +-+-+ +-+-+ +-+-+ +-+-+-+ +-+ + +
| | |   | | | |       | |     | |   | |   | |   | | | | |     | | |     |     |     |       |   | | |
+ +-+ +-+-+ + + + + + + + + + + + + + +-+ +-+ + +-+ +-+-+ + + + +-+-+ + +-+-+-+ + +-+ +-+-+ + +-+-+-+
|   |     | | | | | | | | | | | | | |   |   | |   |     | | | |     | |       | |   |     | |       |
+ + +-+-+ + + +-+ +-+ +-+ + + +-+ + +-+ + + + + +-+-+-+ + +-+-+ +-+-+ + +-+-+-+ +-+ +-+ +-+ +-+-+ + +
| |     | | |   |   |   | | |   | |   | | | | |       | |     |     | |       |   |   |   |     | | |
+ +-+ + + + + +-+ + + + + + + + +-+-+ + +-+ +-+-+-+-+-+ + +-+-+-+ + + + + + + +-+-+ + +-+-+-+ +-+ +-+
|   | | | | |   | | | | | | | |     | |   |           | |       | | | | | | |     | |       |   |   |
+ +-+-+-+-+ +-+ + +-+ + + + +-+-+ + + + + +-+-+-+ + +-+ +-+-+ +-+ + +-+ +-+ +-+-+ + + +-+-+-+-+ + +-+
|         |   | |   | | | |     | | | | |       | |   |     |   | |   |   |     | | |         | |   |
+ + +-+ +-+ + + +-+ + +-+-+ + +-+-+ +-+-+ + +-+ +-+ +-+-+ + +-+ + + +-+ + +-+-+ +-+-+-+-+-+ + +-+ + +
| |   |   | | |   | |     | |     |     | |   |   |     | |   | | |   | |     |           | |   | | |
+ +-+-+-+ + + + +-+-+ + +-+ + + +-+-+ + + +-+ +-+ +-+-+ +-+-+-+-+-+ +-+ +-+-+ +-+ + +-+-+ +-+-+-+ +-+
|       | | | |     | |   | | |     | | |   |   |     |           |   |     |   | |     |       |   |
+ + +-+ + + +-+ +-+ +-+ + + + + +-+-+-+ +-+-+-+ + +-+-+ + +-+ + + + + +-+ +-+-+-+-+-+ + +-+ +-+ + +-+
| |   | | |   |   |   | | | | |       |       | |     | |   | | | | |   |           | |   |   | |   |
+ +-+-+ + + +-+ +-+-+-+-+-+ +-+ + + + +-+ + +-+ + + + +-+-+-+ +-+-+-+-+ + + +-+ + + + +-+-+ + +-+-+ +
|     | | |   |           |   | | | |   | |   | | | |       |         | | |   | | | |     | |     | |
+ +-+ +-+-+-+-+-+-+ + + + +-+-+-+-+ +-+-+ +-+-+-+ +-+-+ +-+ + +-+ +-+ +-+-+-+ + +-+-+ + + +-+-+ +-+ +
|   |             | | | |         |     |       |     |   | |   |   |       | |     | | |     |   | |
+ +-+ + + + +-+-+ + + + +-+-+ +-+-+ +-+ + + +-+ + + + + +-+ + + + +-+-+ +-+ +-+ + +-+ + + + + +-+ +-+
|   | | | |     | | | |     |     |   | | |   | | | | |   | | | |     |   |   | |   | | | | |   |   |
+ + + +-+ + + +-+-+-+ + + + +-+ + +-+ + +-+-+-+-+ + +-+ + +-+ +-+-+ +-+-+ + +-+ +-+-+-+-+ + + +-+ + +
| | |   | | |       | | | |   | |   | |         | |   | |   |     |     | |   |         | | |   | | |
+ +-+-+ +-+-+ +-+-+-+-+-+-+-+ + + + + +-+ +-+-+ + +-+ +-+-+-+ +-+-+-+-+ + + + +-+ + +-+ +-+ +-+ +-+ +
|     |     |               | | | | |   |     | |   |       |         | | | |   | |   |   |   |   | |
+ + +-+-+ +-+ + +-+ +-+ +-+ + +-+ +-+-+-+ + + +-+ + +-+-+-+ +-+-+ +-+ + +-+-+-+ +-+-+-+ +-+ +-+ +-+-+
| |     |   | |   |   |   | |   |       | | |   | |       |     |   | |       |       |   |   |     |
+ +-+ + + + + + +-+-+-+ + +-+ + + + +-+ + +-+-+ + + +-+-+ +-+-+-+-+ + +-+ + + + + + +-+ + + + +-+-+-+
|   | | | | | |       | |   | | | |   | |     | | |     |         | |   | | | | | |   | | | |       |
+ +-+-+-+-+ +-+ +-+ +-+-+-+ + +-+-+ + + + + + +-+-+ + +-+-+-+ + +-+ + + +-+ +-+ + +-+ +-+-+ +-+-+-+ +
|         |   |   |       | |     | | | | | |     | |       | |   | | |   |   | |   |     |       | |
+ + + +-+-+ +-+-+-+-+ +-+ +-+-+ +-+-+ + + +-+-+-+ + +-+ +-+-+ +-+ +-+-+-+-+ +-+-+ + + + + + +-+-+-+-+
| | |     |         |   |     |     | | |       | |   |     |   |         |     | | | | | |         |
+ +-+ +-+-+ + +-+-+-+ +-+ + + + +-+ +-+ + +-+ + + +-+-+ + + + +-+-+ +-+-+ +-+ + +-+ + + + +-+ + +-+-+
|   |     | |       |   | | | |   |   | |   | | |     | | | |     |     |   | |   | | | |   | |     |
+ +-+-+ +-+ +-+-+ + + + +-+ + +-+ +-+ + + + + + +-+ +-+-+-+-+ + + + +-+ +-+-+ + + + +-+-+ +-+ +-+ + +
|     |   |     | | | |   | |   |   | | | | | |   |         | | | |   |     | | | |     |   |   | | |
+ + + + +-+ +-+-+-+-+ + + +-+ +-+-+ +-+ +-+ +-+-+ + + + +-+-+ +-+ +-+-+ +-+-+-+ + + +-+-+-+ +-+ +-+ +
| | | |   |         | | |   |     |   |   |     | | | |     |   |     |       | | |       |   |   | |
+ + + +-+ +-+-+ +-+-+ + +-+-+-+ +-+-+ + + + + + + +-+-+ + + + +-+-+ +-+-+-+-+-+ +-+-+-+-+-+-+-+ +-+-+
| | |   |     |     | |       |     | | | | | | |     | | | |     |           |               |     |
+-+-+-+-+-+-+-+-+-+-+-+-+-+-+-+-+-+-+-+-+-+-+-+-+-+-+-+-+-+-+-+-+-+-+-+-+-+-+-+-+-+-+-+-+-+-+-+-+-+-+