+-+-+-+-+-+-+-+-+-+-+-+-+-+-+-+-+-+-+-+
| |             |               |   | |
+ +-+ +-+-+-+-+ + +-+ +-+-+-+-+ + + + +
|     |       | |   |   |     | | |   |
+-+-+-+ +-+-+ + +-+-+-+ +-+ +-+ + +-+ +
| |     | |   | |     |   |   | |   | |
+ + +-+-+ + + + + +-+ +-+ + + + + + +-+
| | |     | | |   | |     | | | | |   |
+ + + +-+-+ + +-+-+ +-+-+-+-+ + +-+-+ +
|     |     | |               |       |
+ +-+-+ +-+-+ +-+ + +-+-+-+-+ +-+-+-+ +
| |     |         | |   |   |     |   |
+-+ + +-+-+-+-+-+-+ + + +-+ +-+-+ + +-+
|   | |         |   | |   |       | | |
+ +-+ + +-+-+-+ +-+ + +-+ + +-+-+-+ + +
| | | | |     |   | | | | | |   |   | |
+ + + + + +-+ +-+ + + + + +-+ + + +-+ +
| |   |   | |   | | | | |     | | |   |
+ + +-+-+-+ +-+ + +-+ + +-+-+-+ + + +-+
| | |     |     |     | |     | | |   |
+ +-+ +-+ + +-+-+-+-+-+ + +-+ + + + + +
| |   |   | |         | | |   |   | | |
+ + +-+ + + + +-+-+-+ + + + +-+-+-+-+ +
|     | | | | |   |   | | |           |
+ +-+-+ + + + +-+ + +-+ + +-+-+-+ +-+-+
| |     | |   |   |   |   |   | |     |
+ + +-+-+ +-+-+ +-+-+ + +-+ + + +-+-+ +
| |   | | |           |     | |   | | |
+ +-+ + + + +-+-+-+-+-+-+-+-+ + + + + +
| | | |   | |   | |     |       | | | |
+ + + +-+ + + + + + + + +-+-+-+-+ + + +
| | |   | |   | |   | |       |     | |
+ + +-+ + +-+-+ +-+-+ +-+-+-+ +-+-+-+ +
|     | |     |     |   |   |         |
+-+-+ + +-+ +-+-+-+ + + + + +-+-+-+-+ +
|     |   | |     | | | | | |   |     |
+ +-+-+-+ +-+ +-+ + +-+ + +-+ + + +-+-+
|       |       |       |     |       |
+-+-+-+-+-+-+-+-+-+-+-+-+-+-+-+-+-+-+-+