+-+-+-+-+-+-+-+-+-+-+-+-+-+-+-+-+-+-+-+-+-+-+-+-+-+-+-+-+-+-+-+-+-+-+-+-+-+-+-+-+-+-+-+-+-+-+-+-+-+-+
|                                                                                                   |
+ +-+ +-+-+ + + + + + +-+ +-+ + + + + + + + + + + + + + +-+-+ +-+ +-+ +-+ +-+ +-+ + +-+ + + +-+ +-+ +
|   |   |   | | | | | |     | | | | | | | | | | | | | | |     |   |     | |     | | |   | |   |   | |
+ + + + +-+ + + +-+ + + + + + + + + +-+ + +-+-+ +-+ + + + + + + + + + + + +-+-+-+-+ + + + + + + + + +
| | | |   | | |   | | | | | | | | | |   |     | |   | | | | | | | | | | |   |       | | | | | | | | |
+ +-+ +-+-+ +-+-+ +-+ + +-+ + + +-+-+ +-+ + + + + + + + + +-+ + +-+ +-+ +-+ +-+-+ +-+ +-+ + +-+ + + +
| |   |     |       | | |   | |   |     | | | | | | | | | |   | |   |     | |     |     | |   | | | |
+ + +-+ + + + + + +-+-+-+ + +-+ +-+-+ +-+-+-+ + + + + + +-+ +-+ + + +-+-+ + +-+ + + + + + + + + + + +
| |   | | | | | |   |     | |       |       | | | | | |   | |   | |     | | |   | | | | | | | | | | |
+ +-+ + + + + + +-+ + + +-+-+-+-+ +-+ + + + +-+ + + +-+ + + + + + +-+-+-+ +-+ +-+ +-+ + +-+-+ +-+-+ +
|   | | | | | | |   | |       |     | | | |   | | |   | | | | | | |         |   | |   |   |   |     |
+ + + +-+-+-+ +-+ + + + +-+ + + + + + + + + + + + + + + + +-+-+ + + +-+ + + +-+ + +-+-+-+ + +-+ + +-+
| | |   |       | | | | |   | | | | | | | | | | | | | | |     | | | |   | |   | |     |   |   | |   |
+ +-+ +-+ + + + + +-+ +-+ + + +-+ + + +-+ + +-+ +-+-+ + + + + +-+ + +-+ + + + + + + +-+ + + + +-+ +-+
| |     | | | | |   |   | | | |   | | |   |   |   |   | | | |   | |   | | | | | | |   | | | |   |   |
+-+-+-+ + + + + +-+ +-+ +-+-+ + + + + + + + +-+ +-+ + + +-+-+ +-+ + + + + + + + +-+ + + + + +-+-+ + +
|       | | | | |     |   |   | | | | | | | |     | | |     |   | | | | | | | |   | | | | | |     | |
+ + +-+ + + + + + +-+-+ + + + + +-+-+-+-+ + +-+ + +-+ + +-+-+-+ + + + +-+ + + + +-+ + + +-+-+-+-+ + +
| |   | | | | | |   |   | | | |       |   |   | |   | |   |     | | | |   | | | |   | |   |       | |
+ + + + + + +-+ + +-+ + + +-+ + +-+ +-+ +-+-+-+ + + + +-+ +-+-+ + +-+ + +-+ + + +-+ + + + +-+ +-+-+ +
| | | | | |   | |   | | |   | | |   |     |     | | | |     |   | |   |   | | | |   | | |   |     | |
+ +-+-+-+ + +-+ +-+-+ + +-+-+ + + +-+-+ + + + + + +-+ + +-+-+ +-+-+ + +-+ +-+ + +-+ + + + + + + +-+ +
|   |     |   |   |   |     | | | |     | | | | |   | | |     |     | |   |   | |   | | | | | |   | |
+-+ +-+-+ + +-+ +-+-+ +-+ +-+ + + + + + + + + + + + + + +-+ + +-+ +-+-+ +-+ + + + + + +-+ + + + +-+ +
|   |     | |       | |   |   | | | | | | | | | | | | |   | |   |   |     | | | | | | |   | | |   | |
+ +-+ + + +-+ +-+ + + + +-+-+ + + +-+ +-+-+ + + + +-+ +-+-+ +-+-+-+ +-+ +-+-+ + + + + + +-+ +-+-+ + +
|   | | | |     | | | |     | | | |     |   | | |   | |           | |       | | | | | | |       | | |
+ + + + + + +-+ + +-+ + + +-+-+ +-+ + + + +-+ + +-+-+ +-+ + + + +-+-+ + +-+ +-+-+ + + + + + + + + + +
| | | | | | |   |   | | |   |     | | | | |   |     | |   | | | |     |   |     | | | | | | | | | | |
+ + + + + +-+-+-+ + + + + +-+ + + + + +-+-+ + + +-+-+ + +-+ + + + + + + + + +-+-+ + + + +-+ + +-+ + +
| | | | | |       | | | | |   | | | |     | | |     | | |   | | | | | | | | |     | | | |   | |   | |
+ + + + +-+ + + + +-+ +-+ + + + + + +-+-+ + + +-+ + + + + +-+ + +-+-+ + + + + +-+-+-+ +-+ + +-+ +-+ +
| | | |   | | | | |   |   | | | | | |     | |   | | | | | |   | |     | | | | |         | |   | |   |
+ + + + + + + + + + + +-+ +-+ +-+ + +-+ + + + + + +-+ + + + + + + +-+ + + +-+-+ + +-+ + +-+ + +-+-+ +
| | | | | | | | | | |   | |   |   |   | | | | | | |   | | | | | |   | | |     | |   | |   | |   |   |
+ +-+ + + + + +-+-+ + + + + + + + +-+-+ + +-+ + + +-+-+-+ + + + +-+-+-+ +-+ + + +-+-+-+ + +-+ + + + +
|   | | | | | |     | | | | | | |   |   | |   | |   |     | | | |         | | |     |   |   | | | | |
+ + + +-+-+ + +-+ +-+ +-+ +-+ + + +-+ + +-+ +-+-+ +-+ + +-+-+-+ + + + +-+-+-+ +-+ +-+-+ + + +-+ + + +
| | | |     |   |   |   | |   | |   | |   |   |   |   |     |   | | | |       |       | | |   | | | |
+ + + +-+ +-+-+ + + + +-+ + + + + +-+ + +-+ +-+ +-+-+ +-+-+ +-+ +-+ + + + +-+-+-+ +-+ + + +-+ + + +-+
| | |   |     | | | |   | | | | | |   | |     |   |     |   |     | | | |       | |   | | |   | |   |
+ + + + + + +-+ + + + + + + +-+-+ +-+-+ + +-+ + + + + + +-+ + + + + + + +-+ + + + +-+ + + + +-+ +-+ +
| | | | | |   | | | | | | | |       |   |   | | | | | |   | | | | | | | |   | | |   | | | | |     | |
+ + + +-+-+ +-+ +-+-+ + +-+-+ + +-+ + + + +-+ +-+ +-+-+-+-+-+ +-+ + + + + + + + +-+-+ + + +-+ + + + +
| | | |     |   |     |     | |   | | | | |   |           |   |   | | | | | | |   |   | |   | | | | |
+ +-+-+-+ +-+ + + + +-+ + + + + + +-+-+ + + + + + +-+ + +-+ + + +-+ + +-+ + +-+ +-+ +-+-+ + + + + + +
|   |       | | | |   | | | | | |   |   | | | | |   | | |   | | |   |   | |   |   |     | | | | | | |
+ + + + + +-+-+-+ + +-+-+ +-+ + + + + + +-+ + + + + +-+ + + + +-+-+ + + +-+ + +-+ +-+ + + +-+-+ + + +
| | | | |       | |     |   | | | | | |   | | | | | |   | | |     | | |   | |   |   | | |   |   | | |
+-+-+-+ +-+ + + + + + + + + + +-+-+ + + + + + + + +-+-+ + + +-+ + + + +-+ + + +-+ +-+ + + + + +-+-+ +
|       |   | | | | | | | | |   |   | | | | | | | |     | |   | | | |   | | |   |   | | | | |   |   |
+ +-+ + + + + +-+ + + + + +-+ + +-+-+ +-+ +-+ + + +-+-+ + + +-+-+ +-+-+ +-+ +-+-+ +-+ + +-+ + + +-+ +
| |   | | | | |   | | | |   | |   |     | |   | |     | | |   |       | |     |     | |   | | |   | |
+ + + + + +-+ + + +-+ +-+ +-+ + + +-+-+-+-+ +-+ +-+ + + + + + + +-+ + + + + + +-+ + +-+ + + + + + + +
| | | | | |   | | |   |     | | |       |   |     | | | | | | |   | | | | | | |   |   | | | | | | | |
+ + + + +-+ +-+ + +-+ + + + + +-+ + +-+ +-+ + + + +-+ + + + +-+ + + + +-+ + + + +-+ +-+-+ + + +-+-+-+
| | | | |   |   |   | | | | | |   | |   |   | | |   | | | | |   | | |   | | | |   |     | | |       |
+-+ + + + + + + +-+-+ + + + + + + + + + +-+ + +-+ + +-+ + + + + + + +-+-+ + + +-+ + + + + + + + +-+ +
|   | | | | | | |     | | | | | | | | | |   |   | |   | | | | | | |   |   | | |   | | | | | | | |   |
+ +-+ +-+ + +-+ +-+ + + + + +-+ + + + + + + + +-+-+ +-+ + + + + +-+ +-+ +-+ + +-+-+-+ +-+-+ + +-+ +-+
|   |   | |   | |   | | | |   | | | | | | | | |       | | | | |   | |     | | |         |   | |     |
+ + + + + +-+-+ + + + + + +-+-+ + +-+-+ + + +-+ + + +-+ + + +-+ + + + + + + + + + +-+ +-+-+-+-+ + +-+
| | | | |   |   | | | | | |     |     | | | |   | | |   | |   | | | | | | | | | | |           | |   |
+ +-+ +-+ + + +-+ + + + + + + + + +-+ +-+ +-+ +-+ +-+-+ + + + +-+ + + +-+ +-+ +-+-+ +-+ +-+ + + + + +
|   |   | | | |   | | | | | | | |   | |   |     | |     | | |   | | | |   |       | |     | | | | | |
+-+ +-+-+ + + + +-+-+ +-+ + +-+ + + + + + + + + +-+ + + +-+ + +-+ +-+-+ + +-+ +-+ +-+ +-+-+ +-+ + + +
|   |     | | | |     |   |   | | | | | | | | |   | | | |   | |   |     |   |   | |       |   | | | |
+ +-+ + + +-+-+ +-+-+ +-+ + + + + + + +-+-+-+ +-+ +-+ + + + +-+ + + + + + + +-+ +-+ + + +-+ + +-+ + +
| |   | |   |       |   | | | | | | |     |   |     | | | |   | | | | | | |   |   | | | |   |   | | |
+ + + + + + +-+ + + + + + +-+ + + + + + + + + +-+ + + +-+ + +-+-+ + + + + + + + + + + + + + + +-+-+ +
| | | | | | |   | | | | | |   | | | | | | | | |   | |   | |     | | | | | | | | | | | | | | |     | |
+-+ +-+-+ +-+ + + + + +-+-+ + +-+-+-+ + + + + + + +-+ + + + +-+ + +-+ + +-+-+ + +-+-+-+ + +-+ + +-+ +
|       |   | | | | |   |   | |       | | | | | |   | | | | |   |   | |     | | |       |   | |   | |
+-+-+ + + + +-+ + + + +-+-+ +-+-+ +-+ + + +-+ +-+ + +-+ + +-+-+ + + + + + + + + + +-+ +-+ +-+ + +-+ +
|     | | |   | | | | |         |   | | |   | |   |   | |   |   | | | | | | | | |   |   | |   |   | |
+ + +-+ + + +-+-+ +-+ + + + + + + + +-+-+ + +-+ +-+ + + + + +-+ + + +-+ +-+-+ + + + +-+-+-+ + +-+ +-+
| |   | | |     |   | | | | | | | |     | |   |   | | | | | |   | |   | |     | | |   |     |   |   |
+ + + +-+ +-+ + + + + + + +-+ + + + +-+ + + + + + + + +-+ + + + + + + + +-+ + + + + + + + + + + +-+ +
| | | |     | | | | | | | |   | | |   | | | | | | | | |   | | | | | | | |   | | | | | | | | | | |   |
+ +-+ + +-+ +-+-+ + + + + + +-+ + + + + + + +-+ +-+-+ + +-+ + + + + + +-+ +-+-+ + + + + +-+ + + + + +
|   | | |     |   | | | | |   | | | | | | |   |   |   |   | | | | | |   |     | | | | |   | | | | | |
+ + + +-+ + + +-+ +-+ +-+ +-+ +-+-+ +-+ + +-+-+-+ + + + + + +-+-+-+-+-+ + +-+ +-+ + + + + + +-+ +-+ +
| | |   | | |   | |     |   | |       | |       | | | | | | |           | |     | | | | | |   |   | |
+ + + + + +-+ + + + + + +-+ +-+-+-+-+ +-+ + +-+-+-+ +-+ + +-+-+ +-+ +-+ + + +-+ +-+ +-+ + + + +-+-+ +
| | | | | |   | | | | |   |   |         | | |       |   |   |   |     | | | |   |   |   | | |     | |
+ + +-+ + + +-+ +-+ + + +-+-+ + +-+ + + + + +-+ +-+-+ + + + +-+-+ + + + + + +-+-+ + +-+ + +-+-+ +-+ +
| |   | | | |     | | |     | | |   | | | |   |   |   | | | |     | | | | | |     | |   | |       | |
+ + + +-+ + +-+ +-+ + + + + + + + + +-+ + + + +-+ + +-+ +-+-+ + + +-+-+ +-+ + +-+ + + +-+-+ +-+ +-+ +
| | | |   | |     | | | | | | | | |   | | | | |   |   |     | | |   |     | |   | | |   |     |   | |
+ + +-+ + + +-+-+ + + +-+-+-+-+ +-+-+ + + + + + + + + + +-+ + + + + + + +-+ +-+-+ + + + +-+ +-+ + + +
| |   | | |   |   | |     |         | | | | | | | | | | |   | | | | | |   |     | | | |   | |   | | |
+ + + + + +-+ +-+-+ + +-+-+ + + +-+ +-+-+-+-+ +-+ +-+-+ + + + +-+-+ + + + +-+ + + + + + + + + +-+-+ +
| | | | | |       | |   |   | | |   |           |   |   | | |     | | | |   | | | | | | | | | |     |
+-+ + + +-+ + + +-+-+-+ + +-+-+-+ + +-+-+ + + + + + + + + +-+ +-+ + + + + + + +-+ + +-+ + + + + + + +
|   | |   | | |   |     |       | |   |   | | | | | | | |   |   | | | | | | |   | | |   | | | | | | |
+-+ +-+ + +-+ + + + +-+-+ +-+ +-+-+ +-+ +-+ + + + + +-+-+ +-+ + + + + +-+ + + + + +-+ + + + + + +-+ +
|     | |   | | | |   |   |     |     |   | | | | | |       | | | | |   | | | | | |   | | | | | |   |
+ +-+ + + +-+ +-+ + + +-+ + +-+-+ + + + + + + + + + + +-+ +-+ +-+ + + + + +-+-+ + + + + +-+ + + + + +
|   | | | |     | | | |   | |     | | | | | | | | | |   | |     | | | | |     | | | | |   | | | | | |
+-+-+-+-+-+-+-+-+-+-+-+-+-+-+-+-+-+-+-+-+-+-+-+-+-+-+-+-+-+-+-+-+-+-+-+-+-+-+-+-+-+-+-+-+-+-+-+-+-+-+