+-+-+-+-+-+-+-+-+-+-+-+-+-+-+-+-+-+-+-+-+-+-+-+-+-+-+-+-+-+-+-+-+-+-+-+-+-+-+-+-+-+-+-+-+-+-+-+-+-+-+
|         |           |             |     |   |       |       |                     |           |   |
+-+-+-+-+ + + +-+-+-+ + +-+-+-+-+ + +-+ + + + +-+ +-+ + +-+ + +-+ +-+-+ +-+-+-+-+-+ + +-+-+ +-+ +-+ +
|   |   | | |   |   | |     |   | |     |   |     | | |   | |   | |     | |       | | |     |   |   |
+ +-+ + + +-+-+ + +-+ +-+-+ +-+ + +-+-+-+-+-+-+-+-+ + +-+ + +-+ + + +-+-+ + +-+ + + +-+ +-+-+ +-+ + +
|     |   |     |     | |       |   | |       |     | |   | | | | | |   |   | | | |   | | |   |   | |
+ +-+-+-+-+ +-+-+ +-+-+ + +-+-+-+-+ + + +-+ + + +-+ + + +-+ + + +-+ + + + +-+ + +-+-+ + + + +-+ + +-+
|   |       |   | |   |   |         |   |   | | |   | | |   |       | | |     | |   |   |   |   |   |
+-+ + +-+-+-+ +-+ + +-+ +-+ +-+-+-+-+-+-+ +-+ + + + + +-+ +-+-+-+-+-+ + +-+-+-+ + + +-+-+ +-+-+-+-+ +
| | |   |     |   |       |     |         |   | | | |   |     |       |       | | |     | |       | |
+ + + + +-+ + + +-+ +-+-+-+-+-+ + +-+-+-+ +-+-+ + +-+-+ + +-+ + +-+-+ +-+-+-+ + + +-+ +-+ + + +-+ + +
|   | |   | |   | |     |       |     |   |     |   |   |   | | |   |     |     | | | |   | |   | | |
+ +-+-+-+ + +-+-+ + +-+-+ +-+-+-+ +-+ +-+ + +-+-+-+ + +-+-+ + +-+ + +-+ + +-+-+-+ + + + +-+-+-+ + + +
| |       |     |   |   | |     | | |   | |     | |   |   | |     |   | | |         | |         | | |
+ + +-+-+-+-+-+ + +-+ + + + +-+-+ + +-+ +-+-+-+ + +-+-+-+ + +-+-+-+-+ + + + +-+-+-+-+ +-+-+-+-+-+ + +
|   |   |     | | |   |   |       |   |         | |       |   | |     | |         |     |       |   |
+-+-+ +-+ + + + +-+ +-+-+-+ +-+-+-+ + +-+-+-+-+-+ + + + +-+-+ + + +-+-+-+ +-+-+-+ + +-+ + +-+ +-+-+ +
|         | | | |   |   |   | |     |   |   |       | | |   | | | |     | |   |   |   |   | | |   | |
+ +-+-+-+-+ + + + +-+ + + +-+ + +-+ +-+ + + + +-+-+-+ +-+ + + + + + +-+ +-+ + +-+-+ + +-+-+ + + + + +
|   |   |   | | | |   | | |   | |   |   | | | |     |   | | |   | | | |   | |     | | |   |   | |   |
+-+ + + + +-+-+ + + +-+ + + +-+ + +-+ +-+-+ + +-+-+ +-+ + + + +-+ + + +-+ + +-+-+ +-+ + + + +-+ +-+-+
|   | | | |   |   |   | | |     |   |       |     |   |   |   |   |     |   |     |   | | |   | |   |
+ +-+-+ + + + +-+-+ + +-+ + +-+-+-+ +-+-+ +-+-+-+ +-+ +-+-+-+-+ + +-+-+ +-+-+ +-+-+ +-+ + + +-+ + +-+
| |     |   | |     |     |   |   |   |   |       |   |       | | |   |   |   |     |   | | |   |   |
+ + +-+-+-+-+ + +-+-+-+-+-+-+-+ + +-+ +-+-+ +-+-+-+ + + +-+-+ + +-+ + +-+ + +-+ +-+-+-+-+ + + +-+-+ +
|   |       | |   |           | |   |     | |       | | |   | |   | |     | |   |   |     | |   |   |
+-+ + +-+-+ + +-+ +-+-+-+ +-+ + +-+ +-+-+ + +-+-+ +-+ +-+ + + +-+ + +-+-+-+ + +-+ + + +-+-+ +-+ + +-+
| | | |     |   |   |   | | | | |     |   |     | | |     | |   |   |   |   |     | | |   |   | |   |
+ + + +-+-+ + + +-+ + + + + + + +-+-+ + +-+-+-+ + + + +-+-+ + + +-+-+-+ + +-+-+ +-+ + + + + +-+ + + +
|   |     |   |   |   |   | | |   | | |         | |   |   |   | |       |     | |   | | |   |   | | |
+ +-+-+-+ + +-+-+-+-+-+-+-+ + +-+ + + + +-+-+-+-+ + +-+ + +-+-+ + +-+-+-+-+-+ +-+ +-+ + +-+-+ +-+-+ +
|   |     | |           |   | |   |   |     |   | |   | |   |     |       |   |   |         |       |
+-+ + +-+-+ + +-+ +-+-+ + + + + +-+ +-+-+-+ + + + +-+ + +-+ +-+-+-+ +-+-+ + +-+ +-+-+-+-+-+ +-+-+-+ +
| | | | |   | | |   |     | |   | |   | |     |   |   | | |   |     | |   |   |       | |   |     | |
+ + + + + +-+ + +-+ +-+-+-+ +-+-+ +-+ + + +-+-+-+-+-+-+ + +-+ + +-+-+ + +-+-+ +-+ +-+ + + +-+ +-+ + +
|   | | |   |   | |       | |         |   | |           |   |   |     |     |   | |   |   |     | | |
+ +-+ + +-+ +-+ + +-+-+-+ + + +-+-+-+-+ +-+ + +-+-+-+-+-+ + +-+-+ +-+ +-+-+ +-+ + + +-+ +-+-+-+-+ + +
|   | |       | |     | | | |     |     |   | |     |     |     |   | |     |   | | |   |         | |
+-+-+ +-+-+-+ + + + + + + +-+-+-+ +-+ +-+ +-+ + +-+-+ +-+-+ +-+ +-+ + + +-+-+ +-+-+ +-+ +-+ +-+-+-+ +
|     |   |   | | | |   |       |   |     |   |     | |   | | | |   | | |   |     |   |     |     | |
+ +-+-+ + + +-+ + + +-+-+-+-+ + +-+ +-+-+ + +-+-+-+ + +-+ + + + + +-+ + +-+ + +-+ + + +-+ +-+ +-+ + +
| |     | |   | | |     |     | | |   | | |       | | |   | |   |   |   |   | | | | |   | |   | |   |
+ + +-+-+ +-+ + +-+-+-+ + +-+-+ + +-+ + + +-+-+-+ + + + +-+ +-+-+-+ +-+-+ +-+ + + +-+-+ +-+ +-+ +-+-+
|   |   |   | |         | |   |     | |       |   | | |   |   |   | |       |   | |     |   |   |   |
+ +-+ + +-+ +-+-+-+-+-+ + + + +-+-+ + + +-+-+-+ +-+ + +-+ +-+ + + + + +-+-+ +-+ + + +-+-+ +-+ + +-+ +
|   | |   |           | | | |   |   | | |     | |   |   |   |   | | |     |     | |           |   | |
+-+ + +-+-+-+-+-+-+-+ + + +-+-+ + +-+ + + +-+ + +-+ +-+ + +-+-+-+ + +-+-+ +-+-+-+ +-+ +-+-+-+-+-+ + +
|     |   |     |     | |     |   | | | | |   |   |   | | |     | | |   |   |   |   | |       | |   |
+ +-+-+ + + +-+ + +-+-+ +-+-+ + +-+ + +-+ + +-+-+ + +-+ + + +-+ + + + + +-+ + +-+-+ +-+ +-+-+ + +-+ +
| | |   | | |     |     |   | |     |     | |     |     | | |     |   | |     |   |         | |   | |
+ + + +-+ + +-+ +-+ +-+-+ + + +-+-+ +-+-+-+ + + +-+ +-+-+ + +-+-+-+-+-+ + +-+-+ + +-+-+-+-+-+ + +-+ +
|   |   | |   | |   |   | |   | |   | |   | | | | | |   | |           | | |     |         |   |     |
+-+ +-+ + +-+ + + +-+ +-+ +-+-+ + +-+ + + + + + + + + + + +-+-+-+-+ +-+ +-+ +-+-+-+-+-+-+ + +-+ +-+-+
| | |   | |   | | |   |   |     |     | |   | | | |   |     |     |     |   |       |     | |   |   |
+ + + +-+ + + +-+ + + + +-+ +-+ + +-+-+ +-+-+-+ + +-+-+-+-+ + +-+ + +-+-+ +-+-+ +-+-+ +-+-+ + +-+-+ +
|   | |   | | |   | | | |     |   |   | |       |           | | | |     | |     |   | |     | |     |
+ +-+ + +-+ +-+ +-+-+ + +-+-+-+ +-+ + + + +-+-+-+-+-+ +-+-+-+ + + +-+-+ + + + +-+ + + + +-+-+ + +-+ +
| |   |   |           |       | |   |   | |     |   | |   |   | | |   |   | | |   |   |   |   |   | |
+ + +-+-+ + +-+-+-+-+-+-+ +-+ +-+ +-+-+-+ + +-+ + + + +-+ + +-+ + + + +-+-+ +-+ +-+-+-+-+ + +-+ + + +
| |   |   | |     |     | |   |   |       | | |   | |     |     | | |   |   |             | |   | | |
+ +-+ + +-+-+ +-+ + +-+ +-+ +-+ +-+ +-+-+ + + +-+-+ +-+-+-+-+-+ + + +-+ + +-+ +-+-+-+-+-+-+ + +-+ + +
|   | |     | |     | | |   |   |       | | |   | |         |   |   |   |   | |     |     | |   | | |
+ +-+ +-+-+ + +-+-+-+ + + +-+ +-+-+-+-+-+ + + + + +-+-+-+ +-+ +-+-+-+ +-+ + + + +-+ + + + + +-+ + + +
| |   |   |   |     |   |   |           | | | | |     | |   |     | | |   |   |   | | | | |   | | | |
+ + +-+ + +-+ + +-+ +-+ + + +-+-+-+-+-+ + + + + +-+ + + +-+ +-+-+ + + +-+-+-+-+-+ + +-+ +-+-+ + + + +
| | |   |   | |   |   | | |     |     | |     |     | |   |         |           | |   |     | | | | |
+ + + +-+-+ + +-+ +-+ + +-+-+ +-+ +-+ + +-+-+-+-+-+-+ +-+ +-+-+-+-+-+ +-+-+-+ +-+ +-+ + + + + +-+ + +
| | | |     |   |   | |     |     |   |     | |       |     | |     |   |     |     | | | | |     | |
+ + + + +-+-+ +-+ +-+ +-+-+ +-+ +-+ +-+-+-+ + + +-+-+-+ +-+ + + +-+ +-+-+ +-+-+ +-+-+ +-+ + +-+-+-+ +
| |   | |     |   |   |   |   |   | |       | | |   |   |   | | | |     |       |   | |   |       | |
+ +-+-+ +-+-+-+ +-+ +-+ +-+-+ +-+-+ + +-+-+-+ + + + + +-+ +-+ + + +-+-+ + +-+-+-+ + + + +-+-+-+-+-+ +
|   | |   |     |   |   |   | |   | | |         | | |   | |   | |       |   |   | |   |   |   |   | |
+-+ + +-+ + +-+-+ +-+-+ + + + + + + + +-+-+-+-+ + + +-+ + +-+ + + +-+-+-+-+ +-+ + +-+-+-+ + + + + + +
| |   |   | |   |     | | | |   |   |     |   |   |   | |     | | |       |   | | |     |   |   | | |
+ +-+ + +-+ +-+ +-+-+ + + + +-+ +-+-+-+-+ + + + +-+-+ + + +-+-+ + + +-+-+ +-+ + + + +-+ +-+-+-+-+ + +
| |   | |   |   |   | |   | |   |       | | | | |   | | | |   | |   |   | |   | |   |   |       | | |
+ + +-+ + +-+ + +-+ + +-+-+ + +-+ +-+-+ + + + +-+ + + + +-+ + + +-+-+-+ + + +-+ +-+-+ +-+ +-+-+ + + +
|   | |   |   |     |     |   |   | |   | | |     | | |   | |   |       | |   | |   | |   |   |   | |
+ +-+ +-+-+ +-+-+-+ +-+-+ + +-+ +-+ + +-+ + +-+-+-+ + + + + +-+-+ +-+-+-+ +-+ + + + + + +-+ + +-+-+ +
| |         |   |   |   | |   |     |     |   |     | | | |   |   |   |   | | |   | | |   | |       |
+ +-+-+-+ +-+-+ + +-+ + + +-+ +-+-+ +-+-+-+-+ + +-+-+ +-+ +-+ + + + + + +-+ + +-+-+ + +-+ + +-+-+-+-+
|         |     | |   | | |   |   | |   |     |   |     | |   | | | |   |     |   | |   | | |       |
+-+-+-+-+-+ + +-+ + +-+ + +-+ +-+ + + + + + +-+-+ +-+-+ + + +-+ +-+ +-+-+-+ +-+ + + +-+ + + + +-+-+ +
|           |     | |   |   |     | | | | | |   | |   |   | |       |     |     |     | | |   |   | |
+ +-+-+-+-+-+-+-+-+ + +-+-+ +-+-+-+ + +-+ + + + + + + +-+ + +-+ +-+-+ +-+ +-+ +-+-+-+-+ + +-+-+ +-+ +
| |   |             | |   |       | |     | | | |   | |   |   |       | |   | |         |           |
+ +-+ + +-+-+-+-+ +-+ + +-+-+-+-+ + +-+ +-+ + +-+-+-+ +-+ +-+ +-+ +-+-+ +-+ + + +-+-+-+-+ +-+-+-+-+-+
| |   | |       |   |   |     |   |   |   | |       |   |   |   | |   |     | | |   |     |         |
+ + + + + + +-+-+-+ +-+-+ +-+ + +-+-+ +-+-+ +-+-+-+ +-+ +-+-+-+ +-+ + + +-+-+-+ + +-+ +-+-+ +-+-+-+ +
| | | | | |       | |     |   |     | |     |   |   |   |     |     | |       | |   |   | |       | |
+ + +-+ + +-+-+-+ + + +-+-+ +-+-+-+ + + +-+-+ + + +-+ +-+ +-+ + +-+-+ +-+-+-+ + + + +-+ + + +-+-+-+ +
| | |   | |     | |   |   |       |   |   |   | |   | |   | | | |   | |     | | | |   | |   |       |
+ + + +-+-+ +-+ + +-+-+ + +-+ +-+ +-+-+-+ + +-+ + + + + +-+ + + + +-+ + + + + + +-+-+ + +-+-+ +-+-+-+
| |     |   |         | | |   | | |     | | |   | |   |   |   |   |   | | | | | |   | |     |       |
+ +-+-+ + +-+-+-+ +-+-+ + + +-+ + + +-+ + + + +-+ +-+-+-+ + +-+-+-+ +-+ + + + + + + + +-+-+ +-+-+-+ +
|     | | |     | |     | |   | | | | | |   | | | |       |       | |   | | | |   | |     |     |   |
+-+-+ + + + +-+ +-+ +-+-+ +-+ + + + + + +-+-+ + + + + +-+-+-+-+-+ + +-+-+ +-+ +-+-+ + +-+ +-+-+ + + +
|   | |   |   |   | |   | |   | | | |   |   | |   | |         |   |   |   |   |   | |   |     | | | |
+ +-+ +-+-+-+ +-+ + + + + + +-+ + + + +-+ + + + +-+-+-+-+-+-+ + +-+-+ + +-+ +-+ + + + + +-+-+-+ + + +
|             |     | |     |       |     |   |               |       |         |   | |           | |
+-+-+-+-+-+-+-+-+-+-+-+-+-+-+-+-+-+-+-+-+-+-+-+-+-+-+-+-+-+-+-+-+-+-+-+-+-+-+-+-+-+-+-+-+-+-+-+-+-+-+