+-+-+-+-+-+-+-+
|             |
+ + + + + + + +
| | | | | | | |
+ +-+-+ + +-+ +
|     | |   | |
+ +-+-+ + +-+-+
|     | |     |
+ + + + + + + +
| | | | | | | |
+ +-+ + + + +-+
|   | | | |   |
+ +-+-+-+-+ +-+
|         |   |
+-+-+-+-+-+-+-+