+-+-+-+-+-+
| |       |
+ +-+ +-+ +
|     |   |
+ +-+ +-+ +
|   |   | |
+-+ + + + +
|   | | | |
+-+-+-+ +-+
|         |
+-+-+-+-+-+