+-+-+-+-+-+-+-+-+-+-+-+-+-+-+-+-+-+-+-+-+-+-+-+-+-+-+-+-+-+-+-+-+-+-+-+-+-+-+-+-+-+-+-+-+-+-+-+-+-+-+
|                                                                                                   |
+-+ + + + + + + +-+ + + + +-+-+ + + + + + + + + +-+-+-+-+ + + +-+ +-+ + +-+ + + +-+ +-+-+ +-+ + + + +
|   | | | | | |   | | | |   |   | | | | | | | |       |   | | |   |   |   | | |   |     |   | | | | |
+ +-+ +-+ +-+-+ +-+-+ + + + + +-+ + +-+ +-+-+-+-+ +-+-+ + + +-+ +-+ + + + +-+ + + +-+ +-+ + + + +-+ +
|   |   |   |     |   | | | | |   | |           |   |   | | |     | | | | |   | | |   |   | | | |   |
+ + + + + + +-+-+-+ + + + + + + + + +-+ + + +-+-+ + + + + + + + + + +-+ + + +-+-+ + + +-+ + + + + + +
| | | | | |       | | | | | | | | |   | | |   |   | | | | | | | | |   | | | |     | | |   | | | | | |
+ + +-+ + + + + +-+-+ + +-+ +-+ + + + + +-+ +-+-+ + + + +-+ +-+ + + +-+-+ +-+ + + + + + + + + + + + +
| |   | | | | | |     | |   |   | | | |   |     | | | | |   |   | |   |   |   | | | | | | | | | | | |
+-+ + + +-+-+ + + + + +-+-+-+ +-+-+ +-+ + + +-+ + + +-+ +-+ + + + + +-+-+-+ + + + +-+ +-+-+ + + + + +
|   | | |     | | | |   |         |   | | | |   | | |     | | | | | |       | | | |   |     | | | | |
+ +-+ + + +-+-+ + + +-+ + + + + + + + +-+ + +-+ + +-+ + + + + +-+ +-+-+ +-+-+ + +-+ +-+ + + + +-+-+ +
|   | | |   |   | |   | | | | | | | | |   |   | | |   | | | |   |   |     |   |   |   | | | |     | |
+ + + + + + + + + + + +-+ + + + + + +-+-+ +-+-+ + + + +-+-+ +-+-+ + + + + + + + +-+ + + +-+-+ +-+ + +
| | | | | | | | | | | |   | | | | | |     |     | | | |     |     | | | | | | | |   | | |       | | |
+ +-+ + + + + +-+-+ + + +-+-+ +-+-+ + + + +-+ +-+ + + +-+ + +-+ + + + + + + + +-+ +-+ + + +-+ + + + +
|   | | | | | |     | | |     |     | | |   | |   | |   | |   | | | | | | | |   | |   | | |   | | | |
+-+ +-+ + + + +-+-+ + + + + + + + + +-+-+-+ + + +-+ + +-+ +-+ + + + +-+ + + +-+ +-+-+ +-+-+ + +-+ + +
|     | | | |     | | | | | | | | |       | | | |   |   |   | | | |   | | | |       | |     | |   | |
+ + + +-+-+ + + + + + +-+ + + + +-+-+ + + + + + +-+ +-+-+ + +-+-+-+ +-+ +-+ + +-+ + + +-+ +-+ + + + +
| | | |     | | | | | |   | | |   |   | | | | |   |     | | |       |     | |   | | |   | |   | | | |
+-+ + + +-+ + + +-+ + + + +-+ + + + + + + + +-+-+ +-+ + + +-+ + + + + + + +-+ + +-+-+ +-+-+ +-+-+ + +
|   | |   | | | |   | | | |   | | | | | | | |     |   | |   | | | | | | | |   |   |     |     |   | |
+ + + + + + + +-+ + + +-+ + +-+-+ + + + +-+-+ +-+ +-+-+ +-+ +-+ + + + + +-+ + + +-+ + + +-+ + + +-+ +
| | | | | | | |   | | |   |   |   | | |     |   |     |   |   | | | | | |   | |   | | | |   | |   | |
+ + + + + + + + +-+-+-+ + + + +-+ + + + +-+ + + +-+ + +-+ +-+ + +-+ +-+ + + +-+ + +-+ +-+-+ +-+-+-+ +
| | | | | | | |   |     | | | |   | | | |   | | |   | |   |   |   | |   | |   | | |   |           | |
+-+ +-+-+ +-+-+ + + + + + + + + + + + + + + + +-+ + +-+-+ + + + + +-+ + + +-+ + +-+ + + + + + + + + +
|       | |     | | | | | | | | | | | | | | |   | | |     | | | | |   | | |   |   | | | | | | | | | |
+ +-+-+ + + + +-+ + +-+ + +-+ + + +-+ + + + +-+ + + + + +-+ +-+ +-+-+-+ + + + +-+ +-+ + + + +-+ + + +
|     | | | |   | |   | | |   | |   | | | |   | | | | |   |   | |       | | |   |   | | | |   | | | |
+ +-+ + +-+ + +-+ +-+ + +-+ + + + + + + +-+ + + + + + + +-+ + + + + + +-+-+-+ + + + + + + + + + +-+ +
|   | |   | | |   |   | |   | | | | | | |   | | | | | | |   | | | | | |       | | | | | | | | |   | |
+-+ +-+-+ + + + +-+ + + + + +-+-+-+ +-+-+ +-+ +-+-+ + + + + +-+-+ +-+ + + +-+ + +-+ + +-+ +-+ + + + +
|   |     | | | |   | | | |       |   |   |     |   | | | | |       | | | |   | |   |   |   | | | | |
+ +-+ +-+-+ + + +-+ + +-+-+-+-+ + +-+ + + + + +-+ + + +-+ + + +-+-+-+-+ + + + + + + + + + + + +-+ + +
| |   |     | | |   |     |     | |   | | | | |   | | |   | |       |   | | | | | | | | | | | |   | |
+ + + + + + +-+ + +-+ +-+-+-+ + + + + + + +-+ +-+ + + + +-+ +-+ +-+-+-+-+ +-+-+ + + + + + + + +-+ + +
| | | | | |   | |   |       | | | | | | |   |   | | | |   | |         |       | | | | | | | | |   | |
+-+-+ +-+-+ +-+ + +-+-+-+ +-+ +-+-+ + + + +-+-+ +-+-+-+ +-+-+ +-+-+ + + + +-+-+ + + + +-+ + + + + +-+
|     |       | | |         | |     | | |   |     |     |     |     | | | |     | | |   | | | | |   |
+ + +-+ +-+-+-+ +-+ + +-+-+-+-+-+-+-+ + + + + + + + +-+ + +-+ +-+-+ + + + + +-+ +-+ +-+ + +-+-+ +-+ +
| | |       |   |   |               | | | | | | | | |   |   |   |   | | | | |   |     | | |     |   |
+-+ + + +-+-+ +-+-+ + + + + + + +-+-+ + + + + +-+-+-+ + + + + + + + + +-+ +-+ +-+ + + + + +-+ +-+-+-+
|   | | |     |     | | | | | |     | | | | |   |     | | | | | | | |   | |   |   | | | | |         |
+-+ + + + + +-+-+ + + +-+ + + + + + +-+ + + +-+ + + + + + + + +-+ +-+ +-+ + +-+ +-+ + + +-+ + + +-+ +
|   | | | |     | | | |   | | | | | |   | | |   | | | | | | | |   |     | | |   |   | | |   | | |   |
+ +-+ +-+ +-+ + + + + + +-+ + + + + +-+ + + + + +-+ + +-+ + + + + + + + + + + + + + + +-+ + +-+-+ + +
|   |   | |   | | | | |   | | | | | |   | | | | |   | |   | | | | | | | | | | | | | |   | |     | | |
+ +-+ + + +-+ +-+-+ + + +-+ + +-+-+ + + + +-+-+ + + + +-+ +-+ + +-+ + + +-+ + + + +-+ + +-+ +-+-+ + +
| |   | | |   |     | | |   | |     | | |     | | | |   | |   | |   | |   | | | | |   | |     |   | |
+ + +-+-+-+ + + +-+ + + + + +-+-+ +-+ +-+ + + +-+ +-+ +-+ + + + + + + + + + +-+ +-+-+ +-+-+-+ +-+ + +
| |       | | | |   | | | |   |     |   | | | |   |   |   | | | | | | | | | |   |           | |   | |
+ + +-+ + +-+-+ + + + +-+ +-+ +-+ + +-+ + + +-+ + + + + +-+ +-+-+-+ +-+-+-+ +-+-+-+ +-+ +-+-+-+ + + +
| | |   |   |   | | | |     | |   | |   | | |   | | | |   |       | |             | |         | | | |
+ + + + + + + + + + +-+-+ + + + + + + +-+ + + +-+ + +-+ + + + + + + +-+-+ + +-+ + + +-+-+ + + +-+ + +
| | | | | | | | | |   |   | | | | | | |   | | |   | |   | | | | | | |     | |   | | |     | |   | | |
+ + + + + + +-+ +-+ + + +-+-+ +-+-+ +-+ +-+-+ + + + + + +-+ +-+ + + + + + + + + +-+ +-+ + + + +-+ + +
| | | | | | |     | | | |       |   |   |     | | | | | |   |   | | | | | | | |   | |   | | | |   | |
+ +-+-+ +-+ + +-+-+ + +-+-+-+ + + + + + +-+ + + + +-+ + + +-+-+ + + +-+ + + +-+ +-+ + + + + + + +-+-+
| |     |   | |     |       | | | | | |   | | | |   | | |   |   | |   | | | |     | | | | | | |     |
+ +-+-+ + + +-+ + + + + + + +-+ + + + + + + + + + + + + + +-+-+ + + +-+ + + + + + +-+-+ + + + +-+-+ +
| |     | |   | | | | | | |   | | | | | | | | | | | | | |     | | | |   | | | | |     | | | | |     |
+ + +-+ + +-+-+ + +-+ +-+ + +-+ + +-+ +-+-+ + + +-+-+ + + +-+ + + + + + +-+-+ +-+ +-+-+ + + +-+ + +-+
| |   | | |     |   |   | | |   |   | |     | |     | | |   | | | | | | |       | |     | |   | |   |
+ + +-+ +-+-+ +-+ + + + + + +-+ +-+ + + +-+ + + + + + +-+ +-+-+-+ +-+ + + + +-+ + + +-+ + +-+ + +-+ +
| | |   |       | | | | | |   |   | | | |   | | | | | |         |   | | | | |   | |   | | |   |   | |
+ + + +-+ + + + + + + +-+-+ + + + + + + + + + + + + + + + +-+-+ +-+ + + +-+ + + +-+ +-+-+ +-+ +-+ + +
| | |   | | | | | | | |     | | | | | | | | | | | | | | |   |   |   | |   | | | |     |     | |   | |
+ + +-+ + +-+ +-+-+ + + + + +-+ + +-+ + +-+ + +-+-+ +-+-+-+ + + + + + +-+ + + + + + +-+ + + +-+ +-+ +
| |   | |   |   |   | | | | |   | |   | |   |     |   |     | | | | | |   | | | | |   | | | |     | |
+ +-+ + + + + + + + + + + +-+ + +-+ + + +-+-+ +-+ +-+ +-+ + + + + + +-+ +-+ + +-+ +-+ + + + + + + + +
| |   | | | | | | | | | | |   |   | | |     | |     | |   | | | | |   | |   |   |   | | | | | | | | |
+-+ + +-+-+-+-+ + +-+ +-+-+-+-+-+ + +-+ + + +-+-+ + +-+ +-+ +-+ + + +-+ + + + + +-+ +-+ + +-+ + + +-+
|   | |         | |             | |   | | |     | |   | |   |   | |   | | | | |   |   | |   | | |   |
+ +-+ + + +-+ +-+ + + +-+ + + +-+ + + + + + +-+-+ + + + +-+-+ + + + + + +-+ + + + + +-+-+-+ + + + +-+
|   | | | |     | | | |   | |   | | | | | |     | | | | |     | | | | |   | | | | |       | | | |   |
+ +-+ + +-+ +-+-+ + +-+-+ + +-+ + + +-+ + +-+ + +-+-+ +-+ +-+ + +-+-+ + + + +-+ + + + + + +-+ + + + +
| |   |   | |     | |     |   | | |   | | |   | |       |   | |     | | | |   | | | | | |   | | | | |
+ + +-+-+ +-+-+ +-+ + + + +-+ + + + + +-+ + +-+ + +-+ +-+ + + + + + + + + + +-+-+ + +-+ + +-+ +-+ + +
| | |         |   | | | |   | | | | |   | | |   |   |   | | | | | | | | | | |     | |   |   |   | | |
+ + + +-+ + +-+ + + + + + + +-+ + + + + + + + + + + + +-+-+ +-+ + + + + +-+ + + + + +-+ + +-+ +-+ + +
| | | |   | |   | | | | | |   | | | | | | | | | | | | |       | | | | |   | | | | | |   |   |   | | |
+ + + + + + + + + +-+ + + + + + + + +-+ + + + + + + + + + + +-+ + + + + +-+ + + +-+ + + + +-+ +-+-+ +
| | | | | | | | |   | | | | | | | | |   | | | | | | | | | |   | | | | | |   | |   | | | | |       | |
+ + + + + + +-+ +-+ + + + + + + + + +-+ + + + + + + + + + +-+ +-+ +-+ +-+-+-+ + + +-+ + +-+ + + + + +
| | | | | | |     | | | | | | | | | |   | | | | | | | | | |     | |   |       | | |   | |   | | | | |
+-+ +-+-+ + + + + + +-+ + +-+-+ +-+ + +-+-+ +-+ +-+ + +-+ +-+-+-+ +-+-+ + + + + + + + +-+ +-+ + + + +
|   |     | | | | |   | | |       | |     |   |   | |   | |       |     | | | | | | |   | |   | | | |
+-+-+ +-+ +-+-+-+ + + + +-+ + + + + + + + + + + + + + + +-+ +-+-+ +-+ + + + + + + + + +-+ + + + +-+-+
|       |     |   | | |   | | | | | | | | | | | | | | | |       |   | | | | | | | | |   | | | |     |
+ + + +-+ +-+ +-+ +-+ + + +-+ + +-+-+ + + +-+-+ +-+ +-+-+ +-+-+ +-+ + + + + +-+-+-+ + + + + + +-+ + +
| | | |     | |     | | | |   |   |   | | |     |     |       | |   | | | |     |   | | | | | |   | |
+ + + +-+ +-+ +-+ +-+ +-+ +-+ +-+ + +-+-+-+ + +-+ +-+ + +-+ +-+ + + +-+-+ +-+ + +-+-+-+ +-+ +-+ + + +
| | |   | |     | |   |   |     | |     |   |   | |   | |     | | |   |     | | |         |   | | | |
+ + +-+ + +-+-+-+ + + + + +-+-+ + + + + +-+-+ + + + + +-+ + + +-+ +-+ + +-+-+ + +-+ + + + + +-+ + + +
| |   | |       | | | | |   |   | | | |   |   | | | |   | | |   | |   |   |   | |   | | | |   | | | |
+ +-+ +-+-+ + +-+-+-+ + + +-+ +-+-+-+-+-+ + + + + + + + + +-+ + + + + + + + +-+ +-+ + + + + +-+-+ +-+
|   | |     |       | | | |     |         | | | | | | | |   | | | | | | | |   | |   | | | |   |     |
+-+-+-+-+-+-+-+-+-+-+-+-+-+-+-+-+-+-+-+-+-+-+-+-+-+-+-+-+-+-+-+-+-+-+-+-+-+-+-+-+-+-+-+-+-+-+-+-+-+-+