+-+-+-+-+-+-+-+-+-+-+-+-+-+-+-+-+-+-+-+-+-+-+-+-+-+-+-+-+-+-+-+-+-+-+-+-+-+-+-+-+-+-+-+-+
|   |       |   |                 |       |           |           |       |   |         |
+-+ + +-+-+ +-+ + +-+-+-+-+ +-+-+ + +-+-+ + +-+ +-+-+ + + +-+-+-+ +-+ +-+ + + + +-+-+-+ +
|   |   |     |       |     |   | | |     | |   |     | | |     |   | |     | | |   |   |
+ +-+ + +-+-+ +-+-+-+ + +-+-+ + + + + +-+-+ + +-+ +-+-+ + +-+ + +-+ + +-+-+-+-+ + + + + +
| |   | |   |     |   |     | | | | |       | | |     | |   | |     |           | | | | |
+ +-+-+ + + +-+-+ +-+-+-+-+ + + + +-+ +-+-+-+ + +-+-+ +-+-+ + +-+-+-+ +-+-+-+-+-+ +-+ +-+
|     |   | |   |     |   |   | |   |   |     |     | |     | |     |     |         |   |
+-+-+ +-+-+ + + +-+-+ + + + +-+ +-+ +-+ + +-+-+ +-+ + + +-+-+ +-+-+ +-+-+ +-+ +-+-+ +-+ +
|   |   |   | | |     | | |   | | |   | | |   | | |   |     |     |     |   | |   |   | |
+ + +-+ + +-+ +-+ +-+-+ + +-+-+ + +-+ +-+ + +-+ + +-+-+ +-+ +-+-+ +-+-+ +-+ +-+ + + +-+ +
| |     | |       |     |       |   |     |     |     | |   |   |     |   |     |   |   |
+ +-+-+-+ + +-+-+-+-+ +-+-+-+-+-+ + +-+-+-+ +-+-+ +-+ + + +-+ + +-+-+ + +-+-+ +-+-+-+ +-+
|     |   |     |     |       |   | |     |   |     | | | |   |     | |       |     |   |
+-+-+ + +-+-+-+ + +-+-+ +-+-+-+ + + +-+-+ +-+ +-+ + + +-+ +-+-+-+-+ + + +-+-+-+ +-+ + + +
|   |   | |     |   |   |       | |         |   | | |     |       | | | |     | |   | | |
+ +-+-+-+ + +-+-+ + + +-+ +-+-+-+ +-+-+-+-+ +-+ + + +-+-+-+ +-+-+ + + + + +-+ + + +-+-+ +
| |     | | |   | | |     | |   |       |   |   | |   |     |   |   | | |   |   | |     |
+ + + + + + + + + + + +-+-+ + + +-+-+-+ +-+-+ +-+ +-+ + + +-+-+ + +-+ + +-+ +-+-+ +-+ + +
|   | |   |   | | | |   |     |   |   |   |   |     | | |     |   |   | |   |   |   | | |
+ +-+ +-+-+-+-+ + + +-+ +-+-+-+ +-+ + + + + +-+-+-+ + + +-+-+ +-+ + +-+-+ + + + +-+ + + +
|   |   |   |   | | | |         |   | | | |       | | | |   |   | | |     | | |   |   | |
+ +-+-+ + + + +-+-+ + +-+-+ +-+-+ +-+ + + +-+-+-+ +-+ + +-+ +-+ + + +-+ +-+-+ +-+ +-+-+ +
| |     | |   |     |   |   |     |   | |       |     |     |   | |   |       |   |   | |
+ + + +-+ +-+-+ +-+-+ + + +-+ +-+-+ +-+-+-+-+ + +-+-+-+-+-+ + +-+ +-+ +-+-+-+-+ +-+ +-+ +
| | | |   |     |     | | | |     |         | |       |     |   |   |   |   |   | |   | |
+ + +-+ +-+ +-+ +-+-+-+ + + +-+-+ +-+-+-+-+ + + +-+-+ + +-+-+-+ + +-+-+ + + + +-+ + + + +
| |   | | | |   |     |   |     | |       | | |   | | | |   |   | |   | | |   |     |   |
+ +-+ + + + + +-+ +-+ + +-+ +-+ + + +-+-+ + +-+-+ + + + + + + +-+-+ + + + +-+ +-+-+-+-+ +
|   |   | | |     |   |   | |   | | |   |   |   | |   | | |   |     |   |   | |       | |
+-+ +-+-+ + +-+-+-+ +-+-+ + +-+-+ + + + +-+-+ + + +-+-+ + + +-+ +-+-+-+-+ + +-+ +-+-+ + +
|   |   |     |     | |   | |     | | |       | |       | | |   |   |     |   | |   | | |
+ +-+ + +-+-+-+ +-+-+ + +-+ + +-+-+ +-+ +-+-+-+ +-+-+-+-+ + + +-+ + + +-+-+-+ + + + + + +
|     | |     |   |   | |   |     | |   |   |             | |   | |   |       | | | | | |
+-+-+-+ + +-+ +-+ + + + +-+ +-+-+ + + +-+ + +-+-+-+-+-+-+-+-+-+ + +-+-+ +-+-+-+ + + + +-+
|     |   | |     | |         |   | | |   |             |     | |   |   |         | |   |
+ + +-+-+-+ +-+-+-+ +-+-+-+-+-+ +-+ + + +-+-+-+-+-+-+-+ + +-+ + +-+ + + + +-+-+-+-+-+-+ +
| |     |       |   | |       | |   | |   |     | |     | | |   |   | | | | |           |
+ +-+-+ + +-+-+ + +-+ + +-+-+ + + +-+ +-+ + + + + + +-+-+ + +-+-+-+-+ +-+ + + +-+-+-+-+ +
|     |   |   | |     | |   |   | |       | | |   | |     |         |   | | | |       | |
+ +-+-+-+-+ + + + +-+-+ + +-+-+-+ +-+-+ +-+-+ +-+ + + +-+-+-+-+ +-+ + + + + + + +-+-+ + +
| |         | |   |     |       |     |       |   | |   |       |   | |   | | | |   | | |
+ + +-+-+-+-+ + +-+ +-+-+-+-+-+ +-+-+ + +-+-+-+-+-+ +-+ +-+ +-+-+ +-+ +-+-+ + + + + + +-+
| | |       | | |   |         |   |   | |   |         |     | |   | |       | |   | |   |
+ + +-+ + +-+ + + +-+-+ +-+-+ + + + +-+-+ + + +-+-+-+ +-+-+-+ + +-+ +-+-+-+ + +-+-+ +-+ +
| |   | | |   | |   |   |       | |       | |   |       |     | |         | |     | | | |
+ +-+ + + + +-+-+-+ + + +-+-+-+-+-+-+-+-+-+ +-+ +-+-+ +-+ + +-+ + +-+-+-+ + +-+ +-+ + + +
|   | | | | |     | | | |                 | |   |   | |   |     |     | | | | |       | |
+ +-+ + + + + +-+ + + +-+ +-+-+-+-+-+-+-+ + + +-+ + +-+ +-+-+-+-+-+-+ + + + + +-+-+-+ + +
| |   | | |   | |   | |   |           |   |   |   |   | |       |       |     |   |   | |
+ + +-+ + +-+-+ +-+-+ + +-+-+ +-+-+-+-+ +-+-+ + +-+-+ + +-+ +-+ + +-+-+-+-+-+-+ + +-+-+ +
| | | | |   |       | |     |       |   |     | |   | | |   |   | |             |     | |
+-+ + + + +-+ +-+ + + +-+-+ +-+ +-+ + +-+ +-+-+ + +-+ + + +-+-+-+ + +-+-+-+-+-+-+-+-+ + +
|   | | |     |   | |     |   |   | |   |     | |   |   |         | |       |   |     | |
+ +-+ + +-+-+-+ +-+ +-+ + +-+ +-+-+ +-+ +-+ +-+ +-+ +-+-+ +-+-+-+-+ + + +-+-+ + + +-+-+ +
| |   | |     | | |     |   | |     |   |   |   |   |   |   |   |   | | |     |   |     |
+ + + + +-+ + + + +-+-+-+-+ + + +-+-+ +-+ +-+ +-+ + + + +-+-+ + + +-+ +-+ +-+-+-+-+-+ + +
| | |       | | |   |       | | |   |     | |     |   |   |   |   |   |   |   |     | | |
+ +-+-+-+-+-+-+ +-+ + +-+-+-+ + + + +-+-+ + +-+-+-+-+-+-+ + +-+-+-+ + + +-+ +-+ + + + + +
|     |   |   |   | |   |       | |     | |   |           | |       |   |       | |   | |
+ +-+ + + + + +-+ + + +-+ +-+-+-+ +-+-+ + +-+ + +-+-+-+-+-+ +-+ +-+-+-+-+-+-+ +-+ +-+-+ +
|   |   |   | |   |   |   |       |   | | |   | | |       |   | |   |       | | | | |   |
+-+ +-+-+-+-+ + +-+-+ + +-+ +-+-+-+-+ + + + + + + + + +-+-+ + + + + + +-+-+ + + + + + +-+
| |   |       |     | |   |     |     | |   | | |   |       | |   | |     | | | | |     |
+ +-+ + +-+-+-+ +-+ +-+-+ +-+-+ + + +-+ +-+ +-+ + +-+-+-+-+-+ +-+-+ +-+-+ + + + + +-+-+-+
|     | |   |     | |   |     | | | |   | | |   | |         |   | |       | |   | |     |
+ +-+-+ + +-+ +-+-+ + + +-+-+ + + +-+ +-+ + + +-+ + +-+-+-+-+-+ + +-+-+-+-+ +-+ + + +-+ +
| |   | |       |   | |       |   |   |   | | |   | |     |   | |   |     | | | |   |   |
+ +-+ + +-+-+-+-+ +-+ +-+-+-+-+-+ + +-+-+ + + + +-+ + +-+ + + + + +-+ + +-+ + + +-+-+ + +
|     |   |     |     |   | |     |     | | | |   | | | |   | | |     | |   |   |     | |
+-+-+ +-+ + +-+ + +-+-+ + + + +-+-+-+-+ + + + +-+ + + + +-+-+ + + +-+-+ + +-+-+ + +-+-+ +
|   |   | | | | |   |   |   | |       | | | | | | | | |     |   |     | |     | |   | | |
+ + +-+ + + + + +-+ +-+ + +-+ +-+ +-+-+ + + + + + + + + +-+-+-+-+ +-+-+ +-+-+ +-+-+ + + +
| | |   | |   |   |     | |   |   |   | |   | | | | | |           |   |     |     | |   |
+ +-+ +-+ +-+ +-+ +-+ +-+-+ +-+ + + + + +-+-+ + + + + + +-+-+-+-+-+ + + +-+-+-+-+ + + +-+
|   |   |   | | |   | |     |   | | | |       | | | | |     |   |   |   |       |   |   |
+ + +-+ + +-+ + +-+ +-+ +-+-+ +-+-+ + +-+-+-+-+ + + + +-+-+ + +-+ +-+-+-+ +-+-+ +-+-+-+ +
| | |   |   | |   |     |   |     | |     |     |   |     | |   |   |   |     |   | |   |
+ + + +-+-+ + + + +-+-+-+ + +-+ + + +-+-+ + +-+ +-+ +-+-+ + +-+ +-+ + + +-+-+ + + + + +-+
| | |     |   | |         |   | | |   | |   |     |     | |     |   | |   |   | |   |   |
+-+ +-+-+ +-+-+-+ + +-+-+-+-+ + + +-+ + +-+-+ +-+-+-+-+ + +-+-+ + +-+ + + + +-+ +-+-+-+ +
|     | |       | | | |   |   | |   | |   | | |         |     | |     | | | | |     |   |
+ +-+ + +-+-+-+ + + + + + + +-+-+ +-+ + + + + + +-+-+-+-+-+ + + +-+-+-+ + + + +-+-+ + +-+
|   |     |     | | | | |   |   |       |   |   |   |     | | |   | |   | | |     | |   |
+ + +-+-+ + +-+-+ + + + +-+-+ + +-+ +-+-+-+-+-+ + + + +-+ +-+ +-+ + + +-+-+ + +-+-+ +-+ +
| | |   | | |   | | | | |     |   | |   |     | | |   | |     |   | |       |   |   |   |
+ + + + +-+ + + +-+ + + +-+-+ +-+ +-+ + + +-+ +-+ +-+-+ +-+-+-+ +-+ +-+-+-+-+-+ + +-+ +-+
| |   |       |     |         |       |   |       |                             |       |
+-+-+-+-+-+-+-+-+-+-+-+-+-+-+-+-+-+-+-+-+-+-+-+-+-+-+-+-+-+-+-+-+-+-+-+-+-+-+-+-+-+-+-+-+