+-+-+-+-+-+-+-+-+-+-+
| |               | |
+ + +-+-+ +-+ +-+ + +
| | |   |   | |   | |
+ +-+ + +-+-+ + +-+ +
| |   |   |   |     |
+ + +-+-+ + +-+-+-+ +
|   | |   | |   |   |
+-+-+ + +-+ + + + +-+
|     |     | |   | |
+ +-+ +-+-+-+ +-+-+ +
| | |     |   |     |
+ + +-+ +-+ +-+-+ + +
| |   |   |       | |
+ + +-+-+ +-+-+-+-+ +
| | |     |   |     |
+ + + +-+ +-+ + +-+-+
| | | |       |   | |
+ + + +-+-+-+-+-+ + +
|   |               |
+-+-+-+-+-+-+-+-+-+-+