+-+-+-+-+-+-+-+-+-+-+-+-+-+-+
|                           |
+ + + +-+ + + + +-+ + + + + +
| | | |   | | | |   | | | | |
+-+-+-+ + + + +-+-+ + + +-+ +
|       | | |     | | | |   |
+ + + + +-+ + + +-+-+ +-+-+ +
| | | |   | | | |         | |
+ + + +-+ +-+-+-+ +-+ + + + +
| | |   | |       |   | | | |
+ + + + + +-+-+-+ + + +-+-+ +
| | | | |       | | | |     |
+ +-+ + +-+ + +-+ +-+ +-+ + +
|   | |   | | |   |     | | |
+ + + + + + + + + +-+ + +-+ +
| | | | | | | | |   | |   | |
+ + + +-+ + + + + + +-+ + + +
| | | |   | | | | | |   | | |
+ + + + +-+-+-+ + +-+ + + +-+
| | | |   |     | |   | |   |
+-+ + + + +-+ + + + + + + + +
|   | | | |   | | | | | | | |
+ + + + + + +-+-+ + + +-+ + +
| | | | | | |     | | |   | |
+-+ +-+ +-+ +-+-+ + + +-+ +-+
|   |     |   |   | | |     |
+ +-+ + +-+-+ + + + + + + +-+
| |   |     | | | | | | |   |
+-+-+-+-+-+-+-+-+-+-+-+-+-+-+