+-+-+-+-+-+
|   |     |
+-+ + + +-+
| | | |   |
+ + +-+-+ +
| |     | |
+ +-+-+ + +
| |     | |
+ + +-+-+ +
|         |
+-+-+-+-+-+