+-+-+-+-+-+-+-+-+-+-+-+-+-+-+-+-+
|                               |
+ + + +-+ +-+-+-+-+ +-+-+ +-+ +-+
| | |   |         |     |   |   |
+ + +-+ + +-+ + + +-+ +-+ +-+ + +
| |   | |   | | |   |   |   | | |
+ + +-+-+ +-+ + + + + + + +-+ + +
| |     |   | | | | | | |   | | |
+ + + +-+-+-+-+ + + +-+-+ +-+-+ +
| | |         | | |     |     | |
+ + + + + + + + + +-+-+ +-+-+ +-+
| | | | | | | | |     |     |   |
+ +-+ +-+ +-+-+ + +-+-+-+ +-+-+ +
|   |   |     | |       |     | |
+ + +-+ + +-+-+-+-+ + +-+ +-+-+ +
| |   | |         | |   |     | |
+ +-+ +-+-+ +-+ + + +-+ + +-+-+ +
|   |     |   | | |   | |     | |
+ +-+-+-+ + + +-+ +-+-+ +-+ +-+-+
|       | | |   |     |   |     |
+ + + +-+-+ +-+-+-+-+ + +-+ +-+ +
| | |     |         | |   |   | |
+ + + +-+ +-+ +-+ + +-+ +-+ + +-+
| | |   |   |   | |   |   | |   |
+ + + + + + +-+-+ + + + + + +-+ +
| | | | | |     | | | | | |   | |
+ +-+ + +-+-+-+-+-+ +-+ + +-+ +-+
|   | |           |   | |   |   |
+ + +-+-+ +-+ + + +-+ + + + +-+-+
| |     |   | | |   | | | |     |
+ + +-+ + +-+ + +-+ + +-+ +-+ +-+
| |   | |   | |   | |   |   |   |
+-+-+-+-+-+-+-+-+-+-+-+-+-+-+-+-+