+-+-+-+-+-+-+-+-+-+-+-+-+-+-+-+-+-+-+-+-+-+-+-+-+-+-+
| |   |       |             |       |       |   |   |
+ + + +-+ +-+ +-+-+-+ +-+-+ + +-+-+ + +-+-+ + + +-+ +
|   |     | |       | |   |   |     | |   |   |     |
+-+-+-+-+-+ +-+-+-+ + +-+ +-+-+ +-+-+ + + +-+-+ +-+-+
|       |       |   | |     | | |     | | |     |   |
+ + +-+ +-+ +-+-+ +-+ + +-+ + + +-+-+ + + +-+-+-+ + +
| | | |   |     |   | | |     |   |   | |         | |
+ + + +-+ +-+-+ +-+ + + +-+-+-+-+ + +-+ +-+-+-+-+-+ +
| | |           |   | |         | |     |   |       |
+ + +-+-+ +-+-+-+ +-+ + +-+-+-+ + + +-+-+ + + +-+-+-+
| |     | |       |   |   |     | |       | | |     |
+ +-+-+ + + +-+-+-+-+ +-+ + +-+ + +-+-+-+-+ + + +-+ +
| |     | |           |   | |   | |   |   | | |   | |
+-+ +-+-+ +-+-+-+-+-+-+ +-+ + +-+ + + + + + + +-+ + +
|   |     |           |   | |   | | |   |   |     | |
+ +-+-+-+-+ +-+-+ +-+-+-+ + +-+ + +-+-+-+ +-+-+-+-+ +
|   |     | |   |       | |   | |       |         | |
+ + + +-+ + + +-+-+-+-+ + +-+ + +-+-+-+ +-+-+-+-+ + +
| |   |   | |       | |   |   |   |   |         | | |
+ +-+-+ + + +-+-+ + + +-+-+ +-+ +-+ + +-+-+-+-+ +-+ +
| | |   | | |   | |   |   |   | |   |       | |   | |
+ + + +-+-+ + + + +-+ + +-+-+ + + +-+-+ +-+ + +-+ + +
| | |       | |   |   | |     | | |   |   | | |   | |
+ + +-+-+-+-+ +-+-+-+ + + +-+-+-+ +-+ +-+ + + + +-+ +
| |     |     |     | | |             |   |   | |   |
+ + +-+ + + +-+ +-+ + + +-+-+-+-+-+-+-+ +-+-+-+ + + +
| |   |   | |   |   | | |       |   |   |     | | | |
+ +-+ +-+-+ + +-+ +-+ + + +-+ +-+ + + + + +-+ + + +-+
|   |     |   |   |   |     | |   |   | |   | | |   |
+-+ +-+-+ +-+-+ +-+ +-+-+-+-+ + + +-+-+-+-+ + + +-+ +
| | |   |   |   |           | | | |         | | |   |
+ + + +-+-+ + +-+-+-+-+-+-+ + + +-+ +-+-+-+-+ + + + +
|   |       |           |   | |   | |     |   | | | |
+ +-+-+-+-+ +-+-+-+-+-+ + +-+ +-+ + + +-+-+ +-+ + + +
| |       |   |         | | |   |   |     |     | | |
+ +-+ +-+ +-+-+ +-+-+-+-+ + + + +-+-+-+-+ +-+-+-+ +-+
|   | | |       |       | |   | |       |           |
+-+ + + +-+-+-+-+ +-+-+-+ + +-+ + +-+ + +-+-+ +-+-+ +
| | | |     |     |       |   |   |   |     | |   | |
+ + + +-+ + +-+-+ + +-+-+-+-+-+ +-+ +-+-+-+ + + +-+ +
| |   |   |       |       |   |   | |     | | |   | |
+ +-+-+ + +-+-+-+-+-+-+-+ + + +-+-+ +-+-+ + + +-+ + +
|   |   | |     |       |   |       |   | | |     | |
+ + + + + + +-+ + + +-+-+-+-+-+-+-+-+ + + + + +-+-+ +
| | | | | | | |   |         |       | |   | | |   | |
+ + + + +-+ + +-+-+-+-+-+ +-+ + +-+ + +-+-+ +-+ + + +
| | | |   | |           |   | |   |   |   |     |   |
+ +-+ +-+ + +-+-+ +-+-+ +-+ + +-+ +-+-+ + +-+-+-+-+ +
|   | | | | |   | | |   | |   | |   |   |   |     | |
+ + + + + + + + + + + +-+ +-+-+ +-+ + +-+-+ + + +-+ +
| |     |     |   |               |       |   |     |
+-+-+-+-+-+-+-+-+-+-+-+-+-+-+-+-+-+-+-+-+-+-+-+-+-+-+