+-+-+-+-+-+-+-+-+-+-+-+-+-+-+-+-+-+-+-+-+-+-+
|           |   |     |         |     |     |
+-+-+-+-+-+ + + + +-+ + +-+ +-+ + +-+ +-+ + +
|   | |   |   | |   |     | | |   | | |   | |
+ + + + + +-+-+ +-+-+-+-+ + + +-+-+ + + +-+ +
| | |   | |   |         | | |   |   | |   | |
+ + +-+ + + + +-+-+-+-+ +-+ + + + + + +-+ + +
| |   | | | |       |   |   | | | |   |   | |
+ +-+ + + + +-+-+-+ + +-+ +-+-+ + +-+-+ +-+-+
| |   | | |     | | | |   |     | |         |
+ +-+ + + +-+-+ + + + + +-+-+ +-+ + +-+-+-+ +
|   | | |         | |   |     |   |     |   |
+ + + +-+-+-+-+-+-+ +-+-+-+ + + +-+-+-+-+ + +
| | | |             |       | | |       | | |
+-+ + + +-+-+-+-+-+ + + +-+-+-+ + +-+-+ + +-+
|   |   |   |     | | | |   |   |   | | |   |
+ +-+-+-+ + + + +-+ + +-+ + + +-+-+ + + + + +
|     |   | | | |   | |   |   |     |   | | |
+-+-+ + +-+ +-+ + +-+ + +-+-+-+ +-+-+ +-+-+ +
|     |   |     |   | |   |     |     |     |
+ +-+-+-+ +-+-+ +-+ + +-+ + +-+-+ +-+-+ + + +
| |       |   | |     |   | | |   |   | | | |
+ + +-+-+ + + +-+ +-+-+ +-+ + + +-+ + + + +-+
| |     | | | |   |   | |   |   |   |   |   |
+ +-+-+ +-+ + + +-+ + + + + + +-+-+ +-+-+-+ +
|   |   |   |     | |   | | |     |       | |
+-+ + +-+ +-+-+-+-+ +-+-+ + +-+-+ +-+ +-+-+ +
|   |     |       | | |   |     |   | |   | |
+ + +-+-+-+ +-+-+ + + + +-+-+-+ +-+ +-+ + + +
| | |   |   |   |   |   | |   |   |     |   |
+ +-+ + + +-+-+ +-+-+ +-+ + + +-+ +-+-+-+-+ +
|     | |   |     | | |     |   |       |   |
+ +-+-+ +-+ + +-+ + + +-+ +-+-+ +-+-+-+ +-+-+
|     |     |   |   |   | |   |   |   |     |
+-+-+ +-+-+-+ + +-+ +-+ +-+ + + +-+ + +-+ + +
| |   |       |   | |   |   | | |   |   | | |
+ + +-+-+ +-+-+-+ + + +-+ +-+ + + +-+-+ + + +
| |     |   |   | | |     | | | | |   | | | |
+ +-+-+ +-+ + +-+ +-+-+-+-+ + + + + + + + + +
|     | |   |   |               | | |   | | |
+ + +-+ +-+ +-+ +-+-+-+-+-+-+-+-+ +-+-+ + + +
| |   |   |     |   |           |     | | | |
+ +-+ +-+ +-+-+-+ + + +-+-+-+-+ +-+-+ + +-+ +
|   |             |   |               |     |
+-+-+-+-+-+-+-+-+-+-+-+-+-+-+-+-+-+-+-+-+-+-+