+-+-+-+-+-+
| |       |
+ + +-+-+ +
|     |   |
+ +-+-+ +-+
| | | | | |
+ + + +-+ +
|     | | |
+ + +-+ + +
| |       |
+-+-+-+-+-+