+-+-+-+-+-+-+-+-+-+-+-+-+-+-+-+-+-+-+-+-+-+-+-+-+-+-+-+-+-+-+-+-+-+-+-+-+-+-+
|     |             |     |   |     |         |         |   |     |       | |
+-+-+ + +-+-+-+-+-+ +-+ + + + + +-+-+ +-+-+ +-+ +-+ +-+ + + + +-+ +-+ +-+ + +
|   |   | |         |   |   | | |   | |   |     |   |   | | |   |   | | | | |
+ +-+-+-+ + +-+-+-+-+ +-+-+-+ + + + + +-+ +-+-+ + +-+ +-+ + +-+ +-+ + + + + +
| |   |     | |           |     | | |   | |   | |   | |   |   |   | | |   | |
+ + + + +-+-+ + +-+-+-+-+ + +-+-+ + +-+ + + + +-+-+ + + +-+-+ + + + + + +-+ +
| | | |     |   |     |   | |   | |       | |       |   |   | | | |   | |   |
+ + + +-+-+ + +-+ +-+ + +-+-+ + + +-+-+-+-+ +-+-+-+-+-+-+ + + +-+ +-+-+ +-+ +
|   |       |   | |   |       |   |     |   |     |   |   | |   |     |     |
+ +-+-+-+-+-+-+ + +-+ + +-+-+-+-+-+ +-+ + +-+-+-+ + + + + + +-+ +-+-+ +-+-+ +
| |           | |   | |   |         | | | |     | | |   | | |   |   |     | |
+ + +-+-+-+-+ + +-+ + +-+ + +-+-+-+-+ + + + +-+ + + +-+-+ +-+ +-+ + +-+-+ + +
|   |     |   | |   |   | | |   |     | | | |     |     |   |   | |       | |
+-+-+ +-+-+ +-+ + +-+-+ +-+ + +-+ +-+ + + + + +-+-+-+-+ +-+ +-+ + +-+-+-+-+ +
|         | |   |     |     |     |   |   | | |       | | |     |   |     | |
+-+-+-+-+ + + +-+-+-+ +-+-+-+ +-+-+ +-+-+-+ +-+ + +-+-+ + +-+-+-+ + + +-+-+ +
|         | | |       |   | |   | |             |     | | |     | | |   |   |
+ + +-+-+ + +-+ +-+-+-+ + + +-+ + +-+-+-+-+-+-+-+-+-+ + + + + +-+ + +-+ + +-+
| | |   | |   | |       | |   |     |     |   |     | | |   |     | |   |   |
+ +-+ + + +-+ + + +-+-+-+ + +-+-+-+ +-+ + + + + + + + + + +-+-+-+-+ + +-+-+ +
| |   | |   | | |   |   | |         |   | | |   | | | | |   |       |       |
+ + +-+ +-+-+ + +-+ + + + +-+-+-+-+ + +-+ +-+-+-+ + + + +-+-+ +-+-+-+ +-+-+-+
| |   |     | |       | |         | | | | |       | | |     | |     |   |   |
+ +-+ +-+-+ + + +-+-+-+ +-+-+-+-+ + + + + + +-+-+-+-+ +-+-+ + +-+ + +-+ +-+ +
|   |     | | |   |   |   |       | | |     |     |     |   |   | |   |     |
+-+ +-+-+ + + +-+-+ + +-+-+ +-+-+-+ + +-+-+-+ +-+ + +-+-+ +-+ + +-+ + +-+-+ +
|   |     | |       |       |     | | |   |   |   |   |   |   | |   |     | |
+ +-+ +-+-+ +-+-+-+-+-+-+-+-+ +-+ + + + + + +-+-+ +-+ + +-+ +-+ + +-+-+-+-+ +
|   |     |             |     | | | | | |   |   |     | |   |   |     |     |
+ + +-+ +-+-+ +-+-+-+-+ + +-+-+ + + + + +-+-+ + +-+-+ + + +-+ +-+ +-+ + +-+-+
| |     |     |       | |       | |   |       |   |   | | | |   | |   |   | |
+ +-+-+-+ +-+-+ + +-+-+ +-+-+-+ + + +-+-+-+-+-+-+ + +-+ + + +-+ +-+ +-+-+ + +
|       | |   | |   |   |     | |   |           | | |   | |   |   |     | | |
+-+-+-+ + + + +-+-+ + +-+ +-+ + +-+-+ +-+-+-+-+ + +-+ +-+ + +-+-+ + + +-+ + +
|   |   |   | |     | | | | |   | |   |       |   |   |     |     | |     | |
+ + +-+-+-+ + + +-+-+ + + + +-+-+ + +-+ +-+-+ +-+-+ +-+-+-+-+ +-+-+ +-+-+-+ +
| |       | | |       | |         |   | |   |       |       |     |   |     |
+ +-+-+-+ +-+ +-+ +-+-+ +-+-+-+-+ +-+ + + +-+-+-+-+-+ + +-+ +-+-+ +-+ + +-+ +
| |     |   |   |       |       | | |   |     | |     | | |       |   | |   |
+ + +-+ +-+ +-+ +-+-+-+ + +-+ +-+ + +-+-+-+ + + + +-+-+ + +-+-+-+-+ +-+ +-+-+
| |   |   |   | |     | |   | |   |       | | |   |     |         | |       |
+ +-+-+ +-+-+ + +-+-+ + +-+ + + +-+-+-+ + + + + +-+ +-+-+ +-+-+-+-+ + +-+-+ +
|     | |   |   |     | |   | |         |   | |   |   |   |       | |   |   |
+ +-+ + + + +-+-+ +-+ + +-+-+ +-+-+-+-+-+-+-+ +-+ +-+ + +-+ +-+-+ + +-+ + + +
|   | |   |       | | |     |       |         |   |   |   |     | | | | | | |
+ +-+ +-+-+ + +-+-+ + +-+-+ +-+-+-+ + +-+-+-+-+ +-+ +-+ + +-+-+ + + + + + + +
| |   |   | | |   |   |     |       |   |     | |   |   |     | |   |   | | |
+ + +-+ + + + + + +-+ + +-+-+ +-+ +-+-+ +-+ + +-+ +-+ +-+ +-+ + +-+-+ +-+ +-+
| | |   | | |   |   | |   |   |   |   |     |     | |   |   | | |     | |   |
+-+ + +-+ +-+-+-+-+ +-+-+ +-+ + +-+ + +-+-+-+-+-+-+ +-+ +-+ +-+ +-+ +-+ +-+ +
|   | |   |     |   |         | |   | |         |     | | |   |   |     |   |
+ +-+ + +-+ +-+ + +-+ +-+-+-+-+-+ +-+ + +-+-+ + +-+-+ + + +-+ +-+ +-+-+ + +-+
| |   |     |   |   | | |           | |   |   |       |     |   |     | |   |
+ + +-+-+-+-+ +-+-+ + + + +-+-+-+-+-+ +-+ + +-+-+-+-+ +-+-+ +-+ +-+-+ +-+-+ +
|   |     |   |   |   | | |       |   |   |   |     |   | | | |   |   |     |
+ +-+ + +-+ +-+ + +-+ + + +-+-+ +-+ + + +-+-+ + + +-+-+ + + + + +-+ +-+ +-+ +
|   | |   |   | |   |   | |   | |   | | | |   | |     |   |   | |   |     | |
+-+ + +-+ +-+ + +-+ +-+-+ + + + + +-+ + + + +-+-+-+ + + +-+-+ + + +-+-+-+ + +
| | | | |   |   |   |   | | |   |   | |   |       | |   |     |   |     | | |
+ + + + +-+ +-+-+ +-+ + + + +-+ +-+ +-+ +-+-+-+ + + +-+-+ +-+-+-+-+ +-+ + + +
|   | |   |     |     | | |   |   |     |     | | | |   | |         | |   | |
+ +-+ + + +-+ + +-+-+-+ + +-+ +-+ +-+-+-+ +-+ +-+ + +-+ + +-+ +-+-+-+ +-+-+ +
|   |   |   | |   |   | | |   | |       |   |   | |   | |     | |       | | |
+-+ +-+-+ +-+ +-+-+ + + + + +-+ +-+ +-+-+-+ +-+ + +-+ + +-+-+-+ + +-+ + + + +
| | |     |   |     | | | | |       |     |   |   |     |     |   | | | | | |
+ + +-+-+-+ +-+ +-+-+ + + + + +-+-+-+ +-+ +-+ + +-+-+-+-+ + + + +-+ + + + + +
| | |   |   |   |       |   |     |   |       | |         | | | |   | |   | |
+ + + + + +-+ +-+-+-+-+ +-+-+-+ +-+ + +-+-+-+ +-+ +-+-+-+-+ +-+ + +-+ + +-+ +
| | | | | |   |     |   |     | |   | |     | |   |   |     |   |   | | |   |
+ + + + + + +-+ +-+ +-+-+ +-+ + + + +-+ +-+ +-+ +-+ + + +-+-+ +-+-+ + + + +-+
| | | |   | |   | |     | | |   | | |   | |   | |   | |   |   |     | | | | |
+ + + +-+ + + +-+ +-+-+ + + +-+-+ +-+ +-+ +-+ + +-+-+ +-+ + +-+ + +-+ + + + +
| | |   | | | |       | | |     |   | |     |   |     | | |   | | |   | | | |
+ + +-+ + + + +-+-+-+ + + + +-+ +-+ + +-+ + +-+-+ +-+ + + +-+ +-+ + +-+-+ + +
|       | |           |     |     |       |       |     |         |         |
+-+-+-+-+-+-+-+-+-+-+-+-+-+-+-+-+-+-+-+-+-+-+-+-+-+-+-+-+-+-+-+-+-+-+-+-+-+-+