+-+-+-+-+-+-+-+-+-+-+-+-+-+-+-+-+-+-+-+-+-+-+-+-+-+-+-+-+-+-+-+-+-+-+-+-+-+-+-+
|       |   |     |       | |     |       |   |               | | |   | | |   |
+-+-+ +-+ + +-+ + + + +-+-+ +-+ +-+-+ + +-+-+ +-+ + + +-+-+ +-+ + +-+ + + + + +
|   |   | | |   |   | |     | |   |   |       |   | | |     |   |   |   |   | |
+ + + +-+ +-+-+-+-+ + +-+-+ + +-+ +-+-+-+ +-+-+-+-+-+-+-+-+ + +-+ + +-+ +-+-+ +
| |     |           |             | |   | |     | |     |   |   | |       | | |
+-+ + + +-+-+-+-+-+-+-+ +-+-+-+-+-+ + + + +-+ +-+ + +-+ +-+ + +-+-+ +-+-+-+ + +
|   | | |     |   |       |   |   |   | |     |     |         | |       |   | |
+-+-+ + + +-+-+-+ +-+ +-+-+ +-+ +-+-+-+ + + + +-+-+ +-+ + +-+ + +-+ +-+ +-+ + +
|   | |       |     | | |   | |   |     | | |   |     | | | | | |     | |   | |
+-+ +-+-+ +-+-+-+-+ + + +-+ + +-+ +-+-+ +-+-+ +-+-+ +-+ +-+ + + + +-+ +-+ + + +
| | | |   | |             |     |   |           | | |   | |   |     |   | | | |
+ + + + + + + +-+ + + +-+-+ + +-+-+ + + +-+-+-+ + +-+-+-+ + +-+-+ +-+ +-+ + + +
|   | | |   |   | | |   |   | |       | | | |     | |             | | |   |   |
+-+ + + +-+-+-+ +-+-+ + + +-+-+-+ + +-+ + + +-+ +-+ + +-+ + +-+-+ + +-+-+ +-+-+
|       | |       | | |   |   | | | |   |   | | |     |   | |             |   |
+ +-+ +-+ + +-+-+ + + + + +-+ + +-+ +-+-+-+ + +-+-+-+-+-+-+-+ +-+-+-+ + +-+ +-+
| |       |   |   |   | |       | | | |       | |         |       |   |       |
+-+-+-+ + + + + +-+-+-+ +-+-+-+ + + + + + +-+-+ +-+-+ +-+ + + + +-+-+-+ +-+ +-+
| | |   |   | | |   | |   |         | | |         |     |   | |       |   |   |
+ + +-+-+ +-+ + + + + + +-+ +-+-+-+-+ + +-+-+ +-+-+ +-+-+-+ +-+-+ +-+-+-+-+-+ +
|       | | | | | |   | |     |         |       |     | | |   |     | |     | |
+ + + +-+-+ +-+-+ +-+-+-+ +-+-+ + +-+ + +-+-+ +-+ + +-+ + + +-+-+-+ + + + +-+ +
| | |   |     |   |   |   |     | |   |   |   | | |   |   | |   |     | |   | |
+ + +-+-+ +-+-+-+ +-+ +-+ +-+ +-+-+ +-+-+-+ + + +-+ +-+ +-+ + +-+-+-+ +-+ + + +
| | | |       |           | | |           | |     |     |       |   | |   |   |
+-+ + + +-+ +-+ + +-+-+-+-+ + +-+ +-+-+-+ +-+-+-+-+-+-+-+ +-+ +-+ +-+-+ +-+ +-+
|       | |   | | |       |   |   | |     |     |     | |   |       | | | | | |
+-+-+ + + +-+ + +-+-+ + +-+ +-+-+ + +-+ +-+-+ + +-+ +-+ + +-+ + +-+ + +-+ + + +
|   | |   | |         |   |   |     |       | |         |   | |   | |     |   |
+-+ + +-+-+ +-+-+-+ +-+-+ +-+-+ + +-+-+-+ +-+ +-+-+ + +-+-+-+ +-+-+ + + + +-+ +
| |   |     |   |     | | |   | | |   |       | |   | |       |   | | | |     |
+ +-+ +-+-+ + +-+-+-+ + +-+-+ + +-+-+ + +-+ +-+ + +-+-+-+-+-+-+ +-+-+ + + +-+ +
|   |   |         |   |     |   | | |     | | |   | | | |     |   |   | | |   |
+-+ + +-+-+-+-+-+ + +-+-+-+ +-+-+ + + + +-+ + +-+ + + + +-+ +-+-+ + + +-+-+-+-+
|       |     |       | |       |   | | | | | | | |               | | | |   | |
+-+-+ +-+ +-+ +-+ +-+ + +-+ + + + +-+-+ + + + + + + + +-+-+-+-+ +-+ +-+ + +-+ +
|           |   | |       | | | | | |     | |   | | |   |   |       | |   |   |
+-+ + +-+-+ + +-+-+ +-+ +-+ +-+-+ + +-+-+ +-+ + +-+-+-+-+ +-+ +-+-+-+ + +-+ +-+
|   | | | | |   |   | |   |   | | | | |       | | |   |   | |       |   |   | |
+-+-+-+ + +-+ +-+ +-+ +-+-+ + + + + + + +-+ +-+ + + +-+ +-+ +-+ +-+-+-+ +-+ + +
|   |   |   |   | |     | | |         | | |   | | |         |   |   |     |   |
+-+ + +-+ +-+ +-+-+-+ + + + + +-+-+ +-+ + +-+-+-+ +-+-+ + +-+-+ +-+ +-+ +-+-+ +
| |         |     |   |     | |   | | | | |             |     | |   | | | |   |
+ +-+ + +-+-+ + + + +-+-+-+ + + + +-+ + + + +-+ +-+-+-+-+-+-+-+ + + + + + + +-+
|     |       | |       | | |   |         |   |     | |   |       |         | |
+ + +-+-+ +-+ +-+ +-+-+-+ +-+ + +-+ + + +-+ +-+ + +-+ + + +-+ + + +-+ +-+ +-+ +
| | |   |   | | | |       | | |   | | | |     | |   | | | |   | | |   |     | |
+ +-+ +-+ +-+ + + + +-+-+-+ + +-+ + +-+-+-+ +-+-+-+ + + + +-+ +-+ +-+-+-+ +-+ +
| |   |   |   |   |     | |     | | |     | |   |       | |   |         |     |
+ +-+ + +-+-+-+ +-+ +-+ + + +-+-+-+-+-+ + +-+ + +-+ + + +-+ + + +-+ + +-+-+-+-+
| |       |   |     | | |     |     |   | |   |     | |     | | |   |   | |   |
+ +-+-+-+-+-+ +-+-+ + +-+ +-+ + +-+-+-+ + +-+ + + +-+-+-+-+ + +-+-+-+-+ + + + +
| |       |           | | |       |     | |   | |   |       | |     |     | | |
+-+ +-+ +-+-+ +-+ +-+-+ +-+ +-+-+ + + + +-+ +-+ +-+-+-+-+ +-+-+-+-+ + +-+ +-+ +
|   |   |   | | |         | | | |   | |     | |     |   | | |           |   | |
+ +-+-+ +-+ + + +-+-+ + + +-+ + + +-+-+ +-+ + +-+-+ + + +-+ +-+ + +-+-+-+ +-+ +
| | |   | | | |       | | |   |   | |     | |   | |   |     |   |   |   | |   |
+ + + +-+ + +-+ +-+-+ + +-+-+ +-+ + + + + + + + + +-+-+-+-+-+-+ +-+ +-+ + + +-+
| | |   |       |   | |     | |   |   | | | | |     |         |   |     |   | |
+ + +-+ +-+-+ +-+-+ +-+-+ +-+ + +-+-+ + + +-+-+ + +-+ + + +-+ +-+ + + +-+-+ + +
|   |   |   |     |   |   | |   |     | |   |   | | | | | |     | | |     |   |
+-+-+ +-+ +-+-+-+ +-+ + +-+ +-+-+ +-+ +-+-+-+-+ + + + + +-+-+ + +-+ + +-+-+-+-+
|     |   |   |   | |     |       |       |   | |   | |   | | | |   | | | | | |
+-+-+ +-+ + +-+-+ + +-+-+-+-+-+-+ +-+-+ +-+ + + + +-+-+ + + +-+-+-+-+-+ + + + +
| |   |               | | | |   | |     |   |   |     | |     | |   | | |     |
+ + + + +-+-+-+-+ +-+-+ + + +-+ + + + + +-+-+ +-+-+-+ + + + + + + +-+ + +-+ + +
|   |         |     |       | |   | | |   |         | | | | | |             | |
+ +-+-+-+-+ + +-+-+ +-+-+-+ + + +-+-+-+-+-+ +-+ + +-+-+-+-+ + + +-+-+-+-+-+ +-+
|     |   | | |           |     |           |   | |   |   | |   |       |   | |
+ + +-+ + +-+-+-+-+ +-+-+ + +-+-+ +-+-+-+ +-+ +-+ +-+ +-+ + + + +-+ +-+ + + + +
| | |   | | | |   | |     |   |         | |   |     |     | | | | | | | | |   |
+-+ + +-+-+ + + + + + +-+-+-+-+-+-+ +-+ +-+-+ + +-+-+ + +-+-+-+ + + + + + + +-+
|       |   |   |   |           |   |     |   |     | |       |   | | | | |   |
+-+-+ +-+ +-+-+ +-+ + +-+-+ + +-+ + +-+-+-+-+ + + + +-+-+ +-+ +-+ + + +-+ +-+-+
|           |   |   | |     | |   | |     |   | | |         | |     | |       |
+-+-+ + + +-+-+ +-+-+ + +-+-+ + +-+ +-+-+ + + +-+ +-+ +-+ +-+-+-+-+ + +-+ + + +
|     | |     |   |   |     |   |       |   |   | |   |                 | | | |
+-+-+-+-+-+-+-+-+-+-+-+-+-+-+-+-+-+-+-+-+-+-+-+-+-+-+-+-+-+-+-+-+-+-+-+-+-+-+-+