+-+-+-+-+-+-+-+-+-+-+-+-+-+-+-+-+-+-+
|           |       |     |   |   | |
+ +-+-+ +-+-+-+-+-+ + +-+-+ + +-+ + +
|     | |           | |   | | |     |
+-+-+-+ +-+ +-+-+-+ + + +-+ +-+ + +-+
|   |             |   |     |   | | |
+-+ +-+-+-+-+-+-+-+ + +-+-+ +-+ + + +
| |   |   | |       |       |   |   |
+ +-+ +-+ + + + +-+-+ +-+ +-+ + +-+-+
| |         | | | |   |   | | | |   |
+ + + +-+-+-+-+-+ +-+-+ +-+ + + +-+ +
| | | |     | | |   |         | |   |
+ + +-+ +-+-+ + +-+ +-+-+ +-+-+ +-+ +
|           | |   |   |   |   |   | |
+ + + +-+-+ + +-+ +-+ +-+ +-+ + + + +
| | | | |       |   |       | | |   |
+-+ +-+ + +-+-+ + + +-+ +-+-+ +-+-+-+
| |   | | |   | | |                 |
+ +-+-+ + +-+ + + + + +-+ + + + +-+ +
|         |   | | | |   | | | |   | |
+ +-+-+ +-+ +-+ +-+-+-+ + +-+-+ + + +
| | |       |       |   | |   | | | |
+ + +-+-+-+-+ +-+-+-+ + +-+-+ +-+ +-+
|   | |     |         |   |     | | |
+-+-+ +-+ +-+-+ +-+-+ +-+ + +-+ + + +
|     | | | |     |   |     |   |   |
+ +-+ + + + + + +-+ + +-+ +-+ + +-+-+
|   | |       | |   |   |   | |   | |
+-+ + + +-+-+ +-+ +-+-+-+-+-+-+ +-+ +
|   |     | | |     | |   | |     | |
+-+-+-+-+ + + + + +-+ +-+ + +-+ +-+ +
|         |   | | | |   |         | |
+-+-+-+ + +-+-+ +-+ + +-+ + +-+-+ + +
|       |     |   |       |     |   |
+-+ + +-+-+ + + +-+-+ +-+ +-+-+ +-+-+
|   | |     | |   |     | |         |
+-+-+-+-+-+-+-+-+-+-+-+-+-+-+-+-+-+-+