+-+-+-+-+-+-+-+-+-+-+-+-+-+-+-+-+-+
|                                 |
+ + + + + +-+-+-+-+-+-+-+ +-+-+ +-+
| | | | |               |     |   |
+ + + + + + +-+-+-+ + + + + +-+-+ +
| | | | | |       | | | | |     | |
+ +-+-+-+ + + +-+-+ +-+-+-+ + +-+-+
|       | | |     |       | |     |
+ +-+-+ +-+ +-+ +-+-+ +-+-+-+-+ + +
|     |   |   |     |         | | |
+ + + + + + +-+ +-+-+ + +-+ + + + +
| | | | | |   |     | |   | | | | |
+ + +-+ +-+-+ +-+-+ +-+ + + + + +-+
| |   |     |     |   | | | | |   |
+ + +-+ + +-+-+ +-+ + + +-+-+ +-+ +
| |   | |     |   | | |     |   | |
+ + +-+ + + + +-+-+ + + +-+-+ + + +
| |   | | | |     | | |     | | | |
+ +-+ + +-+-+ + +-+ +-+-+-+-+ +-+-+
|   | |     | |   |         |     |
+ +-+ + + + +-+-+ + +-+-+-+-+-+ + +
|   | | | |     | |           | | |
+ + + +-+-+ +-+ +-+-+-+ + + +-+ +-+
| | |     |   |       | | |   |   |
+ + + + +-+-+-+-+-+ +-+ +-+-+ + + +
| | | |           |   |     | | | |
+ +-+ +-+ + +-+ + + +-+ +-+-+ +-+-+
|   |   | |   | | |   |     |     |
+ +-+-+-+-+-+ + +-+-+ + +-+-+ + +-+
|           | |     | |     | |   |
+ +-+-+-+ +-+-+ + + + + + + +-+-+ +
|       |     | | | | | | |     | |
+ +-+-+-+-+-+ +-+-+-+ +-+ + +-+-+ +
|           |       |   | |     | |
+-+-+-+-+-+-+-+-+-+-+-+-+-+-+-+-+-+