+-+-+-+-+-+-+-+-+-+-+-+-+-+-+-+-+-+-+-+-+-+-+-+-+-+-+-+-+-+-+-+-+-+-+-+-+-+-+-+-+-+-+-+-+-+-+-+-+-+-+
| |   |             |           |         |             |       |           |                   |   |
+ + + +-+-+ +-+-+-+ + +-+ +-+-+ +-+-+ + + + +-+-+-+-+-+ +-+ +-+-+ +-+-+-+ + +-+-+ +-+-+-+-+-+-+ +-+ +
|   |       | |     |   |     |     | | |   |     | |   |   |   | |       |     |     |     | |     |
+-+-+-+-+-+-+ + +-+-+-+ +-+-+ +-+-+ +-+ +-+-+ +-+ + + +-+ +-+ + + + +-+-+-+-+-+ +-+-+ + +-+ + +-+-+ +
|   |         | |     |     | |   |   |         | | |   |     |   | |     |   |       | | |       | |
+ + + +-+-+-+ + + +-+ +-+-+ + + +-+-+ + +-+-+-+-+ + +-+ + +-+-+-+-+ + + + +-+ +-+-+-+-+ + + +-+-+-+ +
| |   |   |   | | | |     | | |   |   | |   |     |   | |       |   | | |       |       |   |   |   |
+ +-+-+ +-+ +-+ + + + +-+-+ + +-+ + +-+-+ + + +-+-+ + + +-+ +-+-+ +-+ + +-+-+-+-+ + +-+-+-+-+ + + +-+
| |         |   |   |       | |   |     | | | | |   |   |   |     | | |     |     |         | | | | |
+ +-+-+-+-+ + +-+-+-+ +-+-+-+ + + +-+-+ + + + + + +-+-+-+ +-+ +-+-+ + +-+-+ + +-+-+-+-+-+-+ + + + + +
|         | |       | |       | | |     | |   | | |       | |   |   | |   |   |   |       |   |   | |
+ +-+-+-+ +-+-+-+-+ +-+ +-+-+-+ + + +-+-+ +-+-+ + + +-+-+ + +-+ + +-+ + +-+-+ + + + +-+ +-+-+-+-+-+ +
|     | |         |   | |       | |   |   | |     | |   |   |   |       |   |   | |   |             |
+-+-+ + +-+ + +-+-+-+ + +-+ +-+ +-+-+ + + + + +-+-+ + + +-+ + +-+-+-+-+ + + +-+-+ + +-+-+ + +-+-+-+-+
|         | | |     | |   | | |       | | | |     | | |   | |   |     | | |   | | | |   | | |       |
+ +-+-+-+-+ + + +-+ + +-+ + + +-+-+-+-+-+ + +-+-+ +-+ +-+ +-+-+ + +-+ +-+ +-+ + + +-+ + + +-+ +-+-+ +
|   |       | |   |   |   |     |         |     |     |   |     |   |     |   | |     |   |   | |   |
+-+ + +-+-+-+ +-+ +-+-+ +-+-+-+ +-+-+ +-+-+-+-+ +-+-+-+ +-+ +-+-+-+ +-+-+-+ +-+ +-+-+-+-+ + +-+ + + +
|   |     |     | |   |   |   |     | |           |   | |   |         |   | |             |     | | |
+ +-+-+-+ + +-+-+ +-+ + + + +-+-+-+ + + +-+ +-+-+ + + + +-+ + +-+-+ +-+ + + +-+-+-+ +-+-+-+-+-+ + +-+
| |       |   |   |   | | | |   |     |   |     | | | | |   | |   | |   | |       |       |   | |   |
+ + +-+-+-+-+-+ +-+ +-+ + + + + + +-+-+-+-+-+-+ +-+ + + + + + + + +-+ +-+ +-+-+-+ +-+ +-+-+ + + +-+ +
| |       |     |       | |   |   |       |   |     | |   | | | |   | |           |   |     |     | |
+ +-+-+-+ + +-+-+ +-+-+-+ +-+-+ +-+ +-+-+ + + + +-+-+ +-+-+ + + +-+ + +-+-+-+-+-+-+ +-+ +-+-+-+-+-+ +
| |   |   | | |     |   |     | |   | |   | | |     |   |   | | |     |     |   |   |       |     | |
+ + +-+ +-+ + + +-+-+ + + +-+ +-+ +-+ + + + + +-+ +-+ + + +-+ + +-+-+ + +-+ + + +-+-+ +-+-+-+ +-+ + +
|   |   |   |   |     | |   | |   |   | | | |   | |   | | | | |   |   | | | | |       |       | |   |
+-+ + +-+ +-+-+-+ +-+-+ +-+-+ + +-+ +-+ + + +-+ +-+ +-+ + + + +-+ + +-+ + + + +-+-+-+-+ +-+-+-+ +-+ +
| | |     |     |     | |   |       |   | | | |   |   | | | | | | | |   | | | | |       | |   |     |
+ + +-+-+-+ +-+ +-+-+ + + + +-+-+-+-+ + +-+ + +-+ +-+ +-+ + + + + +-+ +-+ + + + + +-+-+-+ + + + +-+-+
| | |     |   |   |   |   |   |     | | |   |   |   |       |   |   |     | |   | |         |   |   |
+ + + +-+ + + +-+ + +-+-+-+-+ + +-+ + + + +-+ +-+-+ +-+-+-+-+ +-+-+ +-+-+ + +-+ + +-+-+ +-+-+-+-+ + +
|   | |   | | | | | |   |   |   |   | | | |       |         | |         | |   | |     |           | |
+ +-+ + +-+ + + + + + + +-+ +-+-+ +-+ +-+ + +-+-+ +-+-+-+-+ + + +-+-+ +-+ +-+ + +-+-+ +-+-+ +-+-+-+-+
| | | |     | |   |   |   | |   |   | |   |     |         |   |   | | |   |   |     |     | |       |
+ + + +-+-+-+ + +-+ +-+-+ + + + +-+ + + +-+-+-+ +-+-+ +-+-+-+-+-+ + + + +-+ +-+ +-+-+-+-+ + + +-+-+ +
| |     |     | |       | |   |   | | |   |     |     |         | |   |   |     |       | | | | |   |
+ + +-+-+ +-+-+ +-+-+-+-+ + +-+ +-+ + +-+ + +-+-+ +-+ + + +-+ +-+ + +-+-+ +-+-+-+ +-+-+ + +-+ + + +-+
| | |   |   | |   |     | |   |         | | |     |   | |   | |   |     | | |     |     |       |   |
+ + + + +-+ + +-+ + +-+ + + +-+-+-+-+ +-+ +-+ +-+-+-+-+ +-+ + + +-+-+ +-+ + + +-+-+ +-+-+-+-+-+-+-+ +
| | | |     |   | | | | | | |   |   | |   |   |     |     | | | |   | |   | | |           |       | |
+ +-+ +-+-+-+-+ + + + + + +-+ + + + +-+ +-+ +-+ +-+ + +-+-+ + + + + +-+ +-+ + + +-+-+-+-+ + +-+-+ + +
| |   |         |   |   |     |   |     |     |   | |   |   | |   |   | |   | |   |   |   |     |   |
+ + + +-+-+ +-+-+-+-+ +-+ +-+-+-+ +-+-+-+-+-+ +-+ + +-+ + +-+-+-+-+-+ + + + + +-+-+ + + +-+-+ + +-+ +
| | | |   |   |   |   |     |   | |         |   | |     |     |     |   | | |       | |     | | |   |
+ + +-+ + +-+ + + + +-+ +-+-+ + + + +-+-+-+ + +-+ +-+-+-+-+-+ + + +-+-+-+-+ +-+-+-+-+ +-+-+ + + + +-+
| |     |   |   |     |   |   | | |   | |   |     |         |   |           |         |   | | | |   |
+ +-+ +-+-+ +-+-+-+-+ + +-+ +-+ + +-+ + + +-+-+-+ + +-+-+-+ + +-+-+-+-+-+ + + +-+-+-+-+ + + +-+ +-+ +
|   | |   |         | | |   | | |     | |       | | |     | |   |     |   | | | |       | |     |   |
+-+ + +-+ +-+-+-+-+ + +-+ +-+ + +-+-+-+ +-+-+-+ +-+ + +-+ + +-+-+ +-+ + +-+-+ + + +-+-+-+ +-+-+-+ +-+
|   |           |   | |   |   | |         |         |   | |       | |   |   | | | |       |   |   | |
+ +-+-+ +-+-+-+-+ +-+ + +-+ + + +-+-+ + +-+ +-+-+-+-+-+ + +-+-+-+-+ + +-+ + + + + + + +-+-+ + + +-+ +
| |     |         | |   |   | |     | |     |       |   |         |   |   |   |   | | |   | |   |   |
+ +-+-+-+ +-+-+-+-+ +-+-+ + +-+-+-+ + +-+-+-+ +-+-+ +-+-+-+-+ +-+ + +-+ +-+-+-+-+-+ + + + + +-+-+-+ +
|         |       |   |   | |     | | |     | |   |         |   |   |   |         | | | | |         |
+-+-+-+-+-+-+ +-+-+ + + + +-+ + + + + +-+ +-+ + + +-+-+-+-+ +-+-+-+-+ +-+ + +-+-+ + + + + +-+-+-+-+ +
|           |       |   |     | | | |     |   | | |   |   |   |     |   | |     |   | | |   |       |
+ +-+-+-+ + +-+-+-+-+-+-+-+-+-+ + + +-+-+-+ +-+ + + + +-+ +-+ + +-+ +-+ +-+-+ + + +-+-+ + +-+ +-+-+-+
|     |   |                     | |       | |   |   |   | |   | | |     |   | | | |     |     |     |
+-+-+ + +-+-+-+-+-+-+-+-+-+-+-+-+ +-+-+-+ + + +-+-+-+-+ + + +-+ + +-+-+-+ + +-+ +-+ +-+-+-+-+-+-+ + +
|   | | |   |           | |       | |     |         |   | | |   |       | |   |   |     |   |     | |
+ +-+ + + + +-+-+ + +-+ + + +-+-+-+ + +-+-+-+-+-+-+-+ +-+ + + +-+ +-+ + + +-+ +-+ +-+-+ + + + + +-+ +
|   | |   | |   | | |     |       | | |               |   |   |     | |   |           |   | | | |   |
+ + + +-+-+ + + +-+ + +-+-+-+-+-+ + + + +-+-+-+-+-+-+-+-+ +-+-+-+-+-+ + +-+-+ +-+-+-+ +-+-+ +-+ + +-+
| |   | |   | |   | | |       |   | | |     |       |       |     |   | |   | |   |       |   | |   |
+ +-+-+ + +-+ +-+ + +-+ +-+-+ + +-+ + + +-+ + +-+-+ + +-+-+ + +-+ + + +-+ + + + + +-+-+-+-+-+ + +-+ +
|   |   |     |   |   | |   | |     | | | | | |   | | |   | |   |   | |   | | | |             | | | |
+-+ + +-+-+-+-+ +-+ + + +-+ + +-+-+ + + + + + + + + + + + + +-+ +-+-+-+ +-+ +-+ +-+-+-+-+-+-+-+ + + +
| | |       |   |   | | |   |     | | |   | |   | |   | | |   |   |   |   |     |   |     | |   |   |
+ + +-+-+ +-+ + +-+-+ + + +-+-+-+ + + +-+ + + +-+ +-+-+-+ +-+ +-+ + + +-+ +-+-+-+ + +-+ + + + + + +-+
| | |   |   | | |   |     |     |   | |   | |   | |     |   |   |   |   | | |     |     | |   | | | |
+ + + + +-+ + +-+ + +-+-+-+ +-+ +-+-+ + +-+ +-+ + + +-+ + +-+-+ +-+-+-+ + + + +-+ +-+-+-+ +-+-+ + + +
| | | |     |     |   |     |   |   | | |   |   | | |   |     | |       | |   |   |     |   |   |   |
+ + + +-+-+-+ +-+-+-+ + +-+-+ +-+ + + + + +-+ +-+ + + +-+ + + + + +-+-+ + + +-+ +-+-+ + +-+ + +-+-+ +
| | |   |   | |       | |   |     |   | |   |   | | | |   | | |   |     | |   | |     | | |   |   | |
+ + +-+ + + +-+ +-+ +-+ + +-+-+-+-+-+-+-+-+ +-+ + + + +-+-+ +-+ +-+-+-+ + + +-+ + +-+-+ + +-+-+ +-+ +
| | |   | |   |   | |   |                   |   |   |     |     |     | | | |   |     |   | |       |
+ + + +-+ +-+ +-+ +-+ +-+ + +-+-+-+-+-+-+-+-+ +-+-+-+-+-+ +-+-+-+ +-+ +-+ +-+ +-+-+-+ +-+ + + +-+-+-+
| |   |   | |     |   | | |     |       |   | | |   |   |     |     |   |     |   |   | | | |       |
+ +-+ + +-+ +-+-+ + +-+ + +-+-+ + + +-+-+ + + + + + + + +-+-+ + +-+-+-+ +-+-+-+ + + +-+ + + +-+-+-+ +
|     | |     |   |   |     |   | | |     | | |   |   |     |     |     |       | |   |   |     |   |
+ +-+-+ + +-+ + +-+-+ +-+-+-+ +-+ +-+ +-+-+ + +-+-+-+ +-+-+ +-+-+-+ +-+ +-+-+ +-+ +-+ + +-+-+ +-+ +-+
|   |   | | |   |     |       | |   |   |   |   |   |     |     |   |         | |   | |       |   | |
+-+ + +-+ + +-+-+ +-+-+ +-+-+-+ + + +-+ + +-+-+ + + +-+-+-+-+-+ + +-+-+-+-+-+-+ +-+ + +-+-+-+ + +-+ +
|   | | | |     |   |     |   |   | |   |     |   | |           |         |       | | |   |   |   | |
+-+-+ + + +-+ + +-+ +-+-+ + +-+ +-+ + +-+-+-+ +-+-+ + +-+-+-+-+ +-+-+-+-+ + +-+-+ + + + +-+ +-+-+ + +
|     |     | | |   |     | |   |   |   |   |     |   | |     | |       | |     |   | |     |     | |
+ +-+ +-+-+ + + + +-+ +-+-+ + +-+ +-+-+ + + + +-+ +-+-+ + +-+ + +-+ +-+-+ +-+-+ +-+-+ +-+ +-+ +-+-+ +
| |   |   |   | | |   | |   |   |       | | | |         |   | |   | |     |     |   |   |   |       |
+ +-+-+ + +-+-+ + + +-+ + + +-+ +-+-+-+-+ + + +-+-+-+-+ +-+ + +-+ + + +-+-+ +-+-+ + +-+ +-+ +-+-+-+ +
|     | |   |   | |   | | |     |   |     | |   |     | |   |     | |   |         |   |   |     |   |
+ +-+ + +-+ +-+-+ + + + + +-+-+-+ + + +-+-+ +-+ + +-+ + + +-+-+-+-+ +-+ +-+-+-+-+-+-+ +-+ + +-+-+ +-+
|   |     | |     | | | | |   |   | | |   |   | |   |   |         |   |       |           | |     | |
+-+ +-+-+-+ + +-+-+-+ + + + + + +-+ +-+ + +-+ + +-+ +-+-+-+-+-+-+ + + +-+-+-+ +-+-+-+-+-+-+ + +-+-+ +
|   |       |         | |   |   | |     |     | |       |       |   |     | |   |         | | |     |
+-+-+ +-+-+-+-+-+-+-+-+ +-+-+-+-+ +-+-+-+-+-+ + +-+-+-+ + +-+-+-+-+-+-+-+ + +-+ + +-+-+-+ +-+ +-+-+ +
|     |   |         |           |     |     | |   |   |   |         |     |   |   |   | |   | |     |
+ +-+-+ + + +-+-+-+ + + +-+-+-+-+ + +-+ + +-+ +-+ + + +-+-+ +-+ +-+-+ +-+-+-+ +-+-+ + + +-+ + + +-+ +
|       |         |   |           |     |       |   |         |                     |     |     |   |
+-+-+-+-+-+-+-+-+-+-+-+-+-+-+-+-+-+-+-+-+-+-+-+-+-+-+-+-+-+-+-+-+-+-+-+-+-+-+-+-+-+-+-+-+-+-+-+-+-+-+