+-+-+-+-+-+-+-+-+-+-+-+-+-+-+-+-+-+-+-+-+-+-+-+-+-+-+-+-+-+-+
|                                                           |
+ +-+-+ + + +-+-+ + + +-+ + +-+ + + + + + +-+ + + + +-+-+ + +
|     | | | |     | |   | | |   | | | | |   | | | |     | | |
+ + + + +-+ + +-+ +-+ +-+ +-+-+ +-+-+-+-+-+ + + + + + +-+-+ +
| | | |   | | |   |   |     |             | | | | | |   |   |
+ + + + + + +-+ + + + +-+ + +-+ +-+ + + + + +-+ + + +-+ + +-+
| | | | | | |   | | |   | | |     | | | | | |   | |   | |   |
+ +-+ +-+ +-+ + + + + + + +-+ +-+ + + + +-+ + + + + +-+-+ + +
|   |   |   | | | | | | |   |   | | | |   | | | | |     | | |
+-+ +-+ + + + + + + + +-+ +-+ +-+ + + + + + + + + +-+ + + + +
|   |   | | | | | | | |   |     | | | | | | | | | |   | | | |
+-+ +-+-+-+ + + + +-+ +-+ + + +-+-+ +-+ + + +-+ + +-+ +-+ + +
|       |   | | | |     | | |   |   |   | |   | | |     | | |
+ +-+ + + +-+ +-+-+-+ +-+-+ + + +-+-+ + +-+-+-+-+-+-+ +-+ + +
|   | | |   |       |     | | | |     |           |     | | |
+ + + + + + + + + + +-+ + +-+ + + + +-+ + + + +-+-+ + + +-+ +
| | | | | | | | | | |   |   | | | | |   | | | |     | | |   |
+ + + + + +-+ + +-+-+ + +-+ + + +-+ +-+ + + +-+-+ + +-+ +-+ +
| | | | | |   |   |   | |   | |   | |   | | |     |   |   | |
+ + + +-+ + + +-+-+ + +-+ + + + + + +-+ + +-+ +-+-+-+ + +-+ +
| | |   | | |     | | |   | | | | |   | |   | |       |   | |
+ + + + + +-+ +-+-+-+-+ + +-+ + + +-+ + +-+ + + + + + +-+-+ +
| | | | |   |       |   | |   | | |   |   | | | | | | |     |
+ + + + +-+ + + + + +-+-+-+ + + + + +-+ + + + + + + +-+ +-+ +
| | | |   | | | | |   |     | | | | |   | | | | | | |     | |
+-+-+ +-+ + +-+-+ +-+ + + + + + +-+-+ +-+ +-+ + + + +-+ + + +
|     |   | |     |   | | | | | |       | |   | | |   | | | |
+ +-+-+ + + + +-+ + + + +-+ + + + + + + + +-+ + + + + +-+-+ +
| |     | | | |   | | |   | | | | | | | |   | | | | |     | |
+ +-+-+-+-+-+ +-+ +-+ +-+-+-+ + + + + +-+-+ + +-+ +-+ +-+ +-+
| |             | |         | | | | |     | | |   |   |     |
+ + +-+ +-+ + + + +-+ + +-+-+-+-+-+-+-+ + + +-+ +-+ + + +-+-+
| |   |   | | | | |   |     |           | | |     | | |     |
+ +-+ +-+-+-+ + + + + + + +-+ + + +-+ +-+-+ + + + + +-+-+-+ +
| |         | | | | | | | |   | | |   |     | | | |       | |
+ + + + +-+ + + + + + + + + + + + +-+ +-+ +-+-+ + + +-+-+-+ +
| | | |   | | | | | | | | | | | | |   |     |   | |   |     |
+-+ + +-+-+ +-+ + + + + + + +-+ + + +-+-+ + + +-+-+ +-+ + + +
|   | |     |   | | | | | | |   | | |     | | |       | | | |
+-+ + +-+-+ +-+ + +-+ +-+-+ + +-+ +-+ + + + + + + + + +-+ + +
|   | |       | | |       | | |   |   | | | | | | | | |   | |
+-+ + + + +-+-+ + + +-+ + + + + + +-+ +-+ +-+ + +-+-+-+-+ + +
|   | | |   |   | |   | | | | | |   | |     | | |         | |
+ + +-+ +-+ + + + + +-+ +-+ + + +-+ + + +-+ + + + + +-+ +-+ +
| | |   |   | | | |   |   | | |   | | |   | | | | | |   |   |
+-+ +-+ +-+-+ +-+ +-+ +-+-+ + +-+ +-+ + +-+ +-+-+-+-+ +-+ +-+
|   |     |     |   |   |   | |   |   |   |     |       |   |
+ + + + + +-+ +-+ +-+ +-+ + +-+ + + +-+ +-+ +-+ +-+ + +-+-+ +
| | | | |   |   | |   |   | |   | | |   |     |   | | |     |
+ + + +-+ +-+-+ +-+-+ + +-+ + +-+ + + + + + + + + + + + + + +
| | | |       | |     |   | | |   | | | | | | | | | | | | | |
+ +-+ + + + + +-+ + + +-+-+ + + + + + +-+-+ + + + +-+ + + + +
|   | | | | | |   | |   |   | | | | |   |   | | |   | | | | |
+-+ + + + + + + +-+ + + +-+-+ + +-+ + + + + + + + + +-+ + + +
|   | | | | | | |   | |   |   |   | | | | | | | | | |   | | |
+-+ + + + + +-+ +-+ + +-+-+-+ +-+-+ + +-+-+-+ + + + +-+ + + +
|   | | | | |   |   | |         |   |       | | | |   | | | |
+ +-+-+ + +-+-+-+ + +-+ + +-+ + + + +-+-+ + + + + +-+-+-+ + +
|   |   |       | |   | | |   | | |     | | | | |       | | |
+-+-+-+-+-+-+-+-+-+-+-+-+-+-+-+-+-+-+-+-+-+-+-+-+-+-+-+-+-+-+