+-+-+-+-+-+
|       | |
+-+-+-+ + +
| |     | |
+ + +-+-+ +
| |   |   |
+ +-+ + + +
|     | | |
+ +-+-+-+ +
|         |
+-+-+-+-+-+