+-+-+-+-+-+-+-+-+-+-+-+-+-+-+-+-+-+-+-+-+-+-+-+-+-+-+-+-+-+-+-+-+-+-+-+-+-+-+-+-+
|   |                 |       |               |           |     |         |   | |
+-+ +-+-+-+ +-+-+-+-+ +-+-+ + + +-+-+ +-+-+-+-+ +-+-+-+ + + + +-+ + +-+-+ + + + +
| |   |   | |   |   |       | | |   |   |   |     |     | | |     |   |     |   |
+ +-+ + + + + + + + +-+-+-+-+-+ + +-+-+ + + + +-+-+ +-+-+ + +-+-+ +-+ +-+-+-+-+ +
|   |   | |   |   |             |     |   |   |     | |   | |   |   |   |     | |
+ + +-+-+ +-+-+ +-+-+-+-+-+-+-+-+ +-+ +-+-+-+-+ +-+-+ + +-+ + + +-+-+-+ + +-+ + +
| |     |     |     |     |   | |   |   |       |   |   | | | |   |   | |   | | |
+ + +-+-+-+-+ +-+-+ +-+ + + + + +-+ +-+ + +-+-+-+ + + +-+ + + +-+ + + + + + +-+ +
| | |         |         |   | |       | |   |   | |   |   | |   | | |   | |     |
+ + + +-+-+-+-+-+-+ +-+-+-+-+ +-+-+-+-+ +-+ + + +-+ +-+-+ + +-+ + + +-+-+ +-+-+-+
| | | |           | |       | |           |   |   |     | | |   | | |   | |     |
+ +-+ +-+ +-+-+-+ + + +-+-+ + + +-+-+-+-+-+-+-+ + +-+-+ + + + +-+ + + +-+ +-+ + +
|     |   |       | |   | | |   |             | | |   | | | | |   | |     |   | |
+ +-+-+ +-+ +-+-+-+-+-+ + + +-+-+ +-+-+-+-+-+ +-+ +-+ + + + + + +-+ + +-+-+ +-+ +
| |   |   |   |         |   |     |     |   |   |   |   |   | |     | |     | | |
+ + + +-+ +-+ + + +-+-+-+ +-+ +-+-+ +-+ + + +-+ +-+ + +-+-+-+ +-+-+-+ +-+-+ + + +
|   |     | | | | |     | |   |       |   |   |     | |     |     |         | | |
+-+-+-+-+-+ + + + + + +-+ + +-+ +-+-+ +-+-+-+-+-+-+-+ + +-+ +-+-+ +-+-+-+-+-+ + +
| |         | | | | |   |   |   |     |         |   |   | | |     |       |     |
+ + + +-+-+ + +-+ + +-+ +-+-+ +-+ +-+-+ +-+-+ + +-+ +-+-+ + + +-+ + +-+-+ +-+ +-+
| | |     | | |   |   |     |   |       |   | |       |     | |   | |   |   | | |
+ + +-+-+ + + + +-+-+ +-+-+ +-+ +-+-+-+-+ +-+ +-+-+-+ + +-+-+ +-+-+ + + +-+ + + +
| | | |   | | | |   | | |     | |       |   |     | | | |           | |   | | | |
+ + + + +-+ + + +-+ + + + +-+-+ + +-+-+ +-+ +-+-+ + + + + +-+-+-+-+-+ +-+ + + + +
| | | | |   | |   |     |   |     |   |       |   |   | | | |       | |   | |   |
+ + + + +-+-+ +-+ +-+-+-+-+ + +-+-+ + + +-+-+ + + +-+-+ + + + + +-+ + + + + +-+-+
|   | |       |   |       |     |   | | |   | | | |     | | | | |   | | | | |   |
+ +-+ +-+-+-+-+ +-+ +-+-+ +-+-+ + +-+ + + + +-+ + + +-+-+ + + + +-+-+ + +-+ + + +
|   |         | |     |   |   | |   | | | |     | |   |   |   |       |   |   | |
+-+ +-+-+ +-+ + +-+-+ + +-+ + + +-+ + +-+ +-+-+ +-+-+ + +-+ +-+-+-+-+-+-+ +-+-+ +
| |   |   |   | |   | | |   | | |   | |   | |   |     |   | |         |   |   | |
+ +-+ + +-+ +-+ + + + + + + + +-+ +-+ + +-+ + +-+ +-+-+-+ + + +-+ +-+-+ +-+ + + +
|   |   | |     | |   | | | |     | |   |   |   | |   |   | | |   |   | |   |   |
+ + +-+-+ +-+-+-+ +-+-+ +-+ +-+-+-+ +-+-+ + + +-+ + +-+ +-+ + +-+-+ + + + +-+-+ +
| |   |       | |     |     |     | |   | | | |   |   |   |   |     |   | |     |
+ + +-+ + +-+ + + +-+ +-+-+ + +-+ + + + + + + + +-+ + +-+ +-+-+ +-+ +-+-+ + +-+-+
| |     |   |   | |   |     | |   | | |   |   | |   |   | |     |   |     | |   |
+-+-+-+-+ + +-+ + + +-+-+ +-+ + +-+ + +-+-+-+-+ +-+-+-+ + + +-+-+ +-+ +-+-+ + + +
|       | | |   | | |   |   | | |         |   |     |   | |     |   | |   | | | |
+ +-+-+ +-+ +-+-+ + + + +-+ + + +-+-+-+-+ + +-+-+-+ + + + +-+-+ +-+ + + + + +-+ +
|   |       |   | |   | | | | |       |   |   |     | | | |     |   | | | |   | |
+-+ +-+-+-+-+ + + +-+-+ + + + +-+-+-+ + +-+ + + +-+-+ +-+ + +-+-+-+-+ + + +-+ + +
|   |         |   |   | |   |       | | |   | | |     |     |   |   | | |   | | |
+ +-+ +-+-+-+ +-+-+ +-+ + +-+-+-+ +-+ + +-+-+ + +-+ + + +-+-+ + + + + + +-+ + + +
|     |     | |   | |   |     |   |   |       |   | |     |   |   |   |   | | | |
+ +-+-+ +-+ + + + + + +-+-+-+ + +-+ +-+-+-+-+ +-+ + +-+-+-+ +-+-+-+-+-+-+ + + + +
|     |   | |   |   | |       |   |   |   |   |   |   |   |   |           | |   |
+-+-+ +-+ + +-+-+-+ + + +-+-+-+-+ +-+ + +-+ +-+ +-+-+-+ + +-+ +-+-+ +-+-+ +-+-+ +
|   | |   | |     | | |   |       |   |       |   |     |   |     |   |   |     |
+-+ + + +-+ + + +-+ + +-+ + +-+-+-+ +-+-+-+-+ +-+ + +-+-+-+ +-+-+ +-+ + +-+ +-+-+
|   | |   | | | |   | |   | |     |         |   |   |     |   |   |   |   | |   |
+ +-+ +-+ + + + + +-+ +-+ + + +-+-+-+-+-+-+ +-+ +-+-+-+-+ +-+ + +-+ +-+-+-+ + + +
| |     | | | |     |   | | |             |   | |         | | | |         |   | |
+ + +-+-+ + + +-+-+-+-+ + + + +-+ +-+-+-+ +-+ +-+ + +-+-+ + + + + +-+-+-+ +-+-+ +
|   |     | |   |       | | |   | |       | | |   | | |     | | |       |     | |
+-+-+ +-+-+ +-+-+ +-+-+-+ + +-+-+ + +-+-+-+ + + +-+ + + +-+-+ + +-+-+ +-+ +-+-+ +
|     |     |   |   |   | |   |   |         |     | | |   |   |     | |   |   | |
+ +-+-+ +-+-+ + +-+ + + +-+-+ + +-+-+-+-+-+ +-+-+-+ + +-+ + +-+ +-+ + + + + + + +
|     |       |   |   |     |   |   |     | |   |   |   | | |   | | | | | | |   |
+ +-+ +-+-+-+-+-+ +-+-+ +-+ +-+-+-+ + +-+ + + +-+ +-+-+ + + +-+ + + +-+ +-+ +-+-+
| |   |     |   |     |   |       | |   |   |   | |   |   |   |   |   |     |   |
+-+ + +-+-+ + + +-+-+ + +-+-+ + + + +-+ +-+-+-+ + + + +-+-+-+ + +-+-+ +-+ +-+-+ +
|   | |   |   |   |   | |   | | | |   |   |     |   |   |     | |   |   | |     |
+ +-+-+ + +-+ +-+ + +-+-+ + +-+ + + + +-+ + + +-+-+-+-+ + +-+-+-+ + + + + + +-+ +
|       |   |   | |       |     | | |   | | |   |       |   |     | | | |   | | |
+-+-+-+-+-+ +-+ + +-+-+ +-+-+-+-+ + + +-+ + +-+ + +-+-+ +-+ +-+ +-+ + + +-+-+ + +
|         | | | |     | |   |       | |   | |   | |   |   |     | | | | |     | |
+ +-+-+-+ + + + +-+ +-+ + + +-+-+-+-+ + +-+ + +-+ + + + +-+-+-+-+ + + + + +-+ + +
| |   |     | | | |   | | |     |     | |   | |   | | | |       |   | | | | |   |
+ + + +-+-+-+ + + +-+ + + +-+-+ +-+-+ + + +-+ + +-+ + +-+ + +-+ + +-+-+ + + +-+-+
|   |     |   | |   |   |   | | |   | | |   | |   | |   | | | | |   |   |       |
+ +-+-+-+ + +-+ +-+ +-+-+-+ + + + + +-+ +-+-+ +-+ + +-+ + + + + +-+ + +-+-+-+-+ +
| |   |   |           |       | | |     |       | | | |   | | |   | | |     |   |
+ +-+ + +-+-+-+-+-+-+-+ +-+-+ + + +-+-+-+ +-+ +-+ + + +-+-+ + +-+ + + +-+-+ + +-+
|   | |         |   |   |   | | | |     | | | |   | |     | |     | |     | |   |
+-+ + +-+-+-+-+ + + + +-+ + +-+ + + +-+ + + + + + + +-+-+ + +-+-+-+ + +-+ + +-+ +
| |       |     | | |   | |     | | | |   |   | | |     | |       | | |   |     |
+ +-+-+-+ + +-+-+ + +-+ + +-+-+-+ + + +-+-+ +-+ +-+-+-+ + +-+-+-+ + +-+ +-+ +-+-+
|         |       |     |           |         |                 |       |       |
+-+-+-+-+-+-+-+-+-+-+-+-+-+-+-+-+-+-+-+-+-+-+-+-+-+-+-+-+-+-+-+-+-+-+-+-+-+-+-+-+