+-+-+-+-+-+-+-+-+-+-+-+
|                     |
+ + +-+-+ +-+-+-+-+-+ +
| |     |           | |
+ +-+-+ + +-+ + + +-+-+
|     | |   | | |     |
+ +-+ + + +-+ +-+ +-+ +
|   | | |   |   |   | |
+ + +-+-+ + +-+-+-+ + +
| |     | |       | | |
+ +-+-+-+ + + + +-+-+ +
|       | | | |     | |
+ +-+ + + + +-+-+ + +-+
|   | | | |     | |   |
+ +-+ +-+ +-+ + + + +-+
|   |   |   | | | |   |
+ +-+-+ + +-+-+ +-+ +-+
|     | |     |   |   |
+ +-+-+ +-+ + +-+-+ + +
|     |   | |     | | |
+ +-+ + + + +-+ + + + +
|   | | | |   | | | | |
+-+-+-+-+-+-+-+-+-+-+-+