+-+-+-+-+-+
| |       |
+ +-+ +-+ +
|   | |   |
+-+ + + +-+
|   | |   |
+ +-+ +-+ +
| |   |   |
+ +-+-+ + +
|       | |
+-+-+-+-+-+