+-+-+-+-+-+
|     |   |
+-+-+ + +-+
|   | |   |
+ +-+ +-+ +
| |   |   |
+ + +-+ + +
| |   | | |
+ +-+ + + +
|       | |
+-+-+-+-+-+