+-+-+-+-+-+-+-+
|   |         |
+-+ + + +-+ + +
|   | |   | | |
+ +-+-+-+-+-+ +
|   | | |     |
+-+ + + +-+ +-+
|     |   |   |
+-+ + +-+ + +-+
|   |     | | |
+-+-+ + +-+ + +
|   | | |     |
+ +-+-+ + +-+-+
|             |
+-+-+-+-+-+-+-+