+-+-+-+-+-+-+-+-+-+-+-+-+-+-+-+-+-+-+-+-+-+-+-+-+-+-+-+-+-+
|     |   |     |     |   |                 |   |         |
+ + +-+ +-+ +-+ + +-+-+-+ +-+ +-+ + + +-+-+ +-+ + + + +-+-+
| |   | |   | | | | | | | |     | | |   |     | | | |     |
+ +-+-+ + +-+ + + + + + + +-+-+-+ + + +-+ +-+ + + + +-+-+ +
|     |   |   |     | | | |   |   | |   |   |     | |   | |
+-+ +-+ +-+-+ +-+-+ + + + + +-+ + +-+-+ + +-+-+ + + + + +-+
| |   | | | |     |     |     | | | |   | |   | | | | |   |
+ + +-+-+ + + +-+-+ + + + + +-+-+-+ + +-+ + + + + + +-+-+ +
| |     |   |       | |   | |   |     |     | | | | |     |
+ + +-+-+ + + +-+-+-+-+-+ + + +-+-+ + +-+-+-+-+-+ +-+ + + +
|   | |   | | |   |     | | |   |   |   | |   | | |   | | |
+ + + + + +-+-+-+ + + +-+ + +-+ +-+ +-+-+ + + + + + +-+-+-+
| |     |   | |   | |   | |             |   |         | | |
+ +-+-+-+-+-+ + +-+ +-+-+ + +-+-+-+-+-+-+ +-+ +-+-+ +-+ + +
|         |         | | | |   |       | |   | | |   | |   |
+ + + +-+ +-+-+ +-+-+ + + +-+-+ +-+-+ + + + + + +-+-+ + +-+
| | | | |   |   |     |   |         | |   | |     |   |   |
+-+-+-+ +-+ + +-+-+ + + +-+-+ +-+-+-+-+-+-+ +-+ +-+ + + + +
|     | | |   | |   |       |   | | | |   | |     | | | | |
+ +-+ + + + + + + +-+ + +-+-+ + + + + + +-+-+-+-+-+ +-+ + +
|   |     | |   |   | |       | | |   | |       |     | | |
+-+ +-+ +-+-+ +-+ +-+-+-+ +-+ + + +-+ + +-+ +-+-+-+ +-+ +-+
|   |     |           | | |   |   |                 |   | |
+ + + +-+ +-+ +-+ +-+ + +-+ + +-+ +-+-+ +-+-+ + +-+-+-+ + +
| | | |         | | | | |   | |   |   | |   | | | |   |   |
+ + + +-+-+-+-+-+ + +-+ + + +-+ +-+ + +-+ +-+ +-+ + + +-+ +
| | |   | |     |     |   | | |   | |   | |     |   |   | |
+-+ +-+-+ + + +-+ +-+ +-+ + + + +-+-+ +-+ + + + + +-+-+ + +
|       |   |     |   | | | |     |     |   | |   | |     |
+ +-+-+-+ + + +-+-+-+-+ +-+-+-+ + +-+ +-+ + +-+-+-+ +-+ +-+
|       | | |   |     |   |     |     |   | |         |   |
+-+-+ +-+-+-+ + + +-+-+ +-+-+-+ + +-+-+ + + + + + +-+ + +-+
|   | | |     | |     |   |   | | |   | | | | | | | |   | |
+ +-+ + +-+ +-+-+-+ + +-+ +-+ + +-+ +-+-+ +-+-+-+ + +-+-+ +
| | |     |         |   |   |         |   |     |     |   |
+ + +-+-+-+-+ + + + +-+-+-+ +-+-+ +-+ +-+ + + + +-+-+ + + +
|       |   | | | |       |     |   |   | | | | |       | |
+-+-+-+ +-+ +-+ +-+ +-+ +-+ +-+-+ +-+-+-+ +-+ +-+-+-+ + +-+
|   | | |   | | |   |     |   |             |   |     |   |
+ +-+ + + + + + +-+-+-+-+ + +-+-+ +-+-+-+-+ + + + +-+-+-+-+
| |       |   | |   | |       | | | |     | | |       |   |
+ +-+ + + + + + + + + +-+-+ + + + + +-+ +-+-+-+-+-+ + + + +
| |   | | | |   | | |   |   | |           |   | |   |   | |
+ +-+-+ + +-+-+ +-+ + +-+ +-+ + + + + +-+ +-+ + +-+ + +-+ +
|   | | | |   | |     |   | | | | | |   |       | | |   | |
+ +-+ + +-+ + + +-+ + +-+ + +-+ +-+-+-+ + +-+-+-+ +-+-+ + +
| |   | |   | |   | | |   |   |   |   | | |       |     | |
+ +-+ + +-+ +-+-+ +-+ + +-+-+ +-+-+ +-+ + + +-+-+ + + + + +
|     |         | | | |   |       |     | | | |     | | | |
+ +-+ + +-+-+-+-+-+ + +-+-+-+-+ +-+ +-+ + + + +-+-+ + + +-+
| |     |         | | |   |       | |   | |   |     | |   |
+-+-+-+ + +-+-+-+-+ + +-+ +-+ + +-+-+-+ +-+ + + +-+-+-+ + +
| | | | |       | |           |           | | | |       | |
+ + + + + + +-+ + +-+ +-+ +-+ +-+ + + + +-+-+ + +-+-+-+-+ +
|       | |   | |     |   |   |   | | | |     | |   | |   |
+-+ +-+ + + +-+-+ +-+ +-+ + + +-+-+-+ + + +-+-+ + +-+ +-+ +
|   |   | |       |   |   | |       | | |   |         |   |
+-+-+-+-+-+-+-+-+-+-+-+-+-+-+-+-+-+-+-+-+-+-+-+-+-+-+-+-+-+