+-+-+-+-+-+-+-+-+-+-+-+-+-+
| |   |           |       |
+ + + + +-+-+-+-+ +-+-+-+ +
|   |   |     | |       | |
+-+-+-+-+-+ + + +-+-+-+ + +
|     |     | |   |     | |
+ + + +-+ +-+ + + + +-+-+ +
| | |     |     | |   |.| |
+ + +-+-+-+-+-+-+ +-+ +-+ +
| |             |   | |.| |
+ +-+-+-+-+-+-+ +-+ + +-+ +
|   |         | |   | |   |
+-+ + +-+-+ +-+ + +-+ + +-+
|   | |     |   |   | |   |
+ +-+-+ +-+ + +-+-+-+ +-+ +
| |     |   |   |   |     |
+ + + + +-+-+-+ + + +-+-+ +
| | | | |     |   |   |   |
+ +-+ +-+ + +-+-+-+ +-+ +-+
|   |     |       | |   | |
+-+ + +-+-+-+-+ + + + +-+ +
| | |         | | |   |   |
+ + +-+-+ +-+-+ + +-+-+-+ +
| | |     |   | | |     | |
+ + +-+-+-+ + + + +-+ + + +
|           |   |     |   |
+-+-+-+-+-+-+-+-+-+-+-+-+-+