+-+-+-+-+-+-+-+
|   | |   |   |
+-+ + +-+ +-+ +
|   | | | |   |
+-+ + + + + +-+
|   | |       |
+ +-+ +-+ + +-+
|     | | |   |
+-+-+ + + +-+ +
| |   | | |   |
+ +-+ + +-+ +-+
| |           |
+ + + +-+-+ + +
|   | |     | |
+-+-+-+-+-+-+-+