+-+-+-+-+-+-+-+-+-+-+-+-+-+-+-+-+-+-+-+-+-+-+-+-+-+-+-+-+-+-+-+-+-+-+-+-+-+-+-+-+-+-+
|           | |       |     |           |           |     |     |     |       |     |
+-+-+-+-+-+ + + +-+ +-+ +-+ + +-+-+ +-+ + +-+ +-+-+ + +-+ + + +-+ + +-+ +-+ + +-+-+ +
|       |   | | | |     | |   |   |   | |   |     | | | |   |     |     |   |       |
+ +-+-+ + +-+ + + +-+-+-+ +-+-+-+ +-+ +-+ +-+-+-+ + + + +-+-+-+-+-+-+-+-+ + +-+-+-+ +
|     | | |     |               |   |   | |       | |     |           | | | |     | |
+ +-+-+ + +-+ +-+-+-+ +-+ +-+-+ + +-+-+ + + +-+-+-+-+-+-+ +-+-+-+ +-+ + + + + +-+ +-+
| |   | |   |       |   | |       |   |   |             | |   |   | | | | | | | |   |
+-+ + + +-+ +-+-+-+ +-+ + +-+-+-+-+ + +-+-+-+-+-+-+-+ +-+ + + + +-+ + + + +-+ + +-+ +
|   |   | |   |   |   | |         | | |       |     |   |   | | |   | | |   |     | |
+ +-+-+ + +-+ + + +-+ +-+ +-+-+-+ + + + +-+ + +-+-+ +-+ +-+-+ + + +-+ + +-+ +-+ +-+ +
| |   |     |   |   |   | |     |   | |   | | |     | |     |   |   |     |     |   |
+ + +-+-+-+ +-+-+-+ +-+ + +-+ + +-+-+ +-+ + + + +-+ + +-+-+ +-+-+ + +-+ +-+-+ +-+ + +
| |       | |     |   | |   | |     |     | |   | | |     |   |   |     |   | |   | |
+ + + +-+-+ + + +-+-+ + +-+ + +-+-+ +-+-+-+ +-+-+ + + +-+ + +-+ +-+-+-+-+ + +-+ +-+ +
| | |   |   | |       | |     |   | |     | |   |   |   | |   | | |   |   |     | | |
+ + +-+ + +-+ +-+-+-+-+ +-+-+-+-+ + + +-+ + + +-+ +-+-+-+ +-+ + + + + + +-+-+-+-+ + +
| |   |   |   |           |     |   | |     |   |       |   |   | | | |         | | |
+ +-+-+-+ + +-+-+-+-+-+-+ + +-+ +-+-+ +-+-+-+-+ +-+-+-+ + + +-+-+ + + +-+-+-+-+ + + +
| |     | |   |       | |   | | |   |   |     |     |   | |     |   | |       | | | |
+ + +-+ +-+-+ + +-+-+ + +-+-+ + + + + + + +-+ + +-+ + +-+ +-+ + + +-+ + +-+-+ + + + +
|     |     | | |     |   |   |   | | |     | | | | | |   |   | | |   | |       |   |
+-+-+-+ + +-+ + + +-+-+ + + + +-+-+ + +-+-+-+ + + + + + +-+ +-+ +-+ + + + +-+-+-+ +-+
|     | |   | | | |     |   | |     | |   |   | | |   | |   | | |   | | | |   | |   |
+ +-+ +-+-+ + + + + +-+-+-+-+ + +-+-+-+ + + +-+ + +-+-+ + +-+ + + +-+ + +-+ + + +-+ +
| | |   |   |   | |       |   |   |     | |   |   |   | |   | |   | | |     | |     |
+ + +-+ + + +-+-+ +-+-+ + +-+-+-+ + +-+-+ +-+ +-+ + + + +-+ + +-+-+ + +-+-+-+ + +-+-+
| |       | |     |   | |       |   |     |   | | | | | |   |       |   |   | | |   |
+ +-+-+-+-+-+ +-+-+ + +-+ +-+-+ +-+-+ +-+-+ +-+ + + + +-+ +-+ +-+-+ +-+ +-+ + + +-+ +
|           |       |   |     |     |     |   | |   | |   |   |   | |       | |   | |
+ +-+-+-+-+ +-+-+-+-+-+ +-+-+ +-+ +-+-+-+ + + + +-+-+ + +-+-+ + + +-+ +-+-+-+ +-+ + +
| |       |   |   |   |     | |   |     | | | |     | |   |   | |     |       |   | |
+ + +-+-+ + + + +-+ + +-+-+ +-+ +-+ +-+ + + + +-+ + + + + + +-+ +-+-+-+ +-+-+-+ +-+ +
|   |   | | |   |   |     |   |       | | | |   | | | | | | |   |     |   |   |     |
+-+-+ + +-+ + +-+ +-+-+-+ +-+ + +-+-+-+ + + +-+ + +-+ +-+ + + +-+-+ + +-+ +-+ +-+-+ +
|   | | |   | |   |         | | |       | |   | |   |     | |     | |   |   |     | |
+ + + + + +-+-+ +-+ +-+-+-+-+ +-+ +-+-+ + +-+ + +-+ +-+-+-+ +-+-+ +-+ + +-+ + +-+ + +
| |   |   |     |   |       |   | |   | |   | |   |     |     |   |   | |   |   | | |
+ +-+-+-+ + +-+-+ +-+ +-+-+ +-+ + + + +-+-+ +-+-+ + +-+ + +-+-+ +-+ + +-+ +-+-+ +-+ +
|   |     |     |     |       | |   | |     |     |   | |     | |   | |   |     |   |
+ + + +-+-+-+-+ +-+-+-+ +-+ +-+ + +-+ + +-+-+ +-+-+-+ + +-+-+ + +-+ +-+ +-+ + +-+ +-+
| | |     |   | |     |   | |   | |   |     |   |     |     | |     |   |   | |   | |
+ + +-+-+ +-+ + + +-+ +-+ +-+ +-+ + +-+-+-+ + + +-+ +-+-+-+ + +-+ +-+ +-+ +-+ + +-+ +
| | |   | |   | | | |   | |   |   |       | | | |   |   |   | |   |   |   |   | |   |
+-+ + + + + +-+ + + + +-+ + +-+-+ +-+ +-+-+ + + + +-+ +-+ +-+ + +-+ +-+ +-+ +-+ +-+ +
|   | |   | |   |   | |   |     | | | |   | | | |   |   | |   | |   |     |   |     |
+ +-+ +-+-+ + +-+-+ + + +-+-+-+ + + + + + + +-+ + + +-+ + + +-+ + +-+-+ + +-+ +-+-+ +
|   |       | |     | |   |     |   |   |   |   | |   | |   |   |     | |   |     | |
+-+ +-+-+-+ + + +-+-+ +-+ + +-+-+-+-+-+ +-+-+ +-+ +-+ + +-+ + +-+-+-+ +-+-+ +-+-+-+ +
|   |     | | |   |     | | |     |   |     | | | |   |     |   |   |     |       | |
+ +-+-+ + + + +-+-+ +-+ + + + +-+ + + +-+-+ + + + + +-+ +-+-+-+ + + +-+-+ +-+ +-+ + +
|     | | | |   |   |   | |   | |   |   | | | |   |   | |       | | |   |   | | |   |
+ +-+ + +-+ +-+ + +-+ +-+ +-+-+ +-+-+-+ + + + + +-+-+ + + +-+-+-+ + + + +-+ + + +-+-+
| |   |       | | |   |   |     |   |   | |   | |   | | |   |   | |   |   | |     | |
+ + +-+ +-+-+-+ + + +-+ + + + +-+ + + +-+ +-+-+ +-+ + +-+-+ + + + +-+-+-+ + +-+-+ + +
| | |       |   | | |   | | |     |   |   |   |   | |       | | |   |     | |   |   |
+ + +-+-+-+ + +-+ + + +-+ + +-+-+-+-+-+-+ + + +-+ + +-+-+-+-+ +-+-+ +-+-+ + +-+ +-+ +
| | |     | |     | | |   | | |     |     | |   |             |   |     |   |     | |
+-+ + +-+ +-+-+-+-+ + +-+ + + + + +-+ + +-+ + +-+-+-+-+-+ +-+-+ + +-+-+ +-+-+ + +-+ +
|   | | |       |   |   | | |   |     |     |           | |     | |   |   |   | |   |
+ +-+ + +-+-+-+ + +-+-+ + + +-+-+-+ +-+-+-+-+-+-+-+ + + + + +-+-+ + + +-+ + + +-+ +-+
|     |   | |   | |   | | |       |   |   |       | | | | |   | | | |   | | | |   | |
+ +-+-+ + + + +-+ + +-+ + +-+-+-+ +-+-+ + + +-+-+ +-+ +-+ +-+ + + + +-+ + +-+ + +-+ +
|       |   | |   |   | | |     | |   | |   |   | |   |     | | | | | |   |   |     |
+-+-+-+-+-+ + + +-+-+ + + + +-+-+ + + + +-+-+-+ + + +-+ +-+-+ + + + + +-+-+ +-+-+-+ +
|       |   | | |   | | |   |     | |   | |     | |     |     | | | |       |     | |
+ +-+-+ +-+-+ + + + + + +-+-+ +-+-+ +-+-+ + + +-+ + +-+-+ +-+-+ + + + +-+ +-+ +-+ + +
| |   |       | | | | |       |     |     | | |   |     | |     |   |   | |   |   | |
+ +-+ +-+-+-+ + + + + +-+-+-+-+ +-+-+ +-+-+ + + +-+-+ +-+ + +-+ +-+-+-+ + + +-+ + + +
|   |       | | | |         |       | |     | | |     |   | | |   |     | | | | | | |
+-+ + + +-+-+ + + +-+-+-+-+ + +-+-+ + + +-+-+ + +-+-+ + +-+ + + + + +-+-+ + + + + + +
|   | |       |   |       | | |     |     |   |     | | |     | | |   |   | | | | | |
+ +-+ +-+-+-+-+-+-+ +-+ +-+ + + +-+-+-+-+ + + +-+-+ + + + +-+-+ + +-+ + +-+ + + +-+ +
|   | |           | | |     | | |       | | |     | | | |   |   | |   |   | | |     |
+-+ +-+ +-+-+-+-+ + + +-+-+-+-+ +-+-+ + +-+ +-+-+ + +-+ +-+-+ +-+ + +-+-+ + + +-+-+-+
|   |   |   |   |   |           |     | |   |     | |   |     |   | |   |   |   |   |
+ +-+ +-+ +-+ + +-+-+-+ +-+-+-+-+ +-+-+ + +-+ +-+-+ + +-+ +-+-+ +-+ +-+ +-+-+ + +-+ +
| |   |       |       |     |   | |       |       |   |     | |   |   |       |   | |
+ + +-+-+-+ +-+-+ +-+ +-+-+ + + + +-+ +-+-+-+-+ +-+-+-+-+-+ + + +-+-+ +-+-+ +-+-+ + +
| |   |   |   |   |   |   | | | |   |   |     | |         | |   |   |     |   | |   |
+ +-+ + + +-+-+ +-+ +-+ + + + + + + +-+-+ +-+ +-+ +-+-+ + + +-+-+ + +-+-+ + + + +-+ +
| |   | |       |   |   | |   | | |     | | |   | |   | |   |   | |     | | | |   | |
+ + +-+ +-+-+-+-+ +-+-+ + +-+-+ + +-+-+ + + +-+ + + + + +-+-+ + + +-+-+ + +-+ + + + +
|       |               |       |     |       |     | |       |       |       | |   |
+-+-+-+-+-+-+-+-+-+-+-+-+-+-+-+-+-+-+-+-+-+-+-+-+-+-+-+-+-+-+-+-+-+-+-+-+-+-+-+-+-+-+