+-+-+-+-+-+-+-+-+-+-+-+-+-+-+-+-+-+-+-+-+-+-+-+-+-+-+-+-+-+-+-+-+-+-+-+-+-+-+-+
|       | |         |           |     |         | |     |     |       |       |
+-+-+-+ + + + +-+-+ + +-+-+-+-+ + + + + +-+-+-+ + + + + +-+ + + +-+-+ + + +-+-+
|   |   |   | |     |   |     | | | |   |       |   | |     |   |   | | | |   |
+ +-+ +-+-+-+ +-+-+ +-+ + +-+ + +-+ +-+-+-+ +-+-+-+-+ +-+-+-+-+-+ +-+ + +-+ + +
|   |       | |   |     | |   |   | |     |         |   | |       |   |     | |
+ + +-+-+-+ + + + +-+-+-+-+ + +-+ + + +-+ +-+-+-+-+ +-+ + + +-+ +-+ +-+-+-+ + +
| |         |   | |         | |   | | | |         |     | |   |     |     | | |
+ +-+-+-+-+-+ +-+ +-+ + +-+-+-+ +-+ + + +-+-+ +-+ +-+-+-+ +-+ +-+-+-+ +-+ +-+ +
| |         |   |   | |         |       |   | |   |   | |   | | |     | |     |
+ + +-+-+-+-+-+ +-+ +-+-+-+ +-+-+-+-+-+-+ + +-+ +-+ + + + + + + + +-+ + +-+-+ +
| | |         |   |       | |     |     | |     |   | | | |   |     | |   | | |
+ + + +-+-+ +-+-+ +-+-+-+ + + +-+ + +-+ + +-+-+-+ +-+ + + +-+-+ +-+-+ + + + + +
| |   |   |     |   |     | | | |   |   |   |   |   |   |     |   |   | | | | |
+ +-+ + +-+-+ +-+-+ + +-+-+ + + +-+-+ +-+-+ + +-+ + +-+ +-+-+ +-+-+ +-+ + + + +
|   | |     | |   | | | |   | |           | | |   | | |     |   |   |   |   | |
+-+ + +-+-+ + + + + + + + +-+ +-+-+-+-+-+ + + + +-+ + + +-+-+-+ + +-+ +-+-+-+ +
|   |     | |   |   | | |   |       |   |   |   |   |   |     | | |       |   |
+ +-+-+-+ + +-+-+-+-+ + +-+ +-+-+-+ + +-+-+-+ +-+ +-+ +-+ +-+ + + +-+-+ + + +-+
|   |         |   |   |   | |       |       | | |   |   | |   | |     | |   | |
+-+ +-+-+-+-+ +-+ + +-+ + + + +-+-+-+-+-+-+ + + +-+ +-+-+ + + + +-+-+ + +-+-+ +
| |     |   |     | | | |   |   |           |   |   |   | | | |       | |     |
+ +-+-+ + + +-+ +-+ + + +-+-+-+ + +-+-+-+-+ +-+ + +-+ + + + +-+-+-+-+-+ +-+-+ +
|     | | |     |   | |   |     |   |       |   |     |   |         |   |     |
+ +-+ + + +-+-+-+ +-+ +-+ + +-+-+-+ +-+-+ +-+ +-+-+-+-+-+-+-+-+-+ +-+ +-+ +-+ +
|   |   |   |   | | |     | |     | |   | |   |       |     |     |   |   |   |
+-+ +-+-+-+ +-+ + + + +-+-+ + + + + + + +-+ +-+-+-+ + + +-+ + +-+-+ +-+ + + +-+
| |   |   |     | |     |   | | |   | |         |   |   |   |       | | | |   |
+ +-+ + + +-+-+ + +-+-+ + +-+ + +-+-+ +-+-+-+-+ + +-+-+-+ +-+-+-+-+ + + + +-+ +
|   | | |       |   | |   |   |     | | |   | | | | |       |     | |   | | | |
+ + + + +-+-+-+-+-+ + + +-+-+-+-+-+ + + + + + + + + + +-+-+-+ +-+ + + +-+ + + +
| | | |       |   | |   |         |   | | | | | | | |   |   | |   | | |   |   |
+ + + +-+-+-+ + + + + +-+ +-+-+-+ + +-+ + + + + + + +-+ + + + + +-+ +-+ +-+ +-+
| | | |   | |   | | |   |       | |     | | |     |   | | |   | |     |   | | |
+ + + + + + +-+-+ + +-+-+-+-+-+ + +-+-+-+ + +-+-+-+ + + + +-+-+ +-+-+ +-+ + + +
| |   | | |       |   |       | |     |   |   |     | | | |   |     |     |   |
+ +-+-+ + +-+-+-+-+ + + +-+-+ + +-+-+ + +-+-+ + +-+-+ + + +-+ +-+-+ +-+-+-+-+ +
| |     | |   |   | |   |   |       |   |   | |     |   |   |     |     |     |
+ +-+ +-+ + + + + + +-+-+-+ +-+-+-+-+-+ + + + +-+-+ +-+-+-+ + +-+-+-+-+ +-+-+-+
|   | |     |   | |   |   |   |   |   | | |   |   |   |   | |         |       |
+-+ + +-+-+-+-+-+ +-+ + + + + + + + + + + +-+-+ + +-+ + + + + +-+-+-+ +-+-+-+ +
| | |   |     |   |     |   | | |   | | | |     |     | |   | |     |       | |
+ + + + +-+ + + +-+-+-+-+-+-+-+ +-+-+ +-+ + +-+-+-+-+ + +-+-+ +-+ + +-+-+ +-+ +
| | | |   | | | |   |   |     |   | |   | | |   |   | | |     |   | |   |   | |
+ + +-+-+ +-+ + + + + + + +-+ +-+ + +-+ + + + + + + + + +-+-+ + +-+ + + +-+ + +
|   |     |   |   |   | |   |   | |   | | |   | | | | |     |   | | | | |   | |
+ +-+ +-+-+ +-+-+-+-+-+ + + +-+ + + +-+ + +-+-+ + + +-+-+-+ +-+-+ + + +-+ + + +
|   | |   |         |   | | | | | |   | |   | | | |         | |       |   | | |
+-+ + + + +-+ +-+-+-+ +-+ + + + + +-+ + +-+ + + + +-+-+-+-+-+ + +-+-+-+ +-+-+ +
| |   | |     |       |   | |   |   | |   | |   | |               |     |     |
+ +-+-+ +-+ +-+ +-+-+-+-+ + +-+ +-+ + +-+ + +-+-+ + +-+-+-+-+ +-+-+ +-+-+ +-+ +
|     |   | |   |       | |   |     |   | |     | | |       | |   | |   |   | |
+ +-+-+ + +-+ +-+-+ +-+ +-+-+ +-+-+-+-+ + +-+-+ + +-+ +-+-+ +-+ + + + + +-+ + +
| |     |     |   |   |     | |   |     |   |   | |   |   | |   |   | |     | |
+ + +-+-+-+-+-+ + +-+ +-+-+ + + + +-+ + +-+ + +-+ + +-+ +-+ + +-+ +-+ +-+-+-+ +
|   |           | |   |     | | |     |   | |       | |   | |   | |   |   |   |
+ +-+-+ +-+-+-+-+ + +-+-+ +-+ + +-+-+-+-+ + +-+-+-+-+ + + + +-+ +-+ +-+-+ + +-+
|   |   |     |   |     | |   |   |   |   |       |   | |       |   |     | | |
+-+ + +-+ +-+ + +-+ +-+ + + +-+-+ + + + +-+-+-+-+ +-+ + +-+-+-+-+ +-+ +-+ + + +
| |   |   |   | |     | | | |     | | | |         |   | |   |     |   |   | | |
+ +-+-+ +-+ +-+ +-+-+-+ + + + +-+-+ +-+ + +-+-+-+-+ + + + +-+ +-+-+-+ +-+-+ + +
|     | | |   |   |     |   | |         |   |       | | |   | |       |     | |
+ +-+-+ + +-+ +-+ + +-+-+-+-+ + +-+-+-+-+-+ +-+-+ + +-+ +-+ + + +-+-+ + +-+-+ +
| |   | |   |     |   | |     |     |     |   |   | |       | |   |   | |     |
+ + + + + +-+-+-+-+ + + + + +-+-+-+ + +-+-+-+ + +-+-+ +-+-+-+ +-+ + +-+ +-+-+ +
| | |   |   |       | |   | |   |   | |     | | |     |       |   |   |     | |
+ + +-+-+ + + +-+-+-+ + +-+ + +-+ +-+ + + +-+ + + +-+-+ +-+-+-+ +-+-+ +-+-+ + +
| |   |   |       |   |   | |     |   | |     |       |   |     |       |   | |
+ +-+ +-+-+-+-+ +-+ +-+-+ + +-+ +-+ + + +-+-+-+-+-+-+-+-+ + + + +-+-+-+ + +-+ +
|     |       | |   |     |   |     | |   |     |         | | | |     | | |   |
+ +-+-+ +-+-+ + + +-+-+-+-+ + +-+-+-+ +-+ + +-+ + +-+-+-+-+ + +-+ +-+ +-+ + + +
|     | | |   | |         | |     | | |   | | | | |   |   | |       | |   | | |
+-+-+ + + + +-+ +-+-+-+ + +-+ +-+ + + + +-+ + + + + + + + + +-+-+-+-+ + +-+-+ +
|   |   | |   | |     | |   |   | |   |     | |   | |   |     |       |     | |
+ +-+-+-+ +-+ +-+ +-+ + +-+ +-+ + +-+-+-+-+-+ +-+-+ +-+-+-+-+-+ +-+ +-+-+-+ + +
|           | |   | | |   |   | |     |     |   |   |   |   |   |   |     | | |
+ + +-+-+-+-+ + +-+ + +-+-+-+ + +-+-+ + +-+ + + + +-+ + +-+ + +-+-+-+ +-+ + + +
| |             |             |     |     |   |       |     |           |     |
+-+-+-+-+-+-+-+-+-+-+-+-+-+-+-+-+-+-+-+-+-+-+-+-+-+-+-+-+-+-+-+-+-+-+-+-+-+-+-+