+-+-+-+-+-+-+-+-+-+-+-+-+-+-+-+-+-+-+-+-+-+-+-+-+-+-+-+-+-+-+-+-+-+-+-+-+-+-+-+-+-+
|                                                                                 |
+ + + +-+-+-+ + +-+-+ + + + + +-+ + +-+ + + + +-+ + +-+-+-+-+-+-+-+-+ +-+-+ + +-+ +
| | |       | |     | | | | |   | |   | | | |   | |                 |     | |   | |
+ +-+ +-+ +-+ + + +-+-+-+-+ +-+-+-+ +-+-+ + +-+ +-+-+ + +-+ + + + + + + + +-+-+-+ +
|   |   |   | | |         |       |     | |   |     | |   | | | | | | | |       | |
+ + +-+-+-+-+ +-+ + +-+ +-+-+ + + +-+ +-+-+ +-+ + + +-+-+-+ +-+-+-+ + + + + + +-+ +
| |         |   | |   |     | | |   |     |   | | |       |       | | | | | |   | |
+ + +-+ + + + + +-+-+-+ + + + + +-+-+ + + +-+ +-+-+ +-+ + +-+ + + + + + + + + +-+-+
| |   | | | | |       | | | | |     | | |   |     |   | |   | | | | | | | | |     |
+ + + + +-+ + +-+ + + + +-+-+ + +-+-+ + +-+ +-+ + +-+-+-+-+-+ +-+ + +-+ +-+-+ +-+ +
| | | |   | |   | | | |     | |     | |   |   | |           |   | |   |     |   | |
+ +-+ +-+-+-+-+-+-+ +-+-+-+ +-+ + +-+ +-+-+-+ +-+-+ + + + + + + +-+ +-+-+ +-+-+-+-+
|   |             |       |   | |   |       |     | | | | | | |   |     |         |
+ + + + +-+-+ + + +-+ +-+ + +-+ +-+ + +-+ +-+-+-+-+-+-+ +-+ +-+ + + +-+-+-+-+-+ +-+
| | | |     | | |   |   | |   |   | |   |             |   |   | | |           |   |
+ +-+-+-+-+-+-+-+-+ +-+ +-+ +-+ + +-+ + + + + +-+-+ + +-+ + + + + + +-+-+ +-+ + +-+
|                 |   |   |   | |   | | | | |     | |   | | | | | |     |   | |   |
+ +-+ + + +-+ +-+ +-+ +-+-+ + +-+ +-+-+-+ +-+-+-+-+ + + +-+-+ +-+-+-+-+ +-+-+ +-+-+
|   | | |   |   |   |     | |   |       |         | | |     |         |     |     |
+ +-+-+ + +-+ + +-+-+ + +-+-+ +-+-+-+ + + + +-+ +-+ + + +-+-+-+-+-+ +-+-+-+ +-+-+ +
|     | |   | |     | |     |       | | | |   |   | | |           |       |     | |
+ +-+-+ + +-+ + + +-+-+ +-+-+ + +-+ +-+-+ + +-+ +-+-+-+ + +-+-+ + + +-+-+ + +-+ + +
|     | |   | | |     |     | |   |     | |   |       | |     | | |     | |   | | |
+ +-+-+ + + + + + +-+-+-+ + +-+-+-+-+-+-+-+ +-+-+ + +-+-+ +-+ + +-+ +-+-+ +-+ + +-+
|     | | | | | |       | |               |     | |     |   | |   |     |   | |   |
+ + + + +-+-+ + + +-+-+ + + +-+-+ + +-+-+ +-+-+ +-+ + +-+ +-+ +-+ +-+ +-+-+-+-+-+ +
| | | |     | | |     | | |     | |     |     |   | |   |   |   |   |           | |
+ + +-+ + + + +-+-+-+ +-+-+-+ +-+-+ + +-+ +-+-+-+-+-+ +-+-+ + +-+-+ +-+ + + + + + +
| |   | | | |       |       |     | |   |           |     | |     |   | | | | | | |
+ + + + + + +-+-+-+ + + + +-+ +-+ + +-+ +-+ +-+-+-+ + + +-+ + +-+-+ +-+ +-+-+-+ +-+
| | | | | |       | | | |   |   | |   |   |       | | |   | |     |   |       |   |
+ +-+ +-+ +-+-+-+-+ + +-+-+ + +-+ +-+ +-+ + +-+ +-+-+-+ +-+-+ + +-+ +-+-+-+ + +-+ +
|   |   |         | |     | |   |   |   | |   |       |     | |   |       | |   | |
+ +-+-+ +-+-+-+ +-+ +-+ + + + +-+ + +-+ +-+ + +-+ +-+ + + +-+ +-+-+ + +-+-+ + + +-+
|     |       |   |   | | | |   | |   |   | |   |   | | |   |     | |     | | |   |
+ + +-+-+-+ + +-+-+ +-+ +-+-+ + +-+-+-+-+ +-+-+-+ +-+ +-+-+ + + +-+-+ + + +-+-+ +-+
| |       | |     |   |     | |         |       |   |     | | |     | | |     |   |
+ + + + +-+-+-+-+ +-+-+-+-+ +-+ +-+ +-+ +-+ + +-+ + + +-+ +-+-+ +-+ +-+-+-+ + + +-+
| | | |         |         |   |   |   |   | |   | | |   |     |   |       | | |   |
+ + +-+-+-+ +-+-+-+ +-+-+ +-+-+ + + + + +-+-+ +-+ +-+-+ +-+-+ +-+ + + + + +-+ + + +
| |       |       |     |     | | | | |     |   |     |     |   | | | | |   | | | |
+ + +-+ +-+ +-+ + + +-+-+-+ +-+-+-+ +-+ +-+-+ +-+ + +-+-+-+ + + +-+ +-+ + +-+-+ + +
| |   |   |   | | |       |       |   |     |   | |       | | |   |   | |     | | |
+ +-+-+ +-+-+-+ +-+-+ + + + +-+ + + +-+-+ +-+ +-+ +-+ + +-+ +-+-+ + + +-+ + + +-+-+
|     |       |     | | | |   | | |     |   |   |   | |   |     | | |   | | |     |
+ +-+-+ +-+ + + + + + +-+ +-+ + +-+-+-+-+ +-+ +-+ + + + + + +-+-+-+-+-+-+ +-+ + +-+
|     |   | | | | | |   |   | |         |   |   | | | | | |             |   | |   |
+ +-+-+ +-+ + +-+-+ +-+ + +-+ +-+-+-+ + +-+-+-+ + + +-+ + + +-+-+-+-+ + + + + +-+-+
|     |   | |     |   | |   |       | |       | | |   | | |         | | | | |     |
+ + +-+-+-+ + +-+ + + +-+ + + + + + + + +-+ +-+-+ + +-+ +-+-+-+ +-+ + + +-+-+ +-+ +
| |       | |   | | |   | | | | | | | |   |     | |   |       |   | | |     |   | |
+ +-+ + +-+ +-+ +-+ +-+-+ + +-+ +-+ + +-+-+-+-+-+-+-+ +-+ +-+ + +-+-+ +-+ + +-+ +-+
|   | |   |   |   |     | |   |   | |               |   |   | |     |   | |   |   |
+ + + + + +-+-+ + + +-+ + +-+ + +-+ + + + +-+-+-+-+ +-+ + +-+ + + +-+ +-+ +-+-+ + +
| | | | |     | | |   | |   | |   | | | |         |   | |   | | |   |   |     | | |
+ + +-+ + + +-+ + +-+ + + +-+ + + + +-+-+-+-+-+-+ +-+-+ + + + + +-+-+ +-+-+-+ +-+ +
| |   | | |   | |   | | |   | | | |             |     | | | | |     |       |   | |
+ + +-+ + +-+-+-+ + +-+ + +-+ +-+-+-+ + +-+ + + + + + + +-+ +-+-+ +-+ + + + +-+ + +
| |   | |       | |   | |   |       | |   | | | | | | |   |     |   | | | |   | | |
+ +-+-+ +-+-+ + +-+-+ +-+ + + + + + + + + +-+ + +-+-+-+-+ + +-+-+ + + + + +-+ +-+-+
|     |     | |     |   | | | | | | | | |   | |         | |     | | | | |   |     |
+ +-+ + + +-+ + +-+ +-+-+ + + + + + +-+-+-+-+-+ +-+-+ + +-+ +-+-+-+ +-+-+-+ + + + +
|   | | |   | |   |     | | | | | |           |     | |   |       |       | | | | |
+ + + + +-+ +-+ + +-+-+ + + + +-+ +-+-+-+ +-+-+-+ + + + + +-+ + +-+ + + + + +-+ +-+
| | | |   |   | |     | | | |   |       |       | | | | |   | |   | | | | |   |   |
+ + + + + +-+-+ +-+-+ +-+ + + + +-+ + + +-+-+-+-+-+-+-+ +-+-+ + + +-+ +-+ + +-+-+ +
| | | | |     |     |   | | | |   | | |               |     | | |   |   | |     | |
+ +-+-+ + +-+-+ +-+-+-+ + + +-+ +-+ + +-+ + + + +-+ + + +-+-+ + + + + +-+-+-+ + +-+
|     | |     |       | | |   |   | |   | | | |   | | |     | | | | |       | |   |
+ +-+-+-+ + + +-+ +-+ +-+-+-+-+ +-+-+ + + + +-+-+ +-+-+ + + +-+-+-+-+ +-+ +-+ + +-+
|       | | |   |   |         |     | | | |     |     | | |         |   |   | |   |
+ +-+ +-+ +-+-+ +-+ +-+ +-+ +-+ + + + +-+ +-+ + + +-+ + + +-+-+-+ + + +-+-+ +-+-+-+
|   |   |     |   |   |   |   | | | |   |   | | |   | | |       | | |     |       |
+ +-+ +-+ + +-+-+-+-+ + + +-+ + + +-+ + +-+-+ + +-+ +-+ +-+ +-+ +-+ +-+-+-+-+-+ + +
|   |   | |         | | |   | | |   | |     | |   |   |   |   |   |           | | |
+ + + + +-+-+ +-+ +-+ + + +-+-+-+ +-+ + + +-+-+-+ +-+ + + + +-+ + + + +-+-+-+ +-+-+
| | | |     |   |   | | |       |   | | |       |   | | | |   | | | |       |     |
+ +-+-+ + + +-+ + +-+ +-+ +-+ + + +-+-+ +-+-+ +-+ + +-+-+-+-+-+ +-+ +-+ +-+ +-+ +-+
|     | | |   | |   |   |   | | |     |     |   | |           |   |   |   |   |   |
+ +-+ +-+-+-+-+ +-+-+-+-+-+-+ +-+ +-+-+ + + + +-+ +-+ + + + + + + +-+ +-+-+ +-+ +-+
|   |         |             |   |     | | | |   |   | | | | | | |   |     |   |   |
+-+-+-+-+-+-+-+-+-+-+-+-+-+-+-+-+-+-+-+-+-+-+-+-+-+-+-+-+-+-+-+-+-+-+-+-+-+-+-+-+-+