+-+-+-+-+-+-+-+-+-+-+-+-+-+-+-+-+-+-+-+-+-+
|                                         |
+ +-+-+ + + + + + +-+ + + + + + +-+ + + +-+
|   |   | | | | |   | | | | | | |   | |   |
+ +-+ +-+ + + +-+ + + + + + +-+-+ + + +-+-+
|   | |   | | |   | | | | |   |   | |     |
+ + +-+ +-+-+-+-+-+ + +-+-+ +-+ +-+ + +-+ +
| |   |       |     |     | |   |   |   | |
+ + + +-+ + + + +-+ + +-+-+-+ +-+ +-+ + + +
| | | |   | | | |   |       | |     | | | |
+-+ +-+ + + +-+-+ + + +-+-+ + + + + + + + +
|     | | | |     | |   |   | | | | | | | |
+ + +-+-+-+ + +-+ +-+ +-+-+ + +-+ + +-+ + +
| |       | |   |   |     | | |   |   | | |
+ + + +-+ + +-+ + + + +-+ + + +-+-+-+-+ + +
| | |   | |   | | | |   | | |         | | |
+ + + +-+ +-+ + + + +-+ + +-+ + + + + + + +
| | |   | |   | | | |   |   | | | | | | | |
+ + + + + + + +-+ + + + + + + + + + + +-+ +
| | | | | | | |   | | | | | | | | | | |   |
+ +-+-+-+ + + + +-+ + + + +-+ + + + + +-+-+
|     |   | | |   | | | |   | | | | |     |
+ + + +-+ +-+-+-+ + +-+-+-+ + + +-+ + + + +
| | | |         | |       | | | |   | | | |
+ + + + + + +-+-+ +-+ + +-+-+ + + + + + + +
| | | | | | |       | | |     | | | | | | |
+ +-+-+ +-+-+ +-+ +-+ + +-+ +-+-+ + + + + +
|     | |     |     | |   |     | | | | | |
+-+ + + + + +-+ + + + + + + + + + + + + + +
|   | | | |   | | | | | | | | | | | | | | |
+ +-+-+ + + + + + + + + + +-+ + + + + + + +
|   |   | | | | | | | | | |   | | | | | | |
+ + +-+ + + + +-+-+ +-+ + +-+ +-+ +-+-+ + +
| |   | | | | |     |   |   |   |     | | |
+-+-+ + +-+-+-+ +-+-+ + + + + + +-+ + + + +
|     | |           | | | | | |   | | | | |
+-+ + +-+-+ + + + + +-+-+ +-+ +-+-+ + +-+ +
|   | |     | | | | |       | |     |   | |
+ + + + + + +-+ + + + + + +-+ + +-+ + + + +
| | | | | | |   | | | | | |   | |   | | | |
+ + +-+ + + + +-+ +-+ + + + + +-+ + +-+-+-+
| | |   | | | |     | | | | | |   |       |
+-+-+-+-+-+-+-+-+-+-+-+-+-+-+-+-+-+-+-+-+-+