+-+-+-+-+-+-+-+-+-+-+-+-+-+-+-+-+-+-+-+-+-+-+-+-+-+-+-+-+-+-+-+-+-+-+-+-+-+-+-+-+-+
|   |   |   |       |     |       |   | | |     |   | |                 | | |     |
+-+ + + +-+ +-+-+-+ +-+-+ + +-+ +-+-+ + + +-+ + +-+ + + +-+ +-+ +-+-+-+ + + +-+-+ +
| |   |     | |   |   |       |     | |   |   | |     | |   | |   |           |   |
+ +-+-+-+-+ + +-+ + +-+-+ +-+-+-+ +-+ + + + +-+-+-+ + +-+ +-+ + + +-+-+-+-+-+-+ +-+
|           |           | |   |         |   | |     |   |     | |   | | |   |   | |
+ +-+ +-+ + +-+ + +-+ + + + +-+-+ +-+ +-+-+ + + + + +-+-+-+-+-+ + +-+ + + + +-+ + +
| |   | | |     | | | |       |   |       |   | | | | |         |   |     |       |
+-+-+ + + +-+ +-+ + +-+-+-+-+-+-+-+-+-+-+-+ +-+ +-+-+ +-+ +-+-+-+-+-+-+ +-+-+ + + +
|   | | | |     |     |   |     | |     |           |           |       | |   | | |
+ +-+ + +-+-+-+-+ +-+-+ +-+-+ +-+ +-+ +-+ + +-+-+-+ + +-+-+ +-+-+-+ +-+ + + + +-+ +
| |     |         | |       |   | |   | | | | | |   |     | |   |     | |   | |   |
+ +-+ +-+ +-+-+ +-+ +-+ +-+ + + + +-+ + +-+-+ + + + +-+ +-+ + +-+ + +-+-+-+ +-+-+ +
|       |   | | | |     |   | | | |     |     |   |     |   | | | | | | | | | |   |
+ +-+ +-+ +-+ + + +-+-+-+ + + + + +-+-+ +-+-+ +-+-+-+-+-+ +-+ + + + + + + + + +-+-+
| |   |     |       | |   | | |       | |       |   | | |     |   | | |     |   | |
+ + +-+-+ +-+-+-+ +-+ + + +-+ + +-+-+ + +-+ + +-+-+ + + + +-+-+ +-+-+ +-+-+ + + + +
| | | |   |     | | |   |     | |   | |   | |     |                     |   | |   |
+-+ + +-+-+-+ +-+ + +-+-+ +-+ +-+ +-+ +-+ +-+-+ + +-+-+ + +-+-+ +-+ +-+-+ + +-+ +-+
| | | |         | | |     |   | |     |         |       |     | | |   | | | | |   |
+ +-+ + + +-+-+ +-+ +-+ +-+-+-+ + + + +-+ +-+ +-+ + +-+-+-+-+ + + + + + +-+-+ +-+ +
|       |     |       | | |   | | | |     |   | | |   | |   | |   | |         |   |
+ + +-+-+-+ +-+ +-+ +-+ + + +-+ +-+-+-+ + + +-+ +-+ + + + +-+-+-+-+-+ +-+ + +-+-+ +
| | |   |   | |   |   |     |     |     | | | |     |   |     |     |   | |   | | |
+-+ +-+ + +-+ + +-+ +-+-+-+-+-+ + +-+-+ +-+-+ +-+-+ +-+ +-+ + + +-+-+-+-+-+ +-+ + +
|   |     |   |   |         | | | |     | | |         | |   |       |   | |       |
+-+ +-+-+ + +-+-+-+-+ +-+-+-+ + +-+ + +-+ + +-+-+-+-+-+ + +-+ +-+-+ +-+ + + +-+-+-+
| | |   |     |   |   |   | | |   | |       |       | | |   |   | |   |   |   |   |
+ +-+ + + +-+ + +-+-+ + +-+ + + +-+-+-+-+ + + + + +-+ +-+-+ +-+-+ +-+ + +-+ + + +-+
| | | |   |   |             |     |   | | | | | |       | |     |     | |   |     |
+ + +-+ +-+-+-+-+-+ + +-+ +-+ +-+-+ + + +-+ +-+ + +-+ + + +-+ +-+-+-+ + + +-+-+-+ +
| |       |         | |     |   |   |   |   | | |   | |   | | | | | |       | |   |
+ +-+ +-+-+-+-+-+ +-+-+-+ + + +-+-+ +-+-+ +-+ +-+-+ +-+-+ + +-+ + + +-+ +-+-+ + +-+
| |       |     |   |   | | |     | |     |         |     |   | |           |     |
+ +-+ +-+-+-+ +-+ + +-+ +-+ +-+ +-+ +-+-+ + +-+-+-+ +-+ +-+ +-+ + +-+-+ + +-+-+ +-+
| |   | |   |     | | | |     | | | |     | |   |   |   | | | | |   | | |     |   |
+ +-+ + + +-+ +-+-+-+ + + +-+ + + + + + +-+ +-+ +-+-+-+ + + + + +-+ + +-+ +-+-+-+-+
|     |     |       |       |       | |           |     |   |     |   | |   |     |
+-+ +-+-+-+ + + +-+ + + + +-+-+ +-+-+ +-+-+ +-+ +-+-+-+-+-+ + + +-+ +-+ + + +-+ +-+
| |     |     |   | | | |     |     | |       | | |           | | | |     |     | |
+ + +-+-+ + + +-+ + +-+-+ +-+-+ +-+ +-+-+-+-+ +-+ + +-+ + +-+ +-+ +-+-+ + + + + + +
|     | | | | |   | |   | | | |   |   | |           | | | | |         | | | | |   |
+-+ +-+ +-+ +-+-+-+-+ + +-+ + + + +-+-+ + +-+-+-+ +-+ +-+ + +-+ + + +-+ +-+ +-+ +-+
| |     | | |     | | | | |     | |       | |     |         | | | | |   | |   |   |
+ + + + + + +-+ +-+ + + + +-+ +-+ + +-+-+-+ + +-+ +-+-+ + +-+ +-+-+-+ + + +-+ +-+-+
| | | | |             |   |     |       | |     | | |   |     | | | | |   |     | |
+ + +-+ +-+-+ + +-+ + +-+ + + +-+ +-+-+-+ + +-+-+-+ + +-+-+ + + + + +-+-+-+-+ +-+ +
| |   | |     | | | |   | | |   | |       |         | | | | |     |     | | |     |
+ +-+ +-+ +-+-+-+ +-+-+-+-+-+ +-+-+ + +-+-+-+ +-+ +-+-+ + + + + +-+-+-+ + + +-+ + +
|     |   |                 | |     | |       |       |   | | |   | |       |   | |
+ +-+ +-+ + +-+ +-+ +-+-+-+-+-+ +-+-+-+-+ +-+ + +-+ + +-+ +-+-+-+-+ +-+-+ + + +-+-+
| | | |   | |   | | |   |     |   |     | |   | |   |     | | |     |     |       |
+-+ +-+ +-+ +-+ + + + +-+ + +-+ +-+ +-+-+ +-+-+-+-+-+-+ +-+ + + +-+-+ +-+-+-+ +-+ +
|           |   | | | | | |       |       |   |   |     |       |         |   |   |
+-+-+-+ +-+-+ +-+ + + + +-+ +-+-+-+-+-+-+-+-+ + +-+-+-+-+-+-+-+ + +-+ +-+ +-+ +-+ +
|   |   |   |   |                 |     |   |   |   |     | | | | | | |   |   | | |
+-+ +-+-+ +-+-+-+-+ + +-+-+-+ +-+ + +-+-+ + + + +-+ +-+ + + + + +-+ +-+-+ +-+-+ +-+
| | |       | |   | |       |   | | | |   |   | |   | | | |     |       | |       |
+ + + +-+-+ + + +-+-+ +-+-+-+-+-+-+ + +-+-+ +-+-+-+ + + +-+-+ +-+-+ + +-+ +-+-+ +-+
|   | |       |   |       |   |     |       |             |         | |     |   | |
+ + +-+ + +-+-+ + +-+ +-+-+ + +-+ +-+-+ + +-+ + +-+-+-+-+-+-+-+ +-+ +-+ + +-+ + + +
| |     |     | |       | | | |       | |   | |       |     |   |   | | |     |   |
+ + +-+-+-+-+ + +-+ +-+-+ + +-+-+-+ +-+-+ + +-+ +-+-+ + + +-+-+-+ +-+ + + + + +-+-+
| | |       | | |   |   |     |     |     |         |   |   |         | | | |     |
+ +-+-+-+-+ + +-+ +-+-+ + +-+-+-+ +-+-+-+ +-+-+-+ +-+ +-+-+ +-+ +-+-+-+-+-+ +-+ +-+
|   |     |       |       |     |       |   |     |   | |     |     |       |   | |
+-+-+ +-+ + + + +-+-+-+ +-+ + +-+ +-+-+ +-+ +-+-+ +-+-+ +-+-+-+ + +-+ + + +-+-+ + +
|     | |   | |   | |     | | |       | |       |         |   | | |   | |   |     |
+ +-+-+ + +-+-+ + + + + + + +-+-+ +-+-+ + + +-+ +-+-+ +-+-+ +-+ + + + +-+ +-+ +-+-+
| |           | | |   | |   |       |     |   |     |     |   | |   | | | |       |
+-+-+ +-+-+ + +-+-+-+ + + +-+ + +-+-+ +-+ +-+ +-+ +-+ +-+-+ +-+-+ +-+ + + + + + + +
|       |   |   |     | |   | | |     | | |     | |     |       |   |   | | | | | |
+-+-+-+-+-+ +-+-+ + +-+-+ +-+ +-+-+-+-+ + + +-+-+ +-+ + +-+-+ + + +-+-+-+ +-+-+-+ +
|             | | | |         |     |     | |   |   | |   |   | |       | | | | | |
+ + +-+-+ + +-+ + +-+-+-+-+-+ + +-+-+-+ +-+ + +-+-+ + +-+-+-+ +-+-+-+ + +-+ + + + +
| |   |   |   |       |       |   |       |   | |   | |       |   | | | | |     | |
+-+ +-+ +-+-+-+-+ +-+ +-+ + + + + + +-+-+ +-+-+ +-+-+ +-+-+-+ + +-+ +-+-+ +-+ +-+ +
| | | |             | |   | | | |       |   |     | |   |       |   |   |   |     |
+ + + +-+-+-+ +-+ +-+ +-+-+ + +-+-+ + +-+-+ + + +-+ +-+ + + +-+-+ + + + + + +-+-+ +
|     | |     |   |   | |   | |     |   |     | |   |     |   |   |   | | | |     |
+ + + + +-+ +-+ +-+-+-+ + + + +-+-+ + +-+-+-+ + +-+ + +-+-+ + +-+ +-+ + + + + +-+ +
| | |     | |         |   | |   |   | |       |   |       | |       | | | |   |   |
+-+-+-+-+-+-+-+-+-+-+-+-+-+-+-+-+-+-+-+-+-+-+-+-+-+-+-+-+-+-+-+-+-+-+-+-+-+-+-+-+-+