+-+-+-+-+-+-+-+-+-+-+-+-+-+-+-+-+-+-+-+-+-+-+-+-+-+-+-+-+-+-+-+-+-+-+-+-+-+-+-+-+-+-+-+-+-+-+-+-+
|                                                                                               |
+ + +-+ +-+ +-+ + + +-+ + + + +-+ +-+-+-+ + +-+ +-+ + + + +-+ +-+ +-+ + + + + +-+-+ +-+-+ + + +-+
| |   |   |   | | |   | | | |   |       | |   |   | | | |   |   |   | | | | |     |     | | |   |
+ + +-+ +-+ +-+ +-+-+-+ +-+-+-+ +-+ +-+-+-+ +-+-+-+ + + + +-+-+-+-+ + + + +-+-+-+-+ + +-+-+ +-+ +
| |   |   |   |       |       |   |       |       | | | |         | | | |         | |     |   | |
+ +-+ + +-+ +-+ + + + + + +-+ +-+ +-+ +-+-+ + + +-+ + +-+-+-+ + + +-+-+-+-+-+-+-+-+ +-+-+ +-+ + +
|   | |   |   | | | | | |   |   |   |     | | |   | |       | | |                 |     |   | | |
+ +-+-+-+ + +-+-+ +-+ +-+-+ + +-+-+ + + +-+-+ +-+-+ + + + +-+-+ +-+ + + +-+-+ + +-+ + + +-+ + + +
|       | |     |   |     | |     | | |     |     | | | |     |   | | |     | |   | | |   | | | |
+ +-+ +-+-+ + +-+ + +-+ +-+-+ +-+-+ + + + + + +-+-+-+-+-+ +-+ +-+ + + + + + +-+-+ + +-+-+-+ + + +
|   |     | |   | |   |     |     | | | | | |           |   |   | | | | | |     | |       | | | |
+ +-+ + +-+ +-+ + + +-+ + + + + +-+-+ +-+-+ + +-+-+ +-+ + + +-+-+-+ + +-+-+-+ +-+ + +-+ + + +-+-+
|   | |   |   | | |   | | | | |     |     | |     |   | | |       | |       |   | |   | | |     |
+ + + + + +-+-+-+ +-+ + +-+-+-+ +-+-+-+ +-+-+-+-+-+-+ +-+ +-+ + + + +-+ +-+ + +-+ + +-+ +-+ + + +
| | | | |       |   | |       |       |             |   |   | | | |   |   | |   | |   |   | | | |
+ +-+ + + + + +-+ +-+ + +-+ +-+ + + +-+-+-+-+-+ + +-+-+ + +-+-+-+ +-+ + +-+ + + +-+ +-+-+ + + + +
|   | | | | |   |   | |   |   | | |           | |     | |       |   | |   | | |   |     | | | | |
+ +-+-+ +-+ + + + +-+ + + +-+-+-+ +-+-+ +-+ +-+-+-+-+ +-+ +-+-+-+ +-+-+ + +-+ + + +-+-+-+ +-+ +-+
|     |   | | | |   | | |       |     |   |         |   |       |     | |   | | |       |   |   |
+ + + + + +-+-+-+ +-+-+ +-+ + +-+ + + + +-+-+ + + + +-+-+-+-+ +-+-+-+-+-+ + +-+ + +-+-+-+ + + + +
| | | | |       |     |   | |   | | | |     | | | |         |           | |   | |       | | | | |
+ + +-+ +-+ + +-+ + + + + +-+-+-+ +-+-+ +-+-+-+ + + +-+ +-+-+-+-+ + +-+-+-+-+-+-+-+ +-+-+-+-+ +-+
| |   |   | |   | | | | |       |     |       | | |   |         | |               |         |   |
+ + + +-+ + + + +-+-+-+-+ + +-+ + +-+-+-+-+-+-+ + + + + +-+-+-+-+-+ + +-+ +-+-+ + + +-+ +-+-+-+ +
| | |   | | | |         | |   | |             | | | | |           | |   |     | | |   |       | |
+ +-+ + +-+ + + + +-+-+-+ +-+-+-+-+ +-+-+ +-+ + + +-+-+ +-+ + +-+-+ +-+ +-+-+ +-+-+-+ + +-+ +-+-+
|   | |   | | | |       |         |     |   | | |     |   | |     |   |     |       | |   |     |
+ +-+ +-+ +-+-+-+ +-+ +-+-+-+-+ + + +-+ + + + + + + + + + + + + + + +-+-+-+ +-+-+ +-+-+ +-+ + + +
|   |   |       |   |         | | |   | | | | | | | | | | | | | | |       |     |     |   | | | |
+ + + + +-+-+ +-+ +-+-+-+ +-+-+-+-+ + +-+ + +-+-+-+ + +-+ +-+ +-+ + +-+ + +-+-+-+ +-+-+ +-+-+-+-+
| | | |     |   |       |         | |   | |       | |   |   |   | |   | |       |     |         |
+ + +-+ + + + +-+ +-+-+ +-+-+ + +-+-+-+-+-+-+-+-+-+ + +-+ +-+ + +-+-+ +-+-+ +-+ +-+-+ +-+-+-+-+ +
| |   | | | |   |     |     | |                   | |   |   | |     |     |   |     |         | |
+ +-+-+-+ +-+ +-+-+-+ +-+-+ +-+ +-+-+-+ + +-+ +-+ + +-+-+-+ +-+ +-+-+-+ + + +-+-+-+-+-+-+ + +-+ +
|       |   |       |     |   |       | |   |   | |       |   |       | | |             | |   | |
+ +-+-+ + + + +-+ +-+ +-+-+ +-+-+-+ +-+ + +-+ + + + + +-+ +-+ +-+ + +-+-+-+-+ + +-+-+ +-+-+-+ +-+
|     | | | |   |   |     |       |   | |   | | | | |   |   |   | |         | |     |       |   |
+ +-+-+ + + +-+ +-+-+ +-+-+-+ + + +-+-+-+-+ +-+ + + + +-+ +-+-+-+ + + +-+ +-+-+ + + +-+ +-+-+-+ +
|     | | |   |     |       | | |         |   | | | |   |       | | |   |     | | |   |       | |
+ + +-+-+ + +-+-+ +-+-+-+-+ +-+ +-+ +-+ +-+-+ +-+ +-+-+-+ + +-+-+ + + + + + +-+ +-+ + +-+ + + +-+
| |     | |     |         |   |   |   |     |   |       | |     | | | | | |   |   | |   | | |   |
+ + + + + +-+ +-+-+ + + + +-+-+ +-+ +-+-+-+-+ + + + + +-+-+ +-+ +-+-+-+-+ +-+ + + +-+-+ +-+-+ +-+
| | | | |   |     | | | |     |   |         | | | | |     |   |         |   | | |     |     |   |
+ + +-+ + + +-+ + +-+ +-+ + + +-+-+-+-+-+ +-+-+-+ + + +-+-+-+ + +-+ +-+ +-+-+-+ + +-+-+ +-+ + +-+
| |   | | |   | |   |   | | |           |       | | |       | |   |   |       | |     |   | |   |
+ +-+-+-+-+-+ +-+ +-+ + + +-+ +-+-+-+ + +-+ + +-+-+-+ +-+ + +-+-+-+-+ + + +-+-+-+ +-+ +-+ + +-+-+
|           |   |   | | |   |       | |   | |       |   | |         | | |       |   |   | |     |
+ + + +-+ +-+ +-+-+ + +-+-+ + + + +-+ + + + + + +-+ + +-+ + + + + + + +-+-+ +-+ + +-+ +-+ + + +-+
| | |   |   |     | |     | | | |   | | | | | |   | |   | | | | | | |     |   | |   |   | | |   |
+ + + +-+-+ + + +-+ +-+-+-+ +-+-+-+ + +-+-+ + +-+ +-+-+ + +-+-+-+ + + +-+ + + +-+-+-+-+ +-+-+-+-+
| | |     | | |   |       |       | |     | |   |     | |       | | |   | | |         |         |
+ +-+-+ + +-+-+ + +-+ + + +-+-+ + + +-+-+-+ + + + + +-+-+ +-+-+-+ +-+ + + +-+-+ + +-+-+ + + + + +
|     | |     | |   | | |     | | |       | | | | |     |       |   | | |     | |     | | | | | |
+ +-+-+-+-+-+-+-+ + + + +-+-+-+-+ + + +-+-+ + + +-+-+ + +-+-+-+-+-+-+-+ + + +-+-+-+ +-+ + +-+-+ +
|               | | | |         | | |     | | |     | |               | | |       |   | |     | |
+ +-+-+-+ +-+ + +-+ + + +-+-+ + +-+-+-+-+-+ +-+-+ + + + + + +-+ +-+ +-+ + +-+-+ +-+-+ +-+-+-+-+-+
|       |   | |   | | |     | |           |     | | | | | |   |   |   | |     |     |           |
+ + +-+ +-+ +-+ +-+-+-+ +-+ + + +-+ +-+-+ + + +-+ + +-+-+ +-+ +-+ + +-+-+-+ +-+-+-+-+-+-+ + + + +
| |   |   |   |       |   | | |   |     | | |   | |     |   |   | |       |             | | | | |
+ +-+-+-+-+ +-+-+ + +-+-+-+-+ +-+-+-+ + + + +-+ + +-+ + + +-+ + + +-+-+-+-+-+-+-+-+ +-+ +-+-+-+ +
|         |     | |         |       | | | |   | |   | | |   | | |                 |   |       | |
+ +-+ +-+ + + +-+-+-+-+-+ + +-+-+ +-+ +-+-+ +-+ + +-+ +-+ +-+-+-+ + +-+ + + +-+ + +-+ + +-+ +-+ +
|   |   | | |           | |     |   |     |   | |   |   |       | |   | | |   | |   | |   |   | |
+ + + + + + +-+ + + + + + +-+-+-+ + + + + + +-+ + +-+-+-+ + +-+ + + +-+ +-+-+-+-+-+-+-+ +-+ + + +
| | | | | |   | | | | | |       | | | | | |   | |       | |   | | |   |               |   | | | |
+ + + + + + + +-+ +-+-+-+-+-+ +-+ +-+-+-+ + +-+-+-+-+ +-+ +-+-+ + +-+ +-+-+ + + +-+ + +-+ + + +-+
| | | | | | |   |           |   |       | |         |   |     | |   |     | | |   | |   | | |   |
+ +-+ + +-+-+ + + + +-+-+-+ +-+-+-+-+-+ + + +-+-+ +-+ + + +-+ +-+ + + + + + +-+ + + +-+-+ + +-+ +
|   | |     | | | |       |           | | |     |   | | |   |   | | | | | |   | | |     | |   | |
+ + +-+ +-+ +-+-+ +-+-+ + + + +-+-+ + +-+-+-+-+-+-+-+-+ + +-+ + + +-+ +-+-+-+ +-+-+-+ +-+-+-+-+-+
| |   |   |     |     | | | |     | |                 | |   | | |   |       |       |           |
+ +-+ + + +-+-+-+ +-+-+ +-+ + +-+-+-+ + +-+-+-+-+ + +-+ + + + + +-+ +-+-+ + + +-+ + +-+-+ +-+-+ +
|   | | |       |     |   | |       | |         | |   | | | | |   |     | | |   | |     |     | |
+ +-+-+ + + +-+ +-+ +-+-+ +-+-+-+ + +-+ + + +-+ +-+ +-+ + +-+-+-+ + +-+-+ +-+ + +-+ + +-+ +-+-+ +
|     | | |   |   |     |       | |   | | |   |   |   | |       | |     |   | |   | |   |     | |
+ +-+-+ + +-+ +-+ +-+-+-+-+ + + + + +-+-+ +-+ + + + +-+ + + +-+-+-+-+-+ + +-+ + + + + + + + +-+-+
|     | |   |   |         | | | | |     |   | | | |   | | |           | |   | | | | | | | |     |
+ +-+ +-+ +-+-+-+ + + +-+-+ +-+ + +-+-+ +-+ + + + + +-+ +-+-+ + +-+-+-+ + + + + +-+ +-+-+-+ +-+ +
|   |   |       | | |     |   | |     |   | | | | |   |     | |       | | | | |   |       |   | |
+ +-+-+ +-+-+-+ +-+ +-+ + +-+-+ +-+-+ + + + + + +-+-+-+ +-+-+-+ +-+-+ + +-+-+-+-+-+ + +-+ + + + +
|     |       |   |   | |     |     | | | | | |       |       |     | |           | |   | | | | |
+ +-+-+ +-+ +-+-+ + +-+-+ + +-+-+-+-+-+-+-+ + + + + + + +-+ + +-+-+ + + + + + +-+ +-+ +-+ +-+-+ +
|     |   |     | |     | |               | | | | | | |   | |     | | | | | |   |   |   |     | |
+ +-+ + + +-+ + +-+ +-+ + +-+ + + + + + + + + + +-+-+ +-+-+-+-+ +-+-+ + + + + + + + +-+-+-+-+ +-+
|   | | |   | |   |   | |   | | | | | | | | | |     |         |     | | | | | | | |         |   |
+ + + +-+-+-+-+-+ + + +-+-+-+ +-+ +-+ +-+ + + + +-+-+ + + +-+-+ +-+-+-+ +-+ + +-+-+ +-+-+-+ + + +
| | |           | | |       |   |   |   | | | |     | | |     |       |   | |     |       | | | |
+ + +-+-+ +-+-+ + + + +-+-+-+-+-+ +-+-+-+ +-+ + +-+ +-+-+-+ +-+ +-+ +-+-+-+ + +-+ +-+-+-+-+ + + +
| |     |     | | | |           |       |   | |   |       |   |   |       | |   |         | | | |
+ + +-+ + +-+ + + +-+ + +-+ +-+ + + + +-+-+-+-+ + +-+-+-+-+ +-+ + +-+-+-+ + + + +-+ + + + + + +-+
| |   | |   | | |   | |   |   | | | |         | |         |   | |       | | | |   | | | | | |   |
+ +-+-+-+-+-+-+ + +-+ + +-+ +-+-+ + + + + +-+-+ + + + +-+-+ + + +-+-+-+-+ +-+ +-+ +-+ +-+ +-+ + +
|             | |   | |   |     | | | | |     | | | |     | | |         |   |   |   |   |   | | |
+ + + +-+ +-+ + + +-+ + + + +-+ +-+-+-+-+-+-+ + + +-+-+ +-+ +-+ +-+-+-+ + + +-+ +-+ + +-+-+-+-+-+
| | |   |   | | |   | | | |   |             | | |     |   |   |       | | |   |   | |           |
+-+-+-+-+-+-+-+-+-+-+-+-+-+-+-+-+-+-+-+-+-+-+-+-+-+-+-+-+-+-+-+-+-+-+-+-+-+-+-+-+-+-+-+-+-+-+-+-+