+-+-+-+-+-+-+-+
|   |   |     |
+ + + +-+-+-+ +
| |       |   |
+-+ + +-+-+-+ +
|   |   | |   |
+ +-+ +-+ +-+ +
| | | |       |
+-+ + +-+ +-+-+
| | |   |   | |
+ + +-+ + +-+ +
| |     |     |
+ +-+ + + + +-+
|     |   |   |
+-+-+-+-+-+-+-+