+-+-+-+-+-+-+-+-+-+-+-+-+
|*|*****| | |   |       |
+*+*+-+*+ + +-+ + +-+-+-+
|*|*|  *|     |   |     |
+*+*+-+*+ +-+-+ +-+ +-+ +
|***|  ***|     |   | | |
+ +-+ +-+*+ +-+ +-+ + + +
| | |   |*  |         | |
+-+ +-+-+*+ + +-+ +-+-+ +
|   |   |*| |   |   |   |
+ + +-+ +*+ +-+-+-+ + +-+
| | |*****| |   |   |   |
+ +-+*+-+-+-+ +-+-+-+-+-+
|   |*****| | | |   | | |
+ + +-+-+*+ + + +-+ + + +
| | | | |*|   |         |
+ + + + +*+ +-+-+ +-+-+-+
| |      ***|***  | |   |
+ +-+-+ +-+*+*+*+-+ + + +
| |     | |*|*|*****| | |
+-+-+-+ + +*+*+ +-+*+ +-+
|       | |*|*| |  *****|
+ + +-+ + +*+*+ +-+ + +*+
| |   | |  ***| |   | |*|
+-+-+-+-+-+-+-+-+-+-+-+-+