+-+-+-+-+-+-+-+-+-+-+-+-+-+-+-+-+-+-+-+-+-+-+-+-+-+
|     |.|.|.|.|.|     |       |         |.|.|.|.|.|
+-+-+ +-+-+-+-+-+ +-+ + +-+-+ +-+-+ +-+ +-+-+-+-+-+
|.|.|   |.|.|.|.|   |   |   |     | |.| |.|.|.|.|.|
+-+-+-+ +-+-+-+-+-+ +-+-+-+ +-+-+ + +-+ +-+-+-+-+-+
|.|   | |.|.|.|.|   |           |   |.| |.|.|.|.|.|
+-+ + + +-+-+-+-+ +-+ +-+-+-+-+-+-+-+-+ +-+-+-+-+-+
|.| |   |.|.|.|.|   |       |   |.|.|.| |.|.|.|.|.|
+-+ +-+-+-+-+-+-+-+ + +-+-+ + + +-+-+-+ +-+-+-+-+-+
|.| |.|.|.|   |.|   | |.|.|   |         |.|.|.|.|.|
+-+ +-+-+-+ + +-+ +-+ +-+-+-+-+-+-+-+-+-+-+-+-+-+-+
|.|   |.|.| |     |.|     |.|.|.|.|.|.|.|.|.|.|.|.|
+-+-+ +-+-+ +-+-+-+-+-+-+ +-+-+-+-+-+-+-+-+-+-+-+-+
|.|.| |.|.| |.|.|.|.|.|.| |.|.|.|.|.|.|.|.|.|.|.|.|
+-+-+ +-+-+ +-+-+-+-+-+-+ +-+-+-+-+-+-+-+-+-+-+-+-+
|.|.|   |   |.|.|.|     | |.|.|.|.|.|.|.|.|.|.|.|.|
+-+-+-+ + +-+-+-+-+ +-+ + +-+-+-+-+-+-+-+-+-+-+-+-+
|.|.|.|   |.|.|.|.|   |   |.|   |.|.|.|.|.|.|.|.|.|
+-+-+-+-+-+-+-+-+-+-+ +-+-+-+ + +-+-+-+-+-+-+-+-+-+
|.|.|.|.|.|.|.|.|   | |     | |   |.|   |.|.|.|.|.|
+-+-+-+-+-+-+-+-+ + + + + +-+ +-+ +-+ + +-+-+-+-+-+
|.|.|.|.|.|.|.|.| | | | |   | | |     | |.|.|.|.|.|
+-+-+-+-+-+-+-+-+ + + +-+-+ + + +-+-+-+ +-+-+-+-+-+
|.|.|.|.|.|.|.|.| |   |   |           | |.|.|.|.|.|
+-+-+-+-+-+-+-+-+ +-+-+ + +-+-+-+-+-+ + +-+-+-+-+-+
|.|.|.|.|.|.|.|.|       |     |     | | |.|.|.|.|.|
+-+-+-+-+-+-+-+-+-+-+-+-+-+-+ + +-+ + + +-+-+-+-+-+
|.|.|.|.|.|.|.|.|.|.|.|.|.|.| |   | | |   |.|.|.|.|
+-+-+-+-+-+-+-+-+-+-+-+-+-+-+ + + +-+ +-+ +-+-+-+-+
|.|.|.|.|.|.|.|.|.|.|.|.|.|.| | | |     | |.|.|.|.|
+-+-+-+-+-+-+-+-+-+-+-+-+-+-+ + + + +-+-+ +-+-+-+-+
|.|.|.|.|.|.|.|.|.|.|.|.|.|   | |   |     |.|.|.|.|
+-+-+-+-+-+-+-+-+-+-+-+-+-+ +-+ +-+-+ +-+-+-+-+-+-+
|.|.|.|.|.|.|.|.|.|.|.|.|.| |     |   |.|.|.|.|.|.|
+-+-+-+-+-+-+-+-+-+-+-+-+-+ +-+-+-+ +-+-+-+-+-+-+-+
|.|.|.|.|.|.|.|.|.|.|.|.|.|     |   |.|.|.|.|.|.|.|
+-+-+-+-+-+-+-+-+-+-+-+-+-+-+-+ + +-+-+-+-+-+-+-+-+
|.|.|.|.|.|.|.|.|.|.|.|.|.|.|.|   |.|.|.|.|.|.|.|.|
+-+-+-+-+-+-+-+-+-+-+-+-+-+-+-+-+-+-+-+-+-+-+-+-+-+
|.|.|.|.|.|.|.|.|.|.|.|.|.|.|.|.|.|.|.|.|.|.|.|.|.|
+-+-+-+-+-+-+-+-+-+-+-+-+-+-+-+-+-+-+-+-+-+-+-+-+-+
|.|.|.|.|.|.|.|.|.|.|.|.|.|.|.|.|.|.|.|.|.|.|.|.|.|
+-+-+-+-+-+-+-+-+-+-+-+-+-+-+-+-+-+-+-+-+-+-+-+-+-+
|.|.|.|.|.|.|.|.|.|.|.|.|.|.|.|.|.|.|.|.|.|.|.|.|.|
+-+-+-+-+-+-+-+-+-+-+-+-+-+-+-+-+-+-+-+-+-+-+-+-+-+
|.|.|.|.|.|.|.|.|.|.|.|.|.|.|.|.|.|.|.|.|.|.|.|.|.|
+-+-+-+-+-+-+-+-+-+-+-+-+-+-+-+-+-+-+-+-+-+-+-+-+-+
|.|.|.|.|.|.|.|.|.|.|.|.|.|.|.|.|.|.|.|.|.|.|.|.|.|
+-+-+-+-+-+-+-+-+-+-+-+-+-+-+-+-+-+-+-+-+-+-+-+-+-+
|.|.|.|.|.|.|.|.|.|.|.|.|.|.|.|.|.|.|.|.|.|.|.|.|.|
+-+-+-+-+-+-+-+-+-+-+-+-+-+-+-+-+-+-+-+-+-+-+-+-+-+