+-+-+-+-+-+
|     |   |
+-+-+ + + +
|   |   | |
+ +-+ +-+-+
|         |
+-+-+-+ + +
|       | |
+ + + +-+-+
| | |     |
+-+-+-+-+-+