+-+-+-+-+-+
| |   |   |
+ + + +-+ +
| | |     |
+ + +-+-+ +
| |     | |
+ +-+-+ + +
| |     | |
+ + +-+-+ +
|   |     |
+-+-+-+-+-+