+-+-+-+-+-+
|     | | |
+-+-+ + + +
| | |     |
+ + + +-+ +
|       | |
+ + +-+-+-+
| |     | |
+ + + +-+ +
| | |     |
+-+-+-+-+-+