+-+-+-+-+-+-+-+-+-+-+-+-+
|                       |
+ + +-+-+ +-+-+-+ +-+-+ +
| |     |       |     | |
+ + + +-+ +-+-+-+-+-+-+-+
| | |   |               |
+ +-+-+-+ +-+-+ + + +-+-+
|       |     | | |     |
+ + + + +-+ +-+-+ + + +-+
| | | |   |     | | |   |
+ + + + +-+-+ + +-+-+-+-+
| | | |     | |         |
+ +-+ +-+-+ +-+ +-+-+ + +
|   |     |   |     | | |
+ + + +-+ + +-+ +-+-+ +-+
| | |   | |   |     |   |
+ + +-+-+-+-+ +-+ + +-+-+
| |         |   | |     |
+ +-+ +-+-+ + +-+ + + + +
|   |     | |   | | | | |
+ + + + + + +-+ + + + +-+
| | | | | |   | | | |   |
+ + +-+ + +-+ +-+-+ + + +
| |   | |   |     | | | |
+-+-+-+-+-+-+-+-+-+-+-+-+