+-+-+-+-+-+-+-+
|     | | |   |
+-+-+ + + +-+ +
|     | |     |
+ + + + +-+-+ +
| | | | |     |
+-+-+ + + +-+-+
|       |   | |
+ +-+-+-+ + + +
|   |   | | | |
+ + + + +-+ + +
| |   |   | | |
+ +-+ +-+-+ + +
|   |         |
+-+-+-+-+-+-+-+