+-+-+-+-+-+-+-+-+-+-+-+-+-+-+-+-+-+-+-+-+-+-+-+-+-+-+-+-+-+-+-+-+-+-+-+-+-+-+-+-+-+-+-+-+-+-+
|                                                                                           |
+ + + + +-+ + + + + + + + +-+ + + +-+ +-+ + +-+ + + +-+-+ + + + + +-+ + + +-+ + + +-+ + + +-+
| | | |   | | | | | | | | |   | |   | |   |   | | | |     | | | | |   | | |   | |   | | |   |
+ +-+ + + + + + + +-+ +-+ + + + + +-+ + + + + + +-+ + + + +-+ + + +-+ + + + + + +-+ + + + + +
| |   | | | | | | |     | | | | | |   | | | | | |   | | |   | | | |   | | | | |   | | | | | |
+ + + + + + + +-+-+ +-+ + + + +-+ + + + +-+-+ + + +-+ + +-+-+-+ + +-+ + + +-+-+ +-+-+ + + + +
| | | | | | | |       | | | | |   | | | |     | | |   | |       | |   | |     |     | | | | |
+ +-+ + + + +-+ +-+-+-+ + + +-+ +-+ +-+ +-+ + +-+ +-+ + + +-+ + + + + + + + + + + + +-+ + +-+
| |   | | | |     |     | | |   |   |     | |   |   | | |   | | | | | | | | | | | | |   |   |
+ +-+ + + + + +-+ +-+ + + +-+-+ +-+ +-+ + +-+-+ + +-+ +-+-+ + + + +-+ + + +-+-+ +-+ + + +-+ +
|   | | | | |   | |   | |   |     |   | |   |   |   | |     | | | |   | |     |   | | | |   |
+ + + + + +-+ +-+-+ + + + +-+-+ + + + + +-+ + + +-+ +-+ +-+-+ + +-+ +-+ +-+-+ +-+-+ + + +-+ +
| | | | | |   |     | | | |     | | | | |   | |   | |       | |   |   |     | |     | | |   |
+ + + +-+ + +-+ + +-+ + + + +-+ +-+-+ + +-+ + + + +-+-+ + + + + + + + + + + + +-+-+ +-+ + + +
| | | |   | |   |   | | | |   |   |   | |   | | |     | | | | | | | | | | | |   |     | | | |
+-+-+ + + + + +-+ +-+-+-+ + + +-+-+ + + +-+-+ + + +-+-+ +-+-+-+ +-+ + +-+-+ +-+ +-+ + + + + +
|     | | | | |         | | |   |   | | |     | |   |   |         | |     |   | |   | | | | |
+ +-+ +-+ + + + + +-+ +-+-+ +-+ + + + + + + + +-+-+ + + + +-+ + + + + +-+-+ + + + + + + + + +
|   |   | | | | |   |     | |   | | | | | | |   |   | | |   | | | | |     | | | | | | | | | |
+-+ +-+ +-+-+-+ + + + + +-+ + + +-+ + + + + + + +-+-+ +-+ + +-+ + + +-+ +-+-+-+ + + + + + + +
|     | |       | | | |   | | |   | | | | | | |     |   | | |   | |   | |       | | | | | | |
+ + +-+-+ +-+-+-+-+ +-+ +-+ + +-+ + +-+ + +-+ + + + + + + + + + +-+-+ + + +-+-+ +-+ + + +-+ +
| | |             | |   |   | |   | |   |   | | | | | | | | | |     | | |   |   |   | | |   |
+ + + +-+-+ +-+ +-+ + + + +-+-+ +-+-+ +-+-+ + +-+-+ + +-+ + + +-+-+ +-+ + +-+ + + +-+ +-+-+ +
| | |     | |   |   | | | |         | |     |   |   | |   | | |     |   |   | | | |     |   |
+ + + + + + + + +-+ +-+ + +-+ + + + + +-+-+ + +-+ + +-+ + +-+ + + + + + + + + + + +-+ + +-+-+
| | | | | | | | |     | | |   | | | |     | | |   | |   |   | | | | | | | | | | |   | |     |
+ +-+-+ +-+ +-+-+-+ + + + + +-+ +-+ + + +-+ + +-+ + + +-+ + + + + + + +-+-+-+ + + + + + +-+ +
| |       | |       | | | |   |   | | |   | |   | | |   | | | | | | |   |     | | | | | |   |
+ +-+ +-+ + + + +-+ +-+ + + + +-+ +-+ + +-+ + + +-+ +-+-+ +-+ +-+-+-+-+ + + + + +-+ + + + + +
|   | |   | | | |     | | | |   |   | | |   | | |   |     |   |         | | | |   | | | | | |
+ +-+-+ + + + +-+ +-+-+-+ +-+ + + + +-+-+ + + +-+ +-+ +-+ + + +-+ + + +-+ +-+ + + + + +-+ + +
| |     | | | |         |   | | | |     | | | |   |   |   | |   | | |   |   | | | | | |   | |
+ +-+ + + + + +-+ +-+ +-+ + + + + +-+ +-+-+ + + + + + + +-+ + + +-+ + + +-+-+ + + + + + + + +
| |   | | | |   | |   |   | | | |   | |     | | | | | | |   | |   | | | |     | | | | | | | |
+ + + + +-+ + + +-+ + + + + + +-+ +-+-+-+ + +-+-+ + + + +-+ +-+ + + + + + + +-+ + + + + + + +
| | | |   | | | |   | | | | | |         | | |     | | | |   |   | | | | | | |   | | | | | | |
+ + +-+-+ +-+ + +-+-+ + +-+ + +-+ + + + +-+ +-+ + +-+-+ + + + + + + + +-+-+-+ +-+-+ + + + +-+
| |   |     | |     | | |   | |   | | | |     | |   |   | | | | | | |       | |     | | |   |
+ + + + + + + + + + + + +-+-+-+ + + + + + + +-+-+-+-+-+ + + + +-+ + + +-+-+ +-+ +-+ + +-+ + +
| | | | | | | | | | | | |       | | | | | | |           | | |   | | |     | |   |   | |   | |
+ + + + + + + +-+ +-+ + +-+ + + + + + +-+-+ + + +-+-+ + +-+ + + +-+ +-+ + + + + + +-+ +-+ + +
| | | | | | | |   |   | |   | | | | |     | | | |     |   | | | |   |   | | | | | |     | | |
+ + +-+ + +-+-+-+ + + + + +-+-+ +-+ + + +-+ +-+ + +-+-+ + + + + +-+ +-+ +-+ + + + + +-+ + + +
| | |   |       | | | | |   |   |   | | |     | | |     | | | | |     |   | | | | |   | | | |
+ + + +-+ + + +-+ +-+-+-+-+ + +-+ + + + + +-+ + +-+ + + +-+ + +-+-+ + + +-+ + +-+-+-+ +-+ + +
| | |   | | | |       |     | |   | | | | |   |   | | |   | |     | | |   | |       | |   | |
+ + + + +-+-+ + +-+ + + +-+ + +-+ + + + + + + + +-+ + + + +-+ + + + +-+-+ +-+-+ + + +-+ + + +
| | | |     | | |   | |   | |   | | | | | | | | |   | | |   | | | |   |     |   | |   | | | |
+-+ +-+-+ +-+ +-+ +-+ +-+ + + + + + + +-+ + + +-+-+ +-+-+ +-+ + +-+ + + +-+ +-+ + +-+-+ +-+ +
|   |       | |   |   |   | | | | | | |   | |   |   |       | | |   | | |   |   |   |     | |
+-+ + +-+ + +-+-+ + + + +-+ +-+-+ +-+ + + + + + +-+ +-+ + + +-+ + + + + + +-+ +-+ + + +-+ + +
|   |   | |     | | | | |     |     | | | | | |   | |   | |   | | | | | | |   |   | |   | | |
+ +-+ +-+ + + + + +-+ +-+ +-+-+ + +-+ + + +-+ + +-+ + + + + + +-+ + + + +-+-+ + + + +-+-+ + +
|   |   | | | | | |     |   |   |   | | | |   |   | | | | | |   | | | |   |   | | |     | | |
+ + + + +-+ + + + + +-+ + +-+-+ +-+ + + + +-+ + + + + +-+-+-+ +-+-+-+ + + + + + + + + + + + +
| | | |   | | | | |   | | |     |   | | | |   | | | |   |     |       | | | | | | | | | | | |
+ + + + + + + +-+-+-+ + + + +-+-+ + +-+ + + + + +-+ + + + + + + +-+ + + + + +-+ + + + + +-+ +
| | | | | | | |       | | |     | |   | | | | |   | | | | | | | |   | | | |   | | | | | |   |
+ +-+ + + + + + + + + + + + + +-+ + + + + + + + + + +-+-+-+-+ + +-+ + + + +-+ +-+ + + + + + +
|   | | | | | | | | | | | | |   | | | | | | | | | |   |       | |   | | |   | |   | | | | | |
+ +-+ + + +-+ + + +-+-+ + +-+-+ + + +-+ + +-+ + +-+ + + + +-+-+-+ + +-+ + + +-+ + + + +-+ + +
| |   | | |   | |   |   |     | | |   | |   | |   | | | |   |     | |   | | |   | | |   | | |
+ +-+ +-+ + + + + + + + +-+ + + + + +-+ +-+ + +-+-+-+ + + +-+ + + + +-+-+ +-+ +-+-+-+-+ + + +
|   | |   | | | | | | |   | | | | | |     | | |       | | |   | | |   |   |           | | | |
+ + + +-+ +-+-+-+-+ + +-+-+-+ + + +-+ +-+ + + +-+-+ + + + + + + + + + + + + +-+ + + + + + + +
| | |   | |         |     |   | |   |   | | | |     | | | | | | | | | | | | |   | | | | | | |
+ +-+-+ + +-+ + + + + + + + + + +-+ + +-+ +-+ + + +-+ + + + +-+ +-+-+ + +-+-+ + +-+-+ + + + +
| |     |   | | | | | | | | | | |   |   | |   | | |   | | |   |     | |   |   | |     | | | |
+ + + + +-+-+ + + + +-+ + + + + + + +-+ +-+ + + + + +-+ + + +-+-+ +-+ + +-+ + +-+ + + + +-+ +
| | | |   |   | | | |   | | | | | | |     | | | | |   | | | |       | |   | |   | | | |   | |
+ +-+ +-+ + + + + + + + +-+ + + + + + +-+ +-+ +-+ + + + + +-+ + + +-+ + + +-+-+ + + +-+-+ + +
| |   |   | | | | | | | |   | | | | | |   |     | | | | | |   | |   | | |   |   | |   |   | |
+ + + + + + + + + + + + +-+ + + +-+ + +-+ + + + +-+ + + + + +-+-+ + + + + + +-+ +-+ + + + +-+
| | | | | | | | | | | | |   | | |   |   | | | |   | | | | |   |   | | | | |   | |   | | |   |
+ + + +-+ +-+ +-+-+ + + + + +-+ + + + +-+-+ +-+ + + + + +-+ + +-+ +-+-+ + + +-+-+-+ +-+ +-+ +
| | |   | |       | | | | | |   | | | |     |   | | | | |   | |   |     | |   |     |     | |
+-+ + + + +-+ + +-+ +-+-+ + + + + + +-+ + + +-+-+ + + + + +-+ +-+ + + +-+ + + + + +-+-+-+ + +
|   | | |   | |   |     | | | | | |   | | | |     | | | |   | |   | |   | | | | | |       | |
+ +-+-+ + + + + + + + + +-+ + +-+ +-+ + + + +-+-+-+-+-+-+ + +-+ + + + +-+-+ + + +-+ + + +-+-+
|     | | | | | | | | | |   | |   |   | | | |             |   | | | | |     | |   | | |     |
+ + + + +-+ + + + + + + + + + + + + + + + + + + +-+ + + +-+ +-+ +-+-+-+ + +-+ +-+-+ + +-+-+ +
| | | | |   | | | | | | | | | | | | | | | | | |   | | | |   |   |       |   |     | |     | |
+ + + +-+ +-+-+ +-+ + +-+ +-+-+ + + + + +-+ + + + + + + + + + + + +-+ + + + + + + +-+ +-+-+ +
| | |   | |       | |   |   |   | | | | |   | | | | | | | | | | |   | | | | | | |   |     | |
+ +-+ +-+-+ +-+ +-+ + + + + + +-+ +-+ + + + + + + +-+-+ + +-+ + + +-+-+ + + +-+ +-+ + + +-+ +
| |     |     | |   | | | | |   | |   | | | | | | |     | |   | |     | | |   | |   | |   | |
+ + +-+ + + +-+-+ +-+ +-+-+-+-+-+ +-+ +-+ + + +-+ + + + +-+ + + + + + + +-+-+-+-+ + + + + +-+
| |   | | | |       |         |   |     | | |   | | | |   | | | | | | |   |       | | | |   |
+-+ +-+-+ +-+ + +-+ + +-+ +-+ + + + + +-+ +-+ + +-+ + +-+-+ +-+ +-+-+ + + + +-+ + + + +-+-+-+
|   |       | | |   | |     | | | | | |     | | |   |   |     | |     | | | |   | | |       |
+-+-+-+-+-+-+-+-+-+-+-+-+-+-+-+-+-+-+-+-+-+-+-+-+-+-+-+-+-+-+-+-+-+-+-+-+-+-+-+-+-+-+-+-+-+-+