+-+-+-+-+-+-+-+-+
|               |
+ + + +-+-+ +-+-+
| | |     |     |
+ +-+ + +-+-+-+ +
|   | |       | |
+ +-+-+-+ + + +-+
|       | | |   |
+ + + +-+ + +-+-+
| | |   | |     |
+ + +-+ +-+-+-+ +
| |   |       | |
+ +-+ +-+ + +-+-+
|   |   | |     |
+ + + +-+-+-+-+ +
| | |         | |
+-+-+-+-+-+-+-+-+