+-+-+-+-+-+
|         |
+ +-+ +-+ +
|   |   | |
+ + + + + +
| | | | | |
+ + + + +-+
| | | |   |
+-+ + + + +
|   | | | |
+-+-+-+-+-+