+-+-+-+-+-+-+-+-+-+-+-+-+-+-+-+-+-+-+-+-+-+-+-+-+-+-+-+-+-+-+-+-+-+-+-+-+-+-+-+-+-+-+-+-+-+-+-+-+-+-+
|         |   |       |     |           |         |   |           |           |         |           |
+-+-+-+-+ + + + +-+ + +-+ + +-+-+ +-+-+ + + +-+-+ + +-+ +-+-+ +-+ +-+ +-+-+-+ + +-+-+-+ +-+-+ +-+-+ +
|   |     | |     | |     |       |   | | | |   | |   | |     | |   |   |     | |     |     | | |   |
+ +-+ +-+-+-+-+-+-+ +-+-+-+-+-+-+-+-+ + +-+ + +-+ + + + + +-+-+ +-+ +-+ +-+ +-+ + + + +-+-+ + + + +-+
|     |             |     |           |     |     | |   | |     | |   |   |     | | |   |   | |   | |
+ +-+-+ +-+ +-+-+-+-+ + + +-+ + +-+-+ +-+-+-+ +-+-+ +-+-+ + + + + +-+ + + +-+-+-+ + +-+-+ +-+ +-+ + +
| |   | | |   |     | | |     | |   |     |   |     | |   | | |   |   | |     | | |   |   |     |   |
+ +-+ + + +-+ + +-+-+ + +-+-+-+-+ + +-+-+-+ +-+ +-+-+ + +-+ + + +-+ +-+-+-+-+ + + +-+ + +-+ +-+ +-+-+
|   | |   | | |       | |   |     |       | |     |   |   | | | |   |     |   | | |   | | |   |     |
+-+ + +-+ + + +-+ +-+-+ + + + +-+-+-+-+-+ + +-+-+ + + +-+ + + +-+ +-+ + + + +-+ + + +-+ + +-+ +-+-+ +
|   |   |   |   | |   |   | |     |   |   |     |   | |   | |   |   | | |   |   | |   | |     |   | |
+ +-+-+ +-+ +-+ +-+ + +-+-+ +-+-+ +-+ + + +-+-+ +-+ +-+ +-+ +-+ +-+ +-+ +-+-+ + + +-+ + +-+-+-+ + + +
| |     |   | |     | |   |   |   |   | | |   |   | |   | |   |   |     |     | |   |   |       | | |
+ + +-+-+ +-+ +-+-+-+ + + +-+ + +-+ +-+ + + + +-+ +-+ +-+ +-+ + + +-+-+-+ +-+-+-+-+ +-+-+ +-+-+-+ + +
| |       |     |   | | |   | |     |   |   | | |     |     | | | |     |         | |   |   |       |
+ +-+-+ +-+-+ + +-+ + + +-+ + + +-+-+ +-+-+-+ + +-+-+-+ +-+-+ + + + +-+ +-+-+-+ +-+ + + + + +-+-+-+-+
|     |     | | |   |   | | |   |   |       |         |       | |   | | |     | |   | |   |         |
+-+-+ +-+-+ + + + +-+-+-+ + +-+-+ + +-+-+-+ +-+-+-+-+-+ +-+-+-+ +-+-+ + + +-+ + + +-+ +-+-+-+ +-+-+ +
|   |     | | | |         | |     |   |   |             |       |     |   | | | |   |   |   |     | |
+-+ +-+-+ + + + +-+-+-+-+ + + +-+-+-+ + + + +-+-+-+-+ +-+ +-+-+-+ +-+-+-+-+ + + +-+ +-+-+ + +-+-+ + +
|   |     |   |           | | |     |   | |     |   |   |       |             |   |   |   |     | | |
+ + + +-+-+-+ +-+-+-+-+-+-+ + + + +-+-+-+ +-+-+ + + +-+-+-+-+ + +-+-+-+-+ +-+-+-+ +-+ + +-+-+-+ +-+ +
| | | |     | |           | | | | |   |   |     | | |       | |     |   | |   |     | |   |   | |   |
+ +-+ +-+-+ + + +-+-+-+-+ + + +-+ + + + +-+-+-+-+ + + +-+-+ + +-+-+ + + + + + + +-+ + +-+ + + + + +-+
|     |   | | | | |       |       | |   |         |   |   | |   |   | | |   | |   | | |   | |   |   |
+ +-+-+ + + + + + + +-+-+-+ +-+-+-+ +-+-+ +-+-+-+-+-+-+ +-+ +-+-+ +-+ + +-+-+ +-+ + + + +-+ +-+-+-+ +
|       | | | | |   |       |     |   |     |   |       |   |   | |   |   |   |   | | |   |     |   |
+-+-+-+-+ + + + + +-+-+-+-+-+ +-+ +-+ +-+-+ + +-+ +-+-+ + +-+ + + + +-+-+ + +-+ + +-+ +-+ +-+-+ + + +
| |     | |   | |             | |     |     |     | |   | |   |   |   |   |     | |   |   |   |   | |
+ + +-+ + +-+-+ +-+-+-+-+-+-+-+ +-+-+-+ +-+-+ +-+-+ + +-+ + + +-+-+-+ + +-+-+-+ +-+ +-+ +-+ +-+-+-+ +
| |   |   |     |           |           |           |       | |     | |   |     |   | |   |       | |
+ +-+ +-+-+ +-+-+-+-+-+-+ + + + +-+-+-+-+-+-+-+ +-+-+-+-+-+ +-+ + +-+ +-+ +-+-+-+ +-+ + + +-+-+ +-+ +
|   | |     |         |   | | | |   |       |   |         | |   |   | | |     |   |   | |     | |   |
+ +-+ + + + + +-+-+-+ + +-+ + + + + + +-+-+ + +-+ +-+-+-+ +-+ +-+-+ + + +-+-+ + +-+ +-+ +-+-+ + + +-+
|   | | | | | |     | | |   | | | | | |   | |   |     |   |   |   | | |     |   | |   | |   | |     |
+ + + + + +-+ + +-+-+ + +-+ +-+ + + + + + + +-+-+-+-+ + +-+ +-+ +-+ + +-+-+ +-+-+ + + + + + + +-+-+ +
| |   | |   | |   |   |   |   | | |   | | |   |   |   |   |   |   | | |       | |   |   | | |   |   |
+ +-+-+ +-+ + +-+ + +-+-+ +-+ + + +-+-+ +-+-+ + + + +-+-+ +-+ +-+ + + + +-+-+ + + +-+-+-+ + +-+ + +-+
| |   |   |       | |     |   |   |         |   | | |   |   |   | |   | |     |         | |     |   |
+ +-+ +-+ +-+-+-+-+ + +-+-+ +-+ +-+-+-+-+ + +-+-+ + + + +-+ +-+ + +-+-+ + +-+-+-+-+-+-+-+ +-+-+-+-+ +
| |   |   |     |   | |   | | | |     |   |     | |   | | |   | |       | |       |   |   |       | |
+ + +-+ +-+ +-+ + +-+ +-+ + + + +-+ + + +-+-+-+ + +-+-+ + + + + + +-+-+-+ + +-+-+ + + + +-+ +-+-+ + +
| |     | | |     |     | | |       |   |       |       | | | |   | |   | |   |   | | |     |   | | |
+ + +-+-+ + +-+-+-+ +-+ + + +-+-+-+-+-+-+ +-+-+-+-+-+-+-+ + +-+-+-+ + + + +-+ +-+ + + +-+ +-+ +-+ + +
| | |     |     |   | | |   |         |     |       |     |       |   | |   |   |   |   | |   |   | |
+ + +-+ +-+-+-+ + +-+ + +-+ + +-+-+-+ +-+-+ +-+ + +-+ + +-+-+ +-+ +-+-+ +-+ +-+ +-+-+-+ + +-+ + +-+-+
| |   | |       | |   |   |   |     |   |     | |     |     |   |     |   | |   |       |   | |     |
+ +-+ + + +-+-+-+ + + +-+ +-+-+ + +-+-+ +-+-+ +-+-+-+ +-+ +-+-+ +-+-+ +-+ + + +-+ +-+-+-+-+ + +-+-+ +
| |     | | |     | | |   | |   |     |   | |       |   |     | |   | |   |   |   |               | |
+ + +-+-+ + + +-+-+ + + +-+ + +-+-+ +-+-+ + +-+-+-+ +-+-+-+ +-+ + +-+ + +-+-+-+ +-+-+ +-+-+-+-+-+ + +
| | |   | | |   |   | |   |     | |       |   |   |       |   | |   |   |   |   |   | |         | | |
+ +-+ + + + +-+ +-+ +-+-+ +-+-+ + +-+-+-+-+ +-+ + +-+-+-+ +-+ + +-+ + +-+ + + +-+ + + + +-+-+-+ +-+ +
|     |   |   |   |     |     |   |   |         |   |   | |   |   |   |   |   |   | | |       |   | |
+-+-+-+-+-+-+ +-+ + + + +-+-+ +-+ + + + +-+-+-+-+ +-+ + + + + +-+ +-+-+ +-+-+-+-+ + + +-+-+-+ +-+ + +
|   |         |   | | | |   | |   | | |   |     |     |     |   |     |   |       | |   |   | | | | |
+ +-+ +-+ + +-+ +-+ + + + +-+ + +-+ +-+ +-+ +-+ + +-+-+-+-+-+-+ +-+-+ +-+ +-+ +-+-+ +-+ + + + + + + +
| |   | | | |   | | | | |   | | |   |   |   |   |     |     |       |   |   | |   |   |   | | |   | |
+ + +-+ + +-+ +-+ + + + + + + + +-+ + +-+ +-+ +-+-+ +-+ +-+ +-+-+-+-+ + +-+ + +-+ +-+ +-+-+ + +-+ + +
| | |   |   |   |   | | | | | |   | | | | |   |     |   | |       |   |   |   |     |     | |   | | |
+ + + +-+-+ +-+ + +-+ + +-+ + +-+ + + + + + +-+-+-+-+ +-+ +-+-+-+ + +-+-+ +-+-+ +-+-+-+-+ +-+-+ + + +
|   |     |   | | |   |     |   | |     | |         | | |     |   | |     |           |   |     | | |
+ +-+-+-+ +-+ + +-+ +-+-+-+ +-+ + +-+-+-+ +-+-+-+-+ + + + + +-+ +-+ + +-+-+ +-+-+-+ + + +-+ +-+-+ + +
|   |       |       |   |     | |   |   | |   |   | | | | | |   |   | |     |       | | |   |   |   |
+-+ + +-+ +-+-+-+-+-+ +-+ +-+-+ +-+ + + + + + +-+ + + + + + + +-+-+ + +-+-+-+ +-+ +-+-+ + +-+-+ +-+ +
| |   |   |       |   |   |     | | | | |   |   | |   | | | | |     |         |   |     |     | |   |
+ + +-+-+-+ +-+-+ +-+ + +-+ +-+-+ + + + +-+-+-+ + +-+-+ + + + + +-+-+-+-+-+-+ +-+-+ +-+-+-+-+ + + +-+
| | |       |   |   |   | |   |       | |       |       | |     |           | |     |       | |     |
+ + + +-+-+-+ + +-+ +-+ + +-+ +-+ +-+-+ + +-+-+-+ +-+ +-+ +-+-+-+-+-+-+-+ +-+ + +-+-+-+ +-+ + +-+-+ +
|   |       | |   |   |     |   | |   |   |   |   | |     |             |     |         |   |   | | |
+-+-+ +-+-+ + +-+ +-+ + +-+-+-+ + + + +-+-+ +-+ +-+ +-+-+ + +-+-+-+-+-+ +-+-+-+-+-+-+-+-+ +-+-+ + + +
|   | |     |   | |   | |     | | | |   |     | |   |   | |   |       |             |   | |     |   |
+ + +-+ +-+ +-+ + + +-+ + +-+ + +-+ +-+ + +-+ + + +-+ + +-+-+ + + +-+-+-+-+-+ +-+-+ + +-+ +-+ +-+ +-+
| |     | |   | | |   | | | | | |   | | | | |   | |   |   |   | | |         | |       |   |   | | | |
+ +-+-+-+ +-+ + + +-+ +-+ + + + + +-+ + + + +-+-+ + +-+-+ + +-+ + + +-+-+ +-+ +-+-+-+-+ +-+ +-+ + + +
|     |       | |   |     | | | | |   | |   |     | |   |   |   | |   | |   |       |   |   |   |   |
+-+-+ +-+-+-+-+ +-+ +-+-+-+ + + + +-+ + +-+ +-+ + + + + +-+-+ + +-+-+ + +-+ +-+-+-+ + +-+ +-+ + +-+ +
|   | |           | |     |   |       | | | |   | |   |   |   | |       |         | | |   |   |   | |
+ + + + +-+-+-+-+-+ +-+-+ + +-+-+-+-+-+ + + + +-+ +-+-+-+ + +-+-+ +-+-+-+ +-+-+-+ + + + +-+-+ +-+ + +
| |   |     |     | |     |     |       | |   |   |     | |   |   |     | |   | | |   | |   |   |   |
+ +-+ +-+-+ + +-+ + + +-+-+-+-+ + +-+-+-+ +-+-+ +-+ +-+-+ +-+ + +-+ +-+ + + + + + +-+-+ + + +-+-+-+-+
| |       | | |   | | |     | |   |       |       |     |   |   | | | | |   | |   |       |         |
+ +-+-+-+ + + + +-+ + + + + + +-+-+-+ + +-+ +-+-+ +-+-+ +-+ + +-+ + + + +-+ + +-+-+ +-+-+-+-+-+-+-+ +
|       | | | |     |   | | |         | |   |   |       | | |   | | | |   | |                   |   |
+ +-+-+ +-+ + +-+-+-+ +-+ + +-+-+-+ +-+-+ +-+ + +-+-+-+ + + +-+ + + + +-+ + +-+-+-+-+-+-+-+-+-+ + +-+
|   | |     |   |   | |   |         |   |   | | |     | | |   |   | | |   |   |   |           | |   |
+-+ + +-+-+-+-+ +-+ + + +-+-+-+ +-+-+ + + +-+ + +-+ +-+ + +-+ +-+-+ + + +-+ +-+ + + +-+ +-+-+ +-+-+ +
| |     |     |   |   |   |     |     |   |   |   |     |   | |     | | |   |   | |   | |   |       |
+ +-+-+ + +-+-+-+ +-+-+ + +-+ +-+ +-+-+ +-+ +-+-+ + +-+-+ + + + +-+-+ + + +-+ +-+ +-+ + + + +-+-+-+ +
| |     | |     |     | |   | | | |   | |   |   | |   |   | |   |     | | | |   |     | | |   |   | |
+ + +-+-+ + +-+ +-+-+ +-+-+ + + + + + + + +-+ + + +-+ + + +-+-+-+ +-+ + + + +-+ +-+-+-+-+ +-+ + +-+ +
|   |     |   |     |     | |   | | | | | |   | | |     | |       | |   |     |             | |   | |
+ +-+-+-+ +-+ +-+-+ +-+-+ + +-+-+ + + + + + +-+ + +-+-+-+ + +-+-+-+ +-+-+-+ +-+-+ +-+-+-+-+-+ +-+ + +
| |     |   |   |     | | |       | | | | |   | |   |   | |     |         | |   | |         |   | | |
+ +-+ + + + +-+ + +-+ + + +-+-+-+-+ + +-+ + + +-+-+ + + + +-+-+ + +-+-+-+ +-+ + +-+ +-+-+-+ +-+ + + +
|     | | |     | |   | | |     |   |     | |     |   | |     | |       |   | |   |     |     | |   |
+-+-+-+ +-+-+-+-+ + +-+ + + +-+ + +-+-+-+-+-+-+ + +-+-+ + +-+-+ +-+-+-+ +-+ + +-+ + +-+ +-+-+ + +-+ +
|     |   |   |   |     | | | |   |   |         | |   | | |     |       |   | |   |   |     | |   | |
+ +-+ +-+ + + + +-+-+-+ + + + +-+-+ + +-+ +-+-+-+ +-+ + +-+ +-+-+ +-+-+-+ +-+ + +-+-+-+-+-+ + +-+ + +
|   |       |   |       |           |     |           |           |           |             |     | |
+-+-+-+-+-+-+-+-+-+-+-+-+-+-+-+-+-+-+-+-+-+-+-+-+-+-+-+-+-+-+-+-+-+-+-+-+-+-+-+-+-+-+-+-+-+-+-+-+-+-+