+-+-+-+-+-+-+-+
| |   |     | |
+ + + +-+ +-+ +
| | | |   |   |
+ + +-+ + + + +
| |   | |   | |
+ + +-+ +-+-+ +
|   | |   |   |
+-+ + +-+ +-+ +
|       | | | |
+ +-+ + + + +-+
|   | | | |   |
+ + + + + + + +
| | | |     | |
+-+-+-+-+-+-+-+