+-+-+-+-+-+-+-+-+-+-+-+-+-+-+-+-+-+-+-+-+-+-+-+-+-+-+-+-+-+-+-+-+-+-+-+-+-+-+-+-+-+-+-+-+-+-+-+-+-+-+
|   |     |           |     |             |         |         |     |           |     |         |   |
+-+ + +-+ +-+ +-+ +-+-+ + +-+ +-+-+-+ +-+ +-+-+-+ + +-+ +-+-+ + + + +-+ +-+-+-+ + +-+ + + +-+-+-+ + +
| | |   |   |   |     | |         |   | |         |   |   | | | | |     |     |   | | | |     |   | |
+ + + + +-+ + +-+-+-+ + +-+-+-+-+-+ +-+ +-+-+-+-+-+-+ +-+ + + + + +-+-+-+-+-+ +-+-+ + + +-+-+ + +-+ +
|   | | | | | |       | |   |       |               | |   | | | |           |         | |   |     | |
+ +-+-+ + + +-+ +-+-+ + + + + +-+-+-+ +-+ +-+-+-+-+-+ + +-+ + + +-+-+-+-+-+ + +-+-+-+-+ +-+ +-+-+ + +
|       | |   |     | | | | | | |   | | |     |       |     |           |   |     | |   |   |   | | |
+-+-+-+-+ +-+ +-+-+ + + + + + + + + + + +-+-+ + +-+-+-+-+-+ +-+-+-+-+-+ + +-+-+-+ + + +-+ +-+ + +-+ +
|         |   |     | | | | | | | | |   |   | | | |     |   |   |     | | |     |   | |   |   | |   |
+ +-+-+-+ + +-+ +-+-+-+ +-+ + + + + + +-+ + + + + + + + +-+-+ + + + +-+ + +-+-+ +-+ + + +-+ +-+ + +-+
| |     | | | |   |         | |   | | |   |   | | | | |       | | |     | |   |     |   |   | | |   |
+ + +-+-+ + + + + + +-+-+-+-+ + +-+ + + +-+-+-+ + + + +-+-+-+-+ + +-+-+-+ + + +-+-+-+ +-+ +-+ + + + +
| |       | |   | |   |       |   |   | |       |   | |       | | |     | | | |   |   |   |     | | |
+ +-+-+ +-+ + +-+ + +-+ +-+-+-+-+ +-+-+ + +-+-+-+-+-+ + +-+-+ + +-+ +-+ + + + + + + +-+ +-+ +-+-+-+ +
|     |   | |   |   |   |       |   |   |   |     |   | |     |   | |   |   |   |   | | | | |       |
+ +-+ + +-+ + +-+-+-+ +-+-+-+ +-+-+ + + +-+ + +-+ + +-+ + +-+-+-+ + + +-+ +-+-+-+-+ + + + + + +-+ + +
| |   | |   | |   |   |   |   |     | |   |   | |   |   |   |     | |   |   |     |   | | | | |   | |
+ + +-+ + +-+-+ + + +-+ + + +-+ +-+-+ + +-+-+-+ +-+-+-+ +-+ + +-+-+ +-+ + +-+ +-+ +-+ + + + + + +-+ +
| | | | | |     |   |   | | |   |   | | |               | | | |     | | | |   | |   | | |   | | |   |
+ + + + + +-+ +-+-+-+ +-+ + + +-+ +-+ +-+ +-+-+-+ +-+-+-+ + + + +-+-+ + +-+ +-+ +-+ + + + +-+-+ + +-+
| | |   |     | |     | |   |     |   |     |   | |     |   | | |   | |     | |   | | | |   |   | | |
+ + +-+-+-+-+-+ + + +-+ +-+ +-+-+ + +-+ +-+-+ + + + +-+ + +-+ + + + + +-+-+-+ + + + +-+ +-+ + +-+ + +
| |             | | | |   |   |   |     | |   | |     | |   |   | | |       |   | |   | |   | | |   |
+-+-+-+-+-+ + +-+ + + + + +-+ + +-+-+-+-+ + +-+ + +-+-+ + +-+-+-+ + +-+-+-+ + +-+ +-+ + + +-+ + +-+ +
|         | | |   | |   |     |   |       | |   | |     | |       |     |   |   |     | | |   |     |
+ +-+-+-+ + + + +-+ +-+-+ +-+-+-+ +-+ +-+-+ + +-+-+ +-+-+ + +-+-+ +-+-+ + + +-+ +-+-+-+ + + + + +-+-+
|       |   | | | | |   | |     |   | |     |       | |   |   | |     |   |   |   |     | | | |   | |
+ +-+-+ +-+-+-+ + + + + +-+ +-+ +-+ + + +-+-+-+-+-+-+ + +-+-+ + +-+-+ +-+-+-+-+-+ +-+ +-+ + + +-+ + +
| |   |       |   |   |       |   | | |   |         |       |   |   |           |     |   | | | |   |
+ +-+ +-+-+-+ +-+ +-+-+-+-+-+-+ +-+ + +-+ + +-+-+-+ + +-+-+-+-+ +-+ +-+-+-+-+ + +-+-+-+ +-+ + + +-+ +
| |   |   |     |   |   |       |   |   |   |     | |   |     | |   |     |   |   |   | | | | |     |
+ + + + +-+ +-+ +-+ + +-+ +-+-+ + +-+ + +-+-+ +-+ + +-+ + +-+ + + + +-+-+ + +-+-+ + +-+ + + + +-+-+ +
|   |   |   |   |   |   |   |   |     |       |   |   | | | | | | |       |     |   |   | | |     | |
+-+-+ +-+ +-+-+ + +-+-+ +-+ +-+ +-+-+ +-+-+-+-+-+-+ + +-+ + + + + +-+-+-+ +-+-+ +-+ + +-+ + +-+-+ +-+
|   | |   |   | |   |     |   |     | |   |   |   | |   | | |   |     |   |   | |   | |   | |   |   |
+ +-+ + +-+ + + +-+ + +-+ +-+ +-+ +-+ + + + + + + + +-+ + + +-+-+ +-+ +-+ + + + + +-+ + +-+ + +-+-+ +
|     |     | |   |   | | | |   | |   | | | |   | | |   |       |   |   | | | | |   | |     |     | |
+ +-+-+-+-+-+ +-+-+-+-+ + + +-+ +-+ +-+ + + +-+-+ +-+ +-+ +-+-+ +-+ +-+ + + + + +-+ + +-+ +-+-+ +-+ +
|   |     | |         | |     |       | | | |   |   |     |   |   | |   | | |   |   |   |   |   |   |
+-+ + +-+ + +-+-+-+ + + +-+ +-+-+ +-+-+ + + + +-+-+ +-+ +-+ + +-+ +-+ +-+-+ +-+-+ +-+-+ +-+ + +-+ + +
| |   | | |   |     |   |   |   |   |   |   |         | |   | |   |   |     |   | | |   |   |   | | |
+ +-+-+ + + + + +-+-+-+-+ +-+ + +-+ + +-+-+-+-+-+-+-+ +-+ +-+ + +-+ + + +-+-+ +-+ + + +-+-+ +-+ + +-+
| |       | | |             | | |   |     |         | |   | | | |   | |     | |     | |   |     |   |
+ + +-+-+-+-+ +-+-+-+-+-+-+-+ + +-+ +-+-+ + +-+-+-+ + + +-+ + + +-+ +-+-+-+ + + +-+-+ + + +-+-+-+ + +
| |       |         |         |   |     | |     |   |   |     |     |     | |   |     | |   |   | | |
+ +-+-+-+ + +-+ +-+-+ +-+-+-+-+-+ +-+-+ + +-+-+ + +-+-+-+-+ +-+-+-+-+ +-+ + +-+-+ +-+-+ +-+ + + +-+ +
| |       | |   |     |     |   |   |   |   |   |         |     |   | |     |   | | |   |     |     |
+ + +-+-+-+ +-+-+ +-+-+ +-+ + + +-+ +-+-+ +-+ +-+-+-+-+-+ +-+-+ + + + +-+-+-+ + + + + + +-+-+-+-+-+ +
| | |       |     |   | | | | |   |       |   |         |   | |   | |       | |   |   | |   |   |   |
+ + +-+ +-+ + +-+-+ + + + + + +-+ +-+-+-+ + +-+ + +-+-+ +-+ + +-+-+ + +-+-+ + +-+-+-+-+ + + + +-+ +-+
| |     |   | |     | | | | | |       |   | |   | |     |   |   |   |     | | |     |   | | |       |
+ + +-+-+-+-+ +-+-+-+ + + + + + +-+ +-+ +-+ + +-+ + +-+-+ +-+-+ + +-+-+-+-+ + + + + + +-+ + +-+-+-+ +
|   |         |       | | |   | |   |   |   | |   |   |   |   | | |         | | | |   |   |     |   |
+-+-+ +-+-+-+-+ +-+-+ + + +-+-+ + +-+ +-+ +-+-+ +-+-+-+ +-+ + + + +-+ +-+-+ + + + +-+-+ +-+-+-+ + +-+
|     |     |   |   | | |     | |   | | | |     |     |   | | |   |   |     | | |     |   |   | | | |
+ +-+-+ + +-+ + + + + + + +-+ + +-+ + + + + + +-+ +-+ +-+ + + + +-+ +-+ +-+-+ +-+ +-+ +-+ + + + + + +
|     | | |   | | | | | | |   |   | |   | | |       |   |   | |     |   |   |   |   | |   | |   | | |
+-+-+ + + + +-+ + +-+ + + + + +-+ +-+ +-+ +-+-+-+-+-+-+ +-+-+ +-+-+-+ +-+ + +-+ +-+ + + +-+ +-+-+ + +
|     | |   | | | |   | | | | | |     |   |         |   |     |   |   |   | | |   | |     | |   |   |
+ +-+-+ +-+-+ + + + +-+ + + + + +-+-+-+ +-+ +-+-+-+ + + + +-+ + + +-+ + +-+ + +-+ +-+ +-+-+ +-+ +-+ +
| |   |       | |   |   | | |   |     |     |     | | | | |   | |   |   | |     |   | |   |   |   | |
+ + +-+-+-+-+ + + +-+ +-+ + +-+ +-+-+ +-+-+-+ +-+ + + +-+ +-+-+ +-+ +-+-+ +-+-+ +-+ +-+ + +-+ + +-+ +
| |         | | | | |   | | | |   |       |     | | |   |       |   |   |     | | |     | |   |     |
+ + +-+-+-+ + + + + +-+ +-+ + +-+ + +-+-+-+ +-+ +-+ +-+ +-+-+-+-+ +-+ +-+ + +-+ + +-+-+-+ + +-+ +-+-+
| |   |   |   | | |   |     |       |       | |   |   |       |   |   |   |   | |   |   |   | |   | |
+ +-+ + + +-+-+ + + +-+-+-+-+ +-+-+-+ +-+-+-+ +-+ +-+ +-+ + +-+ +-+ + + +-+-+ + + +-+ + +-+-+ +-+ + +
| |     | |   | |   |     |       |   |         |   |   | | |   |   |       | | | |   |     |   |   |
+ +-+-+-+-+ + + +-+-+ +-+ + +-+-+-+ +-+-+ + +-+-+ + +-+ +-+ + +-+ +-+-+-+-+ + + + + +-+ +-+-+ + +-+ +
|           | |         | | | |   |   |   | |     |   | |   |   |   |   |   |     |   |   |   |   | |
+ +-+-+-+-+-+ + +-+-+-+-+ + + + + +-+ + +-+ + + +-+-+ + + +-+-+ +-+-+ + +-+-+-+-+-+-+ +-+ + +-+-+ + +
| |   |     | | |   |   |     | | |   | |   | | |   | |   |     |   | |             |   | | |   |   |
+ +-+ + +-+ + +-+ + + + +-+-+-+ + + +-+ +-+-+ +-+ + + + +-+ +-+-+ + + +-+-+-+-+-+-+ +-+ + + + +-+-+-+
|     | | | | |   |   | |       |   |       |     | | | |   |   | | | |   |   |     |   |   |       |
+-+-+ + + + + + +-+-+-+ + +-+-+-+-+-+ +-+-+ +-+-+-+ +-+ + + + + + + + +-+ + + + +-+-+ +-+-+-+ + +-+-+
|   | | |   | |     |   | |   |           |       |   | | | | | | |   |   | | |     | |     | | |   |
+ +-+ + + +-+ +-+-+ + +-+ + + + +-+-+-+-+ +-+-+ +-+-+ + + +-+ + + +-+-+ + + + +-+-+ + + +-+-+ + + + +
| |   | |     |     | |   | | | |   |   |   | | |     | |     | |   |   | | |   |   | | |     | | | |
+ + +-+ +-+-+ + +-+-+ + +-+ + + + +-+ + +-+ + + + +-+-+ +-+-+-+ +-+ + +-+-+ +-+ + +-+ + + +-+-+ + + +
|     | |     | |     |   | | |   |   | |     | |   |   |     | |   |     |   |   |   |       |   | |
+ +-+-+ + +-+-+ + +-+ +-+ + +-+ +-+ +-+ +-+-+-+ +-+ + +-+ +-+-+ + +-+-+ + +-+ +-+-+ +-+ +-+-+ +-+-+ +
|   |   |   |   | |   |   | |   |   | | |         |   |       | |     | |   |       |   |   |   |   |
+-+ + +-+-+-+ +-+ +-+-+ +-+ + +-+ +-+ + + +-+-+-+ +-+-+-+-+-+ + +-+-+ + +-+ +-+-+-+-+-+-+ + +-+ + + +
| | | |       | | |     | |   | |   | |   |     | |           |       |   |             | |   | | | |
+ + + + +-+-+-+ + + +-+-+ + +-+ +-+ + +-+-+ +-+ + +-+-+ +-+-+ +-+-+-+-+-+-+-+ +-+-+-+-+ + +-+ +-+ + +
| | | | |     | |   |       |     | |     | |   |       |   | |         |     |     |   | | |     | |
+ + + + +-+ + + +-+-+-+-+ +-+ + +-+ + +-+ + + +-+-+-+-+-+ +-+ + +-+ +-+ + +-+-+ + +-+ +-+ + +-+-+-+ +
| | | | |   |           |     | |   |   | | |         |       | | | |   | |   | |     |   |       | |
+ + + + + +-+-+-+-+-+-+ +-+-+-+-+ +-+ +-+ + +-+ +-+-+-+ +-+-+-+ + + + +-+ +-+ + +-+-+-+ +-+-+-+ +-+ +
|   | | | |     |     |         |   | |   |   |   |   | |       | | |     |   |       | |     |     |
+-+-+ + + + +-+ + + +-+-+-+-+-+ +-+ +-+ + +-+ +-+ + + + +-+-+ +-+ + +-+-+-+ +-+-+-+-+ + + +-+ + +-+-+
|     | |   |   | |       |   |     |   |   |   | | | |     |     | |   |   |       | | |   | |     |
+ +-+ + + +-+ +-+ +-+-+-+ + + +-+-+-+ +-+-+ +-+ + + + +-+-+ + +-+-+ + +-+ + + +-+ +-+ + +-+ + +-+-+-+
| |   | | |   | |   |   |   |         |   | | | | | |       | |     |     | | |   |   |     |       |
+ + +-+ + + +-+ +-+ + + +-+-+-+-+-+-+ + + + + + + + +-+-+-+-+-+ +-+-+-+-+ + + + +-+ +-+ +-+-+ +-+-+ +
| | |   | | |     |   |     |   |     | |     | |   |     |   | |       | |   |   | |   |   |   |   |
+ + + +-+-+ + +-+ +-+-+ +-+-+ + + + +-+-+-+-+ + +-+-+ +-+ + + + + + +-+ +-+-+-+-+ + +-+-+ + +-+-+ +-+
| | |       |   | |     |     |   | |   |   | | |     |   | |   | |   |           | |     | |   |   |
+ +-+-+-+-+-+ + +-+ +-+-+ +-+-+-+-+-+ + + + +-+ +-+ +-+ +-+ +-+-+ +-+ +-+-+-+-+-+-+ + +-+-+ + + +-+ +
|             |         |             |   |         |       |       |                 |       |     |
+-+-+-+-+-+-+-+-+-+-+-+-+-+-+-+-+-+-+-+-+-+-+-+-+-+-+-+-+-+-+-+-+-+-+-+-+-+-+-+-+-+-+-+-+-+-+-+-+-+-+