+-+-+-+-+-+
|         |
+ + + +-+ +
| | |   | |
+ + +-+ +-+
| |   |   |
+ +-+ +-+-+
|   |     |
+ +-+ +-+ +
|   |   | |
+-+-+-+-+-+