+-+-+-+-+
|       |
+-+ +-+ +
|     | |
+-+ +-+ +
|     | |
+-+ + + +
|   | | |
+-+-+-+-+