+-+-+-+-+-+-+-+-+-+-+-+-+-+-+-+-+-+-+-+-+-+-+-+-+-+-+-+-+-+-+-+-+-+-+-+-+-+-+-+-+-+-+-+-+-+
|                                                                                         |
+ + +-+-+-+ + + +-+ + + + + + +-+ + +-+-+-+-+ + + +-+-+ +-+ + + + +-+ +-+-+-+-+ + +-+ +-+ +
| |       | | |   | | | | | |   | |         | | |     |   | | | |   |         | |   |   | |
+ + + +-+ +-+-+ +-+-+ +-+-+-+ + + + +-+ +-+-+ +-+ + + + + +-+ +-+ + + + +-+ + + + + + +-+ +
| | |   |     |     |       | | | |   |     |   | | | | |   |   | | | |   | | | | | |   | |
+ + +-+-+-+-+-+-+-+-+-+ +-+ + +-+-+ + +-+-+ +-+-+ + +-+-+-+-+ +-+-+ + +-+ + +-+ +-+ + + +-+
| |                   |   | |     | |     |     | |         |     | |   | |   |   | | |   |
+ + + +-+-+ +-+ +-+-+ + +-+-+ + +-+ + + + +-+ +-+-+-+ +-+ +-+ + + +-+ +-+ +-+-+-+-+-+ +-+ +
| | |     |   |     | |     | |   | | | |   |       |   |   | | |   |   |           |   | |
+ +-+-+-+ + +-+-+ + +-+-+ +-+ + +-+ + +-+-+ + + +-+ +-+ +-+ +-+-+ +-+ + +-+ +-+-+-+-+-+ + +
|       | |     | |     |   | |   | |     | | |   |   |   |     |   | |   |           | | |
+ + + + + + + + + + +-+-+ + +-+ + +-+-+-+ + +-+ +-+-+-+-+ + + + + + +-+ +-+ +-+ + + +-+ +-+
| | | | | | | | | |     | |   | |       | |   |         | | | | | |   |   |   | | |   |   |
+ +-+-+-+ + +-+ + +-+ +-+-+-+ + + +-+-+-+ +-+-+-+ + +-+ + +-+-+-+ + +-+-+-+ + + + + + + +-+
|       | |   | |   |       | | |       |       | |   | |       | |       | | | | | | |   |
+ + + +-+ + + + + + + +-+-+-+ + +-+ +-+ + +-+ + + +-+-+ + +-+-+-+ +-+ +-+-+-+-+ +-+ +-+ +-+
| | |   | | | | | | |       | |   |   | |   | | |     | |       |   |         |   |   |   |
+ +-+ +-+ +-+-+-+-+-+-+-+ + + + +-+-+ +-+ + + +-+-+ + + +-+ + +-+-+ +-+-+-+ +-+-+ + +-+ +-+
|   |   |               | | | |     |   | | |     | | |   | |     |       |     | |   |   |
+ + +-+ + +-+ + + + +-+ +-+ + +-+-+ + + +-+ +-+-+ +-+ +-+ +-+-+ + + + +-+-+-+-+-+-+ +-+ +-+
| |   | |   | | | |   |   | |     | | |   |     |   |   |     | | | |             |   |   |
+ + +-+-+ + +-+-+-+ +-+-+ + +-+ + +-+ +-+-+-+ + +-+-+ +-+ + +-+-+-+ +-+ +-+-+-+-+ + + + + +
| |     | |       |     | |   | |   |       | |     |   | |       |   |         | | | | | |
+ +-+ +-+ +-+ + + + +-+-+-+-+ + +-+-+ + + +-+-+ + + +-+ + +-+-+ +-+ +-+-+ + +-+ +-+ +-+ + +
|   |   |   | | | |         | |     | | |     | | |   | |     |   |     | |   |   |   | | |
+ +-+ +-+-+ + + + +-+ +-+ +-+-+-+ + +-+-+ + + + +-+-+-+-+ + + + + +-+-+-+ +-+-+ + +-+-+-+ +
|   |     | | | |   |   |       | |     | | | |         | | | | |       |     | |       | |
+ + + + + + +-+-+ +-+ + + +-+ + +-+ + + + + + + +-+ + +-+-+-+-+-+-+ +-+ +-+-+-+ + + +-+ +-+
| | | | | |     |   | | |   | |   | | | | | | |   | |             |   |       | | |   |   |
+ + + + +-+ +-+-+ + +-+-+ + + +-+ + + +-+-+ + + +-+ +-+ + + +-+ +-+ + +-+-+-+-+ +-+ + + + +
| | | |   |     | |     | | |   | | |     | | |   |   | | |   |   | |         |   | | | | |
+ +-+-+-+ + + + +-+ + + + + +-+ +-+-+ +-+-+ + + +-+-+ + +-+-+-+-+ + +-+ +-+ + +-+ + +-+-+-+
|       | | | |   | | | | |   |     |     | | |     | |         | |   |   | |   | |       |
+ +-+ +-+-+-+ + +-+-+-+-+ +-+-+ +-+ + + + + + + +-+ +-+ + +-+-+ +-+-+ +-+ +-+-+ + +-+-+-+ +
|   |       | |         |     |   | | | | | | |   |   | |     |     |   |     | |       | |
+ +-+ +-+ + +-+ + + + +-+ +-+ +-+-+ + + + + +-+ +-+ +-+ +-+-+-+ +-+ +-+ +-+ + +-+-+-+-+-+-+
|   |   | |   | | | |   |   |     | | | | |   |   |   |       |   |   |   | |             |
+ + +-+-+-+ +-+-+ +-+-+-+ +-+-+-+ + +-+-+ + +-+-+-+-+ + +-+ + + +-+ +-+ + + +-+-+-+ +-+-+ +
| |       |     |       |       | |     | |         | |   | | |   |   | | |       |     | |
+ + +-+ + + + +-+-+ + +-+ + + +-+ + +-+ + +-+-+-+ +-+-+-+-+ +-+-+ +-+-+-+-+-+ + +-+-+-+ +-+
| |   | | | |     | |   | | |   | |   | |       |         |     |           | |       |   |
+ + +-+ + + + + + +-+ +-+ + + +-+-+ + +-+-+-+ +-+-+ + +-+ + + +-+ + +-+-+ + + + + +-+ + +-+
| |   | | | | | |   |   | | |     | |       |     | |   | | |   | |     | | | | |   | |   |
+ + +-+-+-+-+-+ +-+-+-+ +-+ +-+ +-+-+ + + +-+-+ +-+-+ + +-+ + +-+ +-+ +-+ + + + +-+-+ + + +
| |           |       |   |   |     | | |     |     | |   | |   |   |   | | | |     | | | |
+ + + +-+-+ + +-+ + +-+ + +-+-+-+-+-+ +-+-+-+ + +-+ + +-+ + + +-+ + +-+ +-+ +-+ + + +-+-+ +
| | |     | |   | |   | |           |       | |   | |   | | |   | |   |   |   | | |     | |
+ +-+ + + +-+ +-+ + +-+ +-+-+-+ + + +-+ +-+ + + + + + + +-+ + + + + + + +-+-+ + + +-+-+-+ +
|   | | |   |   | |   |       | | |   |   | | | | | | |   | | | | | | |     | | |       | |
+ + + + + + +-+-+ + +-+ +-+-+ +-+-+-+-+ + +-+-+-+-+-+ +-+-+-+-+-+-+-+ + + + +-+-+ + +-+-+-+
| | | | | |     | |   |     |         | |           |               | | | |     | |       |
+ +-+ +-+-+-+-+ + + +-+-+-+ +-+-+ +-+-+ +-+ + + + +-+-+-+-+ +-+ +-+ + + +-+-+ + +-+ + +-+ +
|   |         | | |       |     |     |   | | | |         |   |   | | |     | |   | |   | |
+ +-+ + +-+ +-+-+ + + +-+ +-+-+-+-+ + + + +-+-+-+ +-+-+ +-+-+-+-+-+ +-+-+-+ + + +-+ + + + +
|   | |   |     | | |   |         | | | |       |     |           |       | | |   | | | | |
+ +-+-+-+-+ + + + +-+ + + + + + + +-+-+-+ +-+ +-+-+ + +-+-+-+-+ + + + +-+-+-+-+ + + +-+ +-+
|         | | | |   | | | | | | |       |   |     | |         | | | |         | | |   |   |
+ + +-+ + +-+ +-+ + +-+ + + + + +-+-+-+ +-+ + + +-+ + +-+ + +-+ +-+-+-+ + + + +-+-+-+-+-+-+
| |   | |   |   | |   | | | | |       |   | | |   | |   | |   |       | | | |             |
+ + + + + + +-+-+-+ +-+-+ + +-+-+-+-+ + +-+ +-+-+-+-+-+-+-+ +-+ + +-+-+ +-+ +-+ + +-+-+ +-+
| | | | | |       |     | |         | |   |               |   | |     |   |   | |     |   |
+ + + + +-+ + +-+ +-+-+-+ + + + +-+ +-+-+-+-+-+ + +-+-+-+-+ + +-+ + +-+-+ + + +-+-+ + +-+-+
| | | |   | |   |       | | | |   |           | |         | |   | |     | | |     | |     |
+ + + + + +-+-+-+ + +-+ +-+ + + +-+-+-+-+-+-+-+-+-+ + +-+ + +-+ +-+ + + + + + +-+-+ +-+-+ +
| | | | |       | |   |   | | |                   | |   | |   |   | | | | | |     |     | |
+ + + + +-+ +-+-+ + + +-+ +-+-+-+ +-+-+ +-+ +-+-+-+-+ +-+ + + + +-+ + + +-+-+-+-+ + +-+-+-+
| | | |   |     | | |   |       |     |   |         |   | | | |   | | |         | |       |
+ + + + +-+-+ +-+ +-+ + +-+-+ +-+-+ +-+-+ + +-+ +-+-+-+ +-+-+-+-+ + +-+ +-+ +-+ +-+ +-+ +-+
| | | |     |   |   | |     |     |     | |   |       |         | |   |   |   |   |   |   |
+ +-+-+ +-+ +-+ +-+ +-+-+ +-+ +-+ + + + + +-+-+-+-+ + +-+-+ + +-+ +-+ +-+ +-+-+ +-+-+ + +-+
|     |   |   |   |     |   |   | | | | |         | |     | |   |   |   |     |     | |   |
+ +-+-+-+-+-+ + +-+ +-+-+ + + +-+-+ + + + + +-+-+ +-+ + +-+ +-+ +-+-+ + +-+-+ + + + + + +-+
|           | |   |     | | |     | | | | |     |   | |   |   |     | |     | | | | | |   |
+ + + +-+-+ + +-+ +-+ + + +-+-+-+-+ +-+-+ +-+-+-+ +-+-+ +-+-+-+ +-+-+ + + +-+ + + +-+ + + +
| | |     | |   |   | | |         |     |       |     |       |     | | |   | | |   | | | |
+ + + +-+-+ + +-+-+-+ +-+-+-+ +-+ + +-+-+-+-+ + + + + + +-+-+-+-+-+-+-+ + + +-+-+ + +-+-+ +
| | |     | |       |       |   | |         | | | | | |               | | |     | |     | |
+ + + +-+-+ +-+-+ +-+-+-+-+ + +-+-+ + +-+ + + + + +-+-+-+-+-+-+-+ +-+-+-+-+ +-+-+-+-+ +-+ +
| | |     |     |         | |     | |   | | | | |               |         |         |   | |
+ + +-+ + + + +-+ +-+-+ + + +-+-+-+-+ +-+ + +-+ +-+ +-+ + +-+-+-+ +-+ + + +-+ +-+-+-+ + +-+
| |   | | | |   |     | | |         |   | |   |   |   | |       |   | | |   |       | |   |
+ +-+ + +-+ +-+ + +-+ + + +-+ +-+ + +-+-+-+ + + + +-+-+-+ + + +-+ +-+-+ +-+ +-+ + +-+-+-+-+
|   | |   |   | |   | | |   |   | |       | | | |       | | |   |     |   |   | |         |
+ +-+ +-+ + + +-+-+-+ + + + +-+ + +-+-+ +-+-+ +-+-+-+-+-+ + +-+ + +-+ +-+-+-+-+ +-+ + + +-+
|   |   | | |       | | | |   | |     |     |           | |   | |   |         |   | | |   |
+ +-+ +-+ +-+-+ +-+-+-+ + +-+ + +-+ + + + + +-+-+-+-+-+ +-+-+-+-+-+ + + +-+ + +-+-+ +-+ + +
|   |   |     |       | |   | |   | | | | |           |           | | |   | |     |   | | |
+ + +-+ + +-+ +-+ + +-+ + +-+ + +-+ + + + +-+ + +-+ +-+ + +-+ +-+-+ +-+-+ +-+-+ +-+ + + +-+
| |   | |   |   | |   | |   | |   | | | |   | |   |   | |   |     |     |     |   | | |   |
+-+-+-+-+-+-+-+-+-+-+-+-+-+-+-+-+-+-+-+-+-+-+-+-+-+-+-+-+-+-+-+-+-+-+-+-+-+-+-+-+-+-+-+-+-+