+-+-+-+-+-+
| |       |
+ + +-+-+ +
|   | |   |
+-+-+ + +-+
|   |   | |
+ + + +-+ +
| | | |   |
+ +-+ +-+ +
|         |
+-+-+-+-+-+