+-+-+-+-+-+-+-+
|             |
+ +-+ + + + +-+
|   | | | |   |
+ + + +-+-+ +-+
| | |     |   |
+ +-+ +-+-+-+ +
|   |       | |
+ +-+ + +-+ +-+
|   | |   |   |
+ +-+-+ +-+ +-+
|     |   |   |
+ + +-+ + + +-+
| |   | | |   |
+-+-+-+-+-+-+-+