+-+-+-+-+-+
|         |
+ +-+-+-+ +
|       | |
+ +-+-+-+-+
|         |
+ + + +-+ +
| | |   | |
+ + +-+ + +
| |   | | |
+-+-+-+-+-+