+-+-+-+-+-+-+-+-+-+-+-+-+-+-+-+-+-+-+-+-+-+-+-+-+-+-+-+-+-+-+-+-+-+-+
|                                                                   |
+ + + + + + + + + +-+ + + + + + + + + +-+ + +-+ + + + + +-+ + + + +-+
| | | | | | | | | |   | | | | | | | |   | | |   | | | | |   | | |   |
+ +-+-+ + + +-+ +-+ + + +-+ +-+ + + +-+ +-+ + +-+-+ + + + + + + + + +
|     | | | |   |   | | |   |   | | |   |   |   |   | | | | | | | | |
+-+ + + + + + + +-+-+ + +-+ + +-+ +-+ + + + + + + +-+-+-+ + + +-+ + +
|   | | | | | |     | | |   | |   |   | | | | | | |       | |   | | |
+-+-+ + +-+ +-+-+ + +-+ + + +-+-+ +-+-+-+ +-+ + +-+ + + + +-+ +-+-+ +
|     |   |     | | |   | |     | |       |   | |   | | | |   |     |
+-+ + + +-+ + + + + + + + +-+ +-+ + +-+-+ + +-+ + +-+-+ + + + + + + +
|   | | |   | | | | | | |   |   | |   |   | |   | |     | | | | | | |
+ +-+ +-+ + + + + +-+-+ + + +-+ + + +-+-+-+ +-+ + + +-+ + + + +-+ + +
|   |   | | | | |     | | | |   | | |       |   | | |   | | |   | | |
+ + + + +-+ +-+ + +-+-+ + +-+ + + + +-+-+ + + + + + +-+ + + + + + + +
| | | | |     | |     | | |   | | |     | | | | | |   | | | | | | | |
+-+ +-+ +-+ + +-+ + + +-+ + + + + + + + + +-+ +-+ + + +-+-+ + + + + +
|   |     | |   | | |   | | | | | | | | | |     | | |   |   | | | | |
+ + + +-+-+ + +-+ + + + +-+ + +-+ +-+ + +-+-+-+-+-+-+-+-+ +-+-+ + + +
| | |   |   |   | | | |   | | |   |   |               |       | | | |
+ + +-+-+ + + + + + + + + + + +-+ + +-+ +-+-+ + +-+ +-+ + +-+ + + + +
| |   |   | | | | | | | | | |   | |   |     | |   | |   |   | | | | |
+ +-+-+-+ +-+-+ +-+ + + + +-+ +-+-+ +-+-+-+ + +-+ +-+ + +-+ +-+-+ + +
|       |   |   |   | | |   |   |       |   |   | |   |   |   |   | |
+ + + +-+ + +-+-+-+ +-+ + + + + +-+-+-+ +-+-+-+ + +-+-+ + + + + + + +
| | | |   |   |     |   | | | | |           |   | |     | | | | | | |
+ + + +-+ + + +-+ + +-+ +-+-+ +-+ +-+ +-+-+ + + +-+ + +-+ +-+-+ + + +
| | | |   | |   | | |       | |     | |     | | |   |   | |     | | |
+ + +-+-+ +-+ +-+ + +-+-+ + + +-+ + + + +-+ + + +-+-+ + + +-+-+ +-+ +
| | |       | |   |   |   | | |   | | | |   | |   |   | | |       | |
+ + +-+ +-+-+ +-+ + +-+ +-+-+ +-+ + + +-+-+ +-+ +-+ + + +-+ +-+-+-+ +
| | |     |     | |   | |       | | |     | |   |   | |   |       | |
+ +-+ + + + +-+ + + + + + + +-+ +-+ +-+ + + +-+ + +-+ + + + +-+ + + +
| |   | | |   | | | | | | |   |   | |   | |   | |   | | | |   | | | |
+ +-+ + +-+-+-+-+ + + +-+-+ + +-+-+-+-+ + +-+ + + + +-+ +-+-+-+-+ + +
|   | |   |       | |   |   | |         |   | | | | |           | | |
+ + +-+ + +-+-+ + + +-+ +-+ + +-+ + + + + + + +-+-+ + +-+-+ +-+ +-+-+
| | |   |   |   | | |     | |   | | | | | | | |     |     | |       |
+ +-+ +-+-+-+ +-+ + + + + + + + + + +-+ +-+-+ + +-+ + +-+ + + +-+-+ +
|   |       |   | | | | | | | | | | |       | |   | |   | | |   |   |
+ + + + + +-+ + + + + + + + + +-+ + +-+ +-+-+ +-+ + +-+ + +-+-+-+ + +
| | | | |   | | | | | | | | |   | |   |     | |   |   | |   |     | |
+-+ + + + +-+ +-+ + + + + +-+ + + + + + + + + + +-+ + + +-+ +-+-+ + +
|   | | | |   |   | | | | |   | | | | | | | | | |   | |   |   |   | |
+ +-+-+ + +-+ +-+-+ +-+-+ + + + + + + + + +-+ +-+ +-+ +-+-+ + + +-+ +
| |     |   | |         | | | | | | | | | |   |     | |     | | |   |
+ + + + + +-+ +-+ +-+-+ +-+-+ + +-+ +-+-+ + +-+ + +-+ + +-+ + +-+ + +
| | | | | |     |     | |     | |       | |   | |   | |   | |   | | |
+ + + + +-+-+ + + + +-+ + + +-+ + +-+ + + +-+ + +-+ +-+ + +-+ + +-+ +
| | | | |     | | |   | | |   | |   | | | |   |   | |   | |   |   | |
+-+ + + +-+ + + + + +-+ +-+ + + + + +-+-+ + + +-+ +-+ + + +-+-+ + + +
|   | | |   | | | |   | |   | | | |   |   | |   | |   | | |     | | |
+ + + +-+-+ +-+-+-+ +-+-+ + + + +-+-+-+ + + + +-+ + + + + + +-+ + + +
| | |     | |           | | | |     |   | | | |   | | | | |   | | | |
+-+ +-+-+ + + + +-+ + +-+-+ +-+-+ +-+ +-+ + + +-+ + + + + + + +-+ + +
|       | | | |   | |   |     |   |     | | | |   | | | | | | |   | |
+ + +-+ + + + +-+-+ +-+ +-+ + + + + + + + + +-+-+-+-+-+ + + + + + + +
| |   | | | |     |   | |   | | | | | | | |           | | | | | | | |
+-+ + +-+-+ + +-+ + + + + + + + + + + + + +-+ + + + + +-+-+ +-+-+ + +
|   |   |   | |   | | | | | | | | | | | | |   | | | |   |     |   | |
+-+ +-+ + +-+ + + + +-+ + +-+-+-+-+-+ + + +-+ + + + + + + +-+ + +-+ +
|   |   | |   | | |   | |       |     | | |   | | | | | | |   | |   |
+ + + +-+ + +-+ + + + +-+ +-+ + + +-+-+ + + +-+ + + + +-+ + + + + + +
| | | |   | |   | | |   | |   | |     | | |   | | | |   | | | | | | |
+ + +-+-+-+-+ + + +-+ +-+ + +-+ + + + + + + + + + +-+-+ + + + +-+ + +
| |       |   | | |     | |   | | | | | | | | | | |     | | |   | | |
+ +-+ +-+ + + + +-+-+ +-+ +-+-+ +-+-+-+ +-+-+ +-+ +-+ + +-+ + +-+ + +
| |     | | | |   |     | |           | |       |   | |   | |   | | |
+-+-+-+-+-+-+-+-+-+-+-+-+-+-+-+-+-+-+-+-+-+-+-+-+-+-+-+-+-+-+-+-+-+-+