+-+-+-+-+-+-+-+
|             |
+ + + + + + + +
| | | | | | | |
+ +-+ +-+ +-+-+
|   |   |     |
+ + + +-+-+ + +
| | |     | | |
+ + + +-+ +-+ +
| | |   |   | |
+ +-+ + + +-+-+
|   | | |     |
+ + + +-+ +-+-+
| | |   |     |
+-+-+-+-+-+-+-+