+-+-+-+-+-+-+-+-+-+-+-+-+-+-+-+
|       |       |     |       |
+-+-+-+ + +-+-+-+ + +-+ + +-+ +
|   |   |       | |     | |   |
+ +-+ +-+-+-+-+ + +-+-+-+ +-+ +
|     |       |   |   | |   | |
+ +-+-+-+ +-+ + +-+ + + +-+ + +
|   |     | | | |   | |   | | |
+-+ +-+ +-+ + + + +-+ + + + + +
| |   |   |   |   | |   | | | |
+ +-+ +-+ + +-+-+-+ +-+-+ + +-+
|   | |   |       | |     |   |
+-+ + + +-+-+-+-+ + + +-+-+-+ +
|   |   |       | | | |     | |
+ +-+-+-+ + +-+-+ + + + +-+ + +
|       | | |     |   | |   | |
+ +-+ +-+ + + +-+-+ +-+-+ + + +
| |   |   |   |   |       | | |
+-+ +-+ +-+-+-+ + +-+-+-+ +-+ +
|   |   |     | |         |   |
+ + + +-+-+ + +-+-+-+-+-+ + +-+
| | |   |   |           | |   |
+ + +-+ + +-+-+-+-+-+-+ +-+-+ +
| | |   |   |     |     |     |
+ + + +-+ + + +-+ + +-+-+ +-+ +
| | |   | | |   | | |     |   |
+ +-+-+ +-+ +-+ + + +-+ + + +-+
|     | |   |   | |   | | | | |
+ + +-+ + +-+ +-+ +-+ +-+ + + +
| |       |     |         |   |
+-+-+-+-+-+-+-+-+-+-+-+-+-+-+-+