+-+-+-+-+-+-+-+-+-+-+-+-+-+-+-+-+-+-+-+-+-+-+-+-+-+-+-+-+-+-+-+-+-+-+-+-+-+-+-+-+-+-+-+-+
|                                                                                       |
+ + +-+ + + +-+-+ + + + + +-+ + + + + + +-+-+-+ + + +-+ + + +-+ +-+ + +-+-+ + + + + +-+ +
| |   | | |     | | | | | |   | | | | |       | | | |   | | |     | |     | | | | | |   |
+ + +-+ +-+ + +-+ + +-+ + +-+ + +-+ +-+ + + +-+ +-+-+-+ + +-+ + + +-+ +-+ +-+ + +-+ + + +
| |   |   | |   | | |   |   | |   | |   | | |       |   |   | | | |     | |   |   | | | |
+ +-+-+-+-+-+-+-+ +-+-+ + +-+ + + + + + + + +-+ + + +-+-+ +-+ + +-+ +-+ + + + +-+-+ + + +
|               |   |   | |   | | | | | | |   | | |     |   | |   | |   | | |     | | | |
+ + + + + +-+-+-+ + + + +-+ +-+-+ + +-+-+-+-+ + + +-+ + + +-+ +-+-+ +-+ + + + +-+ + +-+ +
| | | | | |       | | | |       | |     |     | |   | | | |     |     | | | | |   | |   |
+ + +-+ + +-+ +-+-+-+ + + +-+-+ + + + + +-+-+-+ + + + + + + + + +-+-+ +-+ + +-+ + +-+ + +
| | |   |   |       | | |   |   | | | |     |   | | | | | | | |     |   | |   | |   | | |
+ + + +-+ + + +-+ + + +-+-+ + + + + + + + + +-+-+-+ + + + + +-+ + +-+ + + + + + +-+-+ +-+
| | | |   | | |   | |     | | | | | | | | |   |     | | | |   | |   | | | | | | |       |
+ + + + + +-+-+ + + +-+-+ + + + + + +-+ +-+ + + + + + +-+ + +-+ + +-+ + + + + + + +-+ + +
| | | | |     | | |     | | | | | |   |   | | | | | |   | | |   | |   | | | | | | |   | |
+-+ + + +-+ +-+ + + +-+ +-+ +-+-+ + + + + + +-+ + + +-+ + + + + +-+ + + + +-+-+ + +-+ +-+
|   | |   |   | | |   | |   |     | | | | | |   | | |   | | | | |   | | | |     |   |   |
+-+-+ + + +-+-+ + + + +-+-+ + + + + + + + + + + + +-+-+ + +-+ +-+ +-+-+ + + + + +-+ +-+-+
|     | |     | | | |   |   | | | | | | | | | | |     | | |     | |     | | | |   |     |
+ +-+-+ + + + +-+-+ + +-+ + +-+ +-+ + +-+-+-+ + +-+ + + +-+ + +-+ + +-+ + + +-+ +-+ +-+ +
| |     | | | |     |   | |   |   | |   |     |   | | |   | |   | |   | | |   | |   |   |
+ +-+ +-+-+-+-+-+ +-+ + + + +-+-+ + +-+ + + +-+ + + + + + + + + + + + + + +-+-+ + + + + +
| |         |     |   | | |     | |   | | | |   | | | | | | | | | | | | |     | | | | | |
+ +-+ + + + +-+-+ + + +-+-+ + + + + + + +-+-+ +-+-+-+ +-+ +-+ + + + + + + + + +-+-+ +-+ +
| |   | | |   |   | |   |   | | | | | | |           | |     | | | | | | | | |   |   |   |
+ + + + + +-+-+ + +-+-+ +-+ + + +-+ + + + + + +-+ +-+ + + + + +-+ + +-+-+ +-+ + + + + +-+
| | | | |     | |   |     | | | |   | | | | | |     | | | | |   | |   |   |   | | | |   |
+-+ + +-+ + + + + + +-+ + + + + + +-+-+ + + +-+-+-+ + +-+ + + + +-+ + +-+ + + +-+-+ + + +
|   |   | | | | | |   | | | | | |     | | |       | |   | | | | |   |   | | | |     | | |
+ + + +-+ + + + +-+-+ +-+ +-+-+ + + +-+-+ + + +-+ + + +-+ +-+-+-+ +-+-+ + + +-+-+ +-+ + +
| | | |   | | | |       |   |   | | |     | | |   | |   | |       |     | | |       | | |
+ +-+ +-+ +-+ + + + +-+ +-+ + + +-+ +-+ +-+ + +-+ + + + +-+ +-+ + +-+ + +-+ + + +-+ + +-+
|   |   |   | | | | |     | | | |   |     | | |   | | | |   |   | |   |   | | |   | |   |
+ + +-+ + + + + +-+ + + +-+ + + + + +-+ + + +-+ + + +-+ +-+-+-+-+ +-+-+ +-+ + + +-+ + + +
| | |   | | | | |   | |   | | | | | |   | | |   | | |         |     |   |   | | |   | | |
+-+-+ +-+ +-+ +-+ + + +-+-+ +-+ + +-+ + + +-+ +-+-+ + +-+-+ + + + + + +-+ + + + +-+-+-+ +
|       |   | |   | |     | |   |   | | | |     |   | |     | | | | |   | | | | |       |
+ +-+ +-+-+ + + + + +-+-+ + +-+-+-+ + + + + + +-+-+ + + + + + +-+-+-+ + + +-+ +-+ +-+-+ +
|   | |     | | | | |     |     |   | | | | |     | | | | | |   |     | |   |   | |     |
+-+ +-+ +-+-+-+ +-+ + + +-+ + + + + + + +-+-+ + + +-+ +-+-+-+ +-+-+ + + + + + + + + + + +
|   |         | |   | |   | | | | | | |   |   | | |       |   |     | | | | | | | | | | |
+ + + + + +-+-+-+ +-+ + + + + + +-+-+ + +-+-+ + + + +-+ +-+ + +-+-+-+ + + + + + +-+ +-+ +
| | | | |   |       | | | | | |   |   |     | | | | |   |   |       | | | | | | |   |   |
+ + +-+-+ +-+ + +-+-+ +-+ + + + +-+ +-+ + + + +-+ +-+ + + + + + +-+ + +-+ +-+ + + + +-+-+
| |   |   |   |     | |   | | |   |   | | | |   |   | | | | | |   | | |     | | | |     |
+-+ +-+-+ +-+ +-+ +-+ +-+ + + +-+ + +-+ + + +-+-+ +-+ +-+ +-+ + + +-+ + + +-+ +-+ +-+-+-+
|   |       |   |   |   | | |   | | |   | |   |   |     | |   | |   | | |   | |         |
+ + + +-+-+ + + + + + +-+ + + +-+ + + +-+ + + +-+ + + + +-+ +-+-+ + +-+ + + + + + + + +-+
| | | |     | | | | |   | | |   | | |   | | | |   | | |   | |     | |   | | | | | | |   |
+ +-+ +-+ + + +-+ + + +-+ + + + +-+ +-+ + +-+-+ + +-+ + + +-+-+ +-+-+-+ + + +-+-+-+-+ + +
|   |   | | |   | | | |   | | | |     | |   |   | |   | | |     |       | |     |     | |
+ + + + + + + + + +-+ + + + +-+ +-+ + +-+-+ + + + +-+-+-+ + + +-+ + + +-+-+ +-+ + + + + +
| | | | | | | | |   | | | | |   |   |     | | | |     |   | |   | | | |       | | | | | |
+ + + + + + +-+-+ +-+ +-+ + +-+-+-+-+-+ + +-+ + + + + +-+ + +-+-+ +-+ + +-+ +-+ + +-+ +-+
| | | | | | |     |   |   |           | | |   | | | | |   | |       | |   |   | | |     |
+ + +-+ +-+ + + +-+ + + + + + +-+-+ + + +-+-+ +-+-+ + + + + + + + +-+ + + + + + +-+-+ + +
| | |     | | | |   | | | | | |     | | |         | | | | | | | |   | | | | | | |     | |
+-+ + + + + + + + + + + + +-+-+ + +-+ +-+-+-+ +-+-+ + + + + + + + + + + + +-+ + + + + + +
|   | | | | | | | | | | | |     |   |   |     |     | | | | | | | | | | | |   | | | | | |
+ +-+ + +-+ + + + + + + + + + + + + + + +-+ + +-+-+ + + + + +-+ + + + +-+ + + + + + + + +
| |   | |   | | | | | | | | | | | | | | |   |   |   | | | | |   | | |   | | | | | | | | |
+ + + + + + + + + +-+ +-+ + +-+ +-+ + +-+ +-+ + + + + + +-+-+-+ +-+ + + + + +-+ + + +-+ +
| | | | | | | | | |   |   |   | |   | |     | | | | | |       |   | | | | |   | | | |   |
+ +-+ + + + + + + + + +-+ + + + + + +-+ +-+ + +-+ + +-+ + + + +-+-+ + + + +-+ +-+ + +-+ +
|   | | | | | | | | | |   | | | | |   |   | |   | |   | | | |   |   | | | |     | |   | |
+-+ + +-+-+ + + +-+ +-+ + + + + + + +-+ +-+ + + +-+-+-+ + + + + + + + +-+ + +-+ +-+ + + +
|   | |     | |   | |   | | | | | | |     | | | |       | | | | | | |   | | |     | | | |
+ +-+-+ + + + + + + + + +-+ +-+ +-+-+ + + +-+ + +-+ + +-+ + + + +-+ + + + +-+-+ +-+-+ + +
| |     | | | | | | | |   | |       | | |   | |   | | |   | | |   | | | |   |   |     | |
+ +-+ + +-+ +-+ + + +-+ + +-+-+ + + + + + + +-+ + +-+ + +-+ + + + + +-+ +-+-+ + +-+-+ + +
| |   | |     | | |   | |     | | | | | | | |   | |   |   | | | | | |     |   | |     | |
+ +-+-+ + + +-+ +-+-+-+-+ +-+ +-+ + +-+-+ +-+ + + + + +-+ + + + +-+ + + +-+-+ + + +-+ + +
|     | | | |       |       | |   | |       | | | | | |   | | | |   | |     | | | |   | |
+ +-+-+ + + + + + + +-+-+ + + +-+ + + + + + + + + +-+-+ +-+ +-+-+ + +-+-+ +-+ +-+ + + + +
| |     | | | | | |   |   | |   | | | | | | | | |     |   | |     |   |     | |   | | | |
+ + +-+ +-+-+ + +-+ + + + + + + +-+-+-+ + + + + + + +-+-+ + + + +-+ + + +-+ +-+-+-+ +-+ +
| | |       | |   | | | | | | | |       | | | | | |     | | | |   | | | |   |       |   |
+-+ +-+-+-+ + + +-+ + + + +-+ + + + +-+-+ + + + +-+-+ + + + + + + + + +-+ + + +-+ + + +-+
|     |     | | |   | | |   | | | |     | | | | |     | | | | | | | |   | | |   | | |   |
+ + + +-+ + + +-+-+-+ +-+-+-+-+-+ + +-+ + + + + +-+ + +-+ + +-+ + +-+ +-+ +-+-+ + +-+ + +
| | |   | | |   |     |           |   | | | | | |   |   | |   | |   | |     |   |   | | |
+ + +-+ + + + + + + +-+ + +-+ + + + +-+-+ +-+ + + +-+ + +-+ + + + + + +-+-+ + + + + + +-+
| | |   | | | | | | |   | |   | | |     |   | | |   | | |   | | | | |     | | | | | |   |
+ +-+ +-+-+-+ + + + + +-+ + +-+ + + + + +-+ + + + + +-+ + + +-+ + + +-+ + +-+ + + +-+ + +
|   |     |   | | | | |   |   | | | | |   | | | | | |   | | |   | |   | | |   | |   | | |
+ + +-+-+ + + +-+ +-+ + +-+ +-+ +-+ +-+ +-+ +-+-+ +-+ + + +-+-+ + + +-+ + + + +-+-+-+ + +
| |   |   | | |   |   |   |   | |   |     | |     |   | |     | | |   | | | |       | | |
+-+-+-+-+-+-+-+-+-+-+-+-+-+-+-+-+-+-+-+-+-+-+-+-+-+-+-+-+-+-+-+-+-+-+-+-+-+-+-+-+-+-+-+-+