+-+-+-+-+-+-+-+-+-+-+-+-+-+-+-+-+-+-+-+-+-+-+-+-+-+-+-+-+-+-+-+-+-+-+-+-+-+-+-+-+-+-+-+-+-+-+-+-+-+-+
|                                                                                                   |
+ +-+-+ +-+ + + +-+ + +-+-+-+-+-+-+-+-+-+-+-+-+-+-+ +-+-+-+ +-+ + +-+-+-+ +-+ +-+ +-+ +-+ + +-+-+ + +
|     |   | | |   | |                             |       |   | |       |   |   |   |   | |     | | |
+ +-+ + +-+-+-+-+-+-+-+ +-+ +-+ + + + +-+-+-+-+-+-+-+ + + +-+ + + + +-+-+-+-+ + + +-+ + + +-+-+-+-+-+
|   | |               |   |   | | | |               | | |   | | | |         | | |   | | |           |
+ + +-+ + +-+-+ + +-+ +-+-+-+ + + +-+ + + +-+ + +-+ + +-+-+-+ + +-+-+-+-+ +-+-+ + +-+ +-+ +-+-+ + + +
| |   | |     | |   |       | | |   | | |   | |   | |       | |         |     | |   |   |     | | | |
+ + +-+-+ + +-+-+-+ +-+ + + + + +-+ +-+ +-+-+-+-+-+-+ +-+-+-+-+ +-+-+-+-+ + + +-+ +-+ + + +-+-+-+-+-+
| |     | |       |   | | | | |   |   |             |         |         | | |   |   | | |           |
+ + + + + + + +-+ + +-+-+ +-+ + + + +-+-+ +-+ + + + +-+-+ + + + + + + + +-+ + + + + + +-+ + +-+-+ +-+
| | | | | | |   | |     |   | | | |     |   | | | |     | | | | | | | |   | | | | | |   | |     |   |
+ + + + + + + +-+-+ + +-+-+-+-+ + + + + +-+ +-+ +-+-+-+-+ +-+ +-+ + + + +-+ + +-+-+-+ +-+ + + + + +-+
| | | | | | |     | |         | | | | |   |   |         |   |   | | | |   | |       |   | | | | |   |
+ + +-+ +-+-+-+-+-+ +-+-+-+ +-+-+ + +-+-+-+-+-+ +-+-+-+ + +-+-+ +-+-+ + + +-+ +-+ + +-+-+-+-+-+ + + +
| |   |           |       |     | |           |       | |     |     | | |   |   | |           | | | |
+ +-+ +-+-+-+-+-+ +-+-+-+ +-+-+ +-+ + +-+-+-+ + + +-+ +-+ +-+-+-+ + +-+-+-+ + + +-+-+-+ +-+ + + + +-+
|   |           |       |     |   | |       | | |   |   |       | |       | | |       |   | | | |   |
+ +-+-+ + +-+ +-+ +-+ + + + + + + +-+-+-+-+-+ +-+ + + +-+ +-+-+ + +-+-+-+ +-+ + +-+-+-+ +-+-+ + +-+ +
|     | |   |   |   | | | | | | |           |   | | |   |     | |       |   | |       |     | |   | |
+ + + +-+-+ + +-+ +-+-+ + + + + +-+ +-+-+-+-+ + + +-+-+-+-+-+-+-+-+-+ + + +-+ + +-+ + + +-+-+-+ + +-+
| | |     | |   |     | | | | |   |         | | |                   | | |   | |   | | |       | |   |
+ + + +-+-+-+-+ +-+-+ +-+-+-+-+-+ + + + + + + + + +-+ + +-+-+-+-+-+-+ +-+ +-+-+-+-+-+ + + +-+-+-+ + +
| | |         |     |           | | | | | | | | |   | |             |   |           | | |       | | |
+ +-+-+ + + + + +-+ +-+ +-+-+ + +-+-+-+ +-+-+-+ +-+ + + +-+-+-+-+ +-+-+ + +-+ +-+-+-+-+-+-+-+ + +-+ +
|     | | | | |   |   |     | |       |       |   | | |         |     | |   |               | |   | |
+ + + + +-+ + + + +-+ +-+ +-+ +-+-+ + +-+ + +-+-+ + +-+ +-+-+ + +-+ + +-+-+ + +-+-+ +-+ + + + + +-+ +
| | | |   | | | |   |   |   |     | |   | |     | |   |     | |   | |     | |     |   | | | | |   | |
+ +-+-+ +-+ +-+ +-+ + +-+ + + + + +-+ +-+ +-+-+ + +-+-+-+-+ + +-+-+-+ +-+ + +-+-+-+ +-+ + +-+-+-+ + +
|     |   |   |   | |   | | | | |   |   |     | |         | |       |   | |       |   | |       | | |
+ +-+-+ + + +-+ + + +-+-+ +-+ +-+-+-+-+ +-+-+ +-+ +-+-+-+ + +-+ +-+-+-+ +-+ + +-+ + + + + +-+ + +-+ +
|     | | |   | | |     |   |         |     |   |       | |   |       |   | |   | | | | |   | |   | |
+ +-+-+-+ +-+-+ +-+ + + + + +-+ + +-+ + + + + + +-+ + + + +-+ +-+ + + + + + +-+ + + +-+-+-+ +-+ + + +
|       |     |   | | | | |   | |   | | | | | |   | | | |   |   | | | | | |   | | |       |   | | | |
+ +-+-+ + + + + +-+-+ +-+ +-+-+ +-+-+-+ +-+-+ +-+ + + + +-+ +-+-+-+ +-+ +-+-+-+-+ + +-+ + +-+-+ + +-+
|     | | | | |     |   |     |       |     |   | | | |   |       |   |         | |   | |     | |   |
+ + + + + + +-+ + + +-+ +-+-+ +-+-+-+-+-+-+-+-+-+ +-+-+-+ + + +-+ + + +-+-+-+ +-+-+-+ + +-+-+-+ + +-+
| | | | | |   | | |   |     |                   |       | | |   | | |       |       | |       | |   |
+ + +-+ + +-+-+-+-+-+ + +-+ + + + + +-+ + +-+ + +-+ + + +-+-+-+ +-+ +-+-+-+-+ + +-+ +-+-+ + +-+ + + +
| |   | |           | |   | | | | |   | |   | |   | | |       |   |         | |   |     | |   | | | |
+ +-+-+ + +-+ +-+-+-+-+ +-+ +-+-+ + + + +-+-+-+ + +-+-+-+ +-+-+-+-+ + +-+ +-+ +-+ + +-+ +-+ + +-+ + +
|     | |   |         |   |     | | | |       | |       |         | |   |   |   | |   |   | |   | | |
+ + + + +-+-+ + +-+-+ +-+-+ +-+-+ +-+-+ +-+-+ +-+-+ + + + + + + +-+ +-+-+-+ + + + +-+ + + + + + + + +
| | | |     | |     |     |     |     |     |     | | | | | | |   |       | | | |   | | | | | | | | |
+ + + + +-+ + + +-+-+ +-+-+-+ + + +-+-+-+-+ + + + +-+ + +-+ + +-+ + + + + +-+ + +-+ + +-+ +-+ + +-+ +
| | | |   | | |     |       | | |         | | | |   | |   | |   | | | | |   | |   | |   |   | |   | |
+ + +-+-+ + + + + +-+-+ + + +-+-+-+-+ +-+-+-+ +-+ +-+ + +-+-+ + + + +-+ +-+ + + + + + +-+ + + + + +-+
| |     | | | | |     | | |         |       |   |   | |     | | | |   |   | | | | | |   | | | | |   |
+ +-+ +-+-+ +-+ +-+ +-+ + +-+-+ + +-+ + + + + +-+ + +-+ + + + +-+-+-+ +-+ +-+-+ +-+ + + +-+-+ +-+-+ +
|   |     |   |   |   | |     | |   | | | | |   | |   | | | |       |   |     |   | | |     |     | |
+ +-+-+ + + +-+-+ + +-+ +-+ +-+-+ +-+-+ +-+-+-+ +-+-+-+ + + + + +-+-+ + +-+-+ +-+-+ +-+-+-+ +-+ +-+ +
|     | | |     | |   |   |     |     |       |       | | | | |     | |     |     |       |   |   | |
+ + +-+ + +-+ + + + + + + +-+ +-+ +-+ + +-+ + +-+-+ +-+-+-+ + +-+ + +-+ + + +-+ + +-+ + + +-+-+-+-+-+
| |   | |   | | | | | | |   |   |   | |   | |     |       | |   | |   | | |   | |   | | |           |
+ + +-+ + +-+ + +-+ + +-+-+-+ + + +-+-+-+ + +-+ + +-+ + + +-+-+-+-+ +-+ + + +-+ +-+-+-+ +-+ + +-+ + +
| |   | |   | |   | |       | | |       | |   | |   | | |         |   | | |   |       |   | |   | | |
+ +-+-+ +-+ + + + +-+ + +-+-+-+ +-+-+-+ + +-+ +-+-+ + +-+-+ +-+ +-+ + +-+-+ +-+ +-+-+ +-+ +-+ + + +-+
|     |   | | | |   | |       |       | |   |     | |     |   |   | |     |   |     |   |   | | |   |
+ + +-+ + +-+ + + +-+-+-+ +-+-+ +-+ +-+-+ + + +-+-+ + +-+ +-+ +-+-+-+-+-+-+ +-+-+ +-+ + + + + +-+ + +
| |   | |   | | |       |     |   |     | | |     | |   |   |             |     |   | | | | |   | | |
+ +-+-+ +-+-+-+-+ +-+-+-+-+ +-+-+-+ + +-+-+-+ + +-+ + + +-+-+ + +-+ +-+ +-+ + + + + +-+ +-+-+ +-+ + +
|     |         |         |       | |       | |   | | |     | |   |   |   | | | | |   |     |   | | |
+ + + +-+-+-+-+-+-+-+-+ +-+ + +-+ +-+ +-+ +-+-+-+-+ +-+ +-+ +-+-+-+ +-+ + + + + + +-+-+ + +-+ + + +-+
| | |                 |   | |   |   |   |         |   |   |       |   | | | | | |     | |   | | |   |
+ + + + +-+-+-+-+ + +-+ + +-+ +-+ + + +-+ + +-+ +-+-+-+-+-+-+ +-+-+ +-+-+ + + + + + + + +-+ +-+ + +-+
| | | |         | |   | |   |   | | |   | |   |             |     |     | | | | | | | |   |   | |   |
+ +-+-+-+ + +-+-+ +-+ +-+-+ + + + + + +-+ + + +-+-+ +-+-+-+ + +-+ +-+-+ +-+ + + + + +-+-+ +-+ +-+-+-+
|       | |     |   |     | | | | | |   | | |     |       | |   |     |   | | | | |     |   |       |
+ +-+-+-+-+ +-+-+-+-+-+-+-+-+-+ + +-+-+-+-+-+-+ +-+ + +-+ +-+-+-+-+ +-+-+ +-+-+-+ +-+ +-+-+ + + +-+ +
|         |                   | |             |   | |   |         |     |       |   |     | | |   | |
+ +-+ +-+ +-+-+ +-+ + +-+ +-+ + + +-+-+-+ + +-+-+ + +-+ +-+ + + +-+-+-+ +-+ + + + + +-+-+ + +-+-+-+ +
|   |   |     |   | |   |   | | |       | |     | |   |   | | |       |   | | | | |     | |       | |
+ + +-+-+ + + + + +-+ +-+ + +-+-+-+-+ + + + + +-+ +-+ +-+-+ +-+-+ +-+ +-+ +-+ +-+-+ +-+ +-+ + +-+ + +
| |     | | | | |   |   | |         | | | | |   |   |     |     |   |   |   |     |   |   | |   | | |
+ +-+-+ + +-+-+ + + + +-+-+ +-+ + +-+-+-+-+-+ +-+-+-+ +-+ +-+-+ + + + +-+-+ +-+ +-+-+-+-+-+-+ + + +-+
|     | |     | | | |     |   | |           |       |   |     | | | |     |   |             | | |   |
+ + + + +-+-+ +-+ + +-+ +-+ + + +-+ +-+ +-+-+ +-+-+-+ +-+ + +-+-+-+ + + + + + +-+-+ + +-+-+ + +-+-+-+
| | | |     |   | |   |   | | |   |   |     |       |   | |       | | | | | |     | |     | |       |
+ + +-+ + + +-+-+-+ +-+ + + +-+ +-+-+ + +-+ + + +-+ + + + + + + + +-+-+ +-+ + +-+-+ +-+ + + + + +-+ +
| |   | | |       |   | | |   |     | |   | | |   | | | | | | | |     |   | |     |   | | | | |   | |
+ + +-+ +-+-+-+ +-+ +-+ +-+ + +-+ + +-+ + +-+ +-+ + +-+ + + + + + + +-+-+-+ + +-+-+-+-+-+-+ + +-+-+ +
| |   |       |   |   |   | |   | |   | |   |   | |   | | | | | | |       | |             | |     | |
+ +-+-+-+-+ + + +-+-+ +-+-+ + +-+ +-+-+-+-+ + +-+-+ + + + +-+ +-+ +-+ +-+-+ + + +-+ + + + +-+-+ +-+-+
|         | | |     |     | |   |         | |     | | | |   |   |   |     | | |   | | | |     |     |
+ + + +-+ + +-+ +-+-+ +-+ + +-+ +-+-+ +-+ + + + + +-+ +-+ + +-+-+ +-+ +-+-+-+-+ + +-+ + +-+-+-+-+-+ +
| | |   | |   |     |   | |   |     |   | | | | |   |   | |     |   |         | |   | |           | |
+ +-+ +-+ + +-+ + +-+ +-+ +-+ +-+ +-+ + +-+-+ +-+ +-+-+ +-+ +-+ + + + + +-+ + + + +-+ +-+ +-+ +-+ + +
|   |   | |   | |   |   |   |   |   | |     |   |     |   |   | | | | |   | | | |   |   |   |   | | |
+ +-+ + + + + + + + +-+ +-+ +-+-+ +-+ +-+ +-+ + + +-+-+-+-+-+-+-+ + + +-+-+ + +-+ + +-+ + + +-+-+ +-+
|   | | | | | | | |   |   |     |   |   |   | | |               | | |     | |   | |   | | |     |   |
+ + + +-+-+-+-+-+-+-+ + +-+ +-+-+ + +-+-+ + +-+ + + + + +-+-+-+-+-+-+-+-+ +-+-+-+-+-+ + + + +-+-+ + +
| | |               | |   |     | |     | |   | | | | |                 |           | | | |     | | |
+ + + +-+ +-+-+ +-+-+-+ +-+-+-+-+-+-+ + +-+ + + + + +-+-+ +-+-+-+ +-+-+-+-+ +-+ + +-+ + + + +-+ +-+ +
| | |   |     |       |             | |   | | | | |     |       |         |   | |   | | | |   |   | |
+ + +-+ +-+-+ + + + +-+ +-+-+ +-+ +-+ + +-+-+-+ + + +-+ +-+ + +-+ + +-+ +-+ +-+-+ +-+ + +-+ +-+-+-+-+
| |   |     | | | |   |     |   |   | |       | | |   |   | |   | |   |   |     |   | |   |         |
+ +-+-+ +-+ + +-+ +-+ + +-+-+-+-+-+ +-+-+ + + + +-+ + + + + +-+ + +-+ +-+-+ + +-+ + + + +-+-+-+ +-+ +
|     |   | |   |   | |           |     | | | |   | | | | |   | |   |     | |   | | | |       |   | |
+ + + +-+-+-+ + + + + + + + + + +-+ + +-+-+-+-+ + +-+ +-+-+ +-+-+-+-+-+-+ +-+-+ + + +-+-+ + + +-+ + +
| | |       | | | | | | | | | |   | |         | |   |     |             |     | | |     | | |   | | |
+-+-+-+-+-+-+-+-+-+-+-+-+-+-+-+-+-+-+-+-+-+-+-+-+-+-+-+-+-+-+-+-+-+-+-+-+-+-+-+-+-+-+-+-+-+-+-+-+-+-+