+-+-+-+-+-+-+-+-+-+-+-+-+-+-+-+-+-+-+-+-+-+-+-+-+-+-+-+-+-+-+-+-+-+-+-+-+-+-+-+-+-+-+-+-+-+-+-+-+-+-+
|                                                                                                   |
+-+ + +-+ + +-+ + +-+ +-+-+ + + + +-+ + + +-+-+ + + + + + +-+ + + + +-+ + + +-+ +-+ +-+ + +-+ + + +-+
|   | |   | |   | |   |     | | |   | | |     | | | | | | |   | | | |   | |   | |     | |   | | |   |
+ +-+-+ +-+ +-+ +-+ + + + + + +-+ + +-+-+ +-+-+-+ + +-+ +-+ + + +-+ +-+ + + + + + + + + + + + +-+ + +
|     | |     |   | | | | | |   | |   |   |       | |     | | | |     | | | | | | | | | | | |   | | |
+ + + + + + +-+ + + + +-+-+ + + +-+ +-+ +-+ + + + + + +-+-+-+ + + +-+ + + +-+-+-+ +-+ + + +-+-+ +-+-+
| | | | | |   | | | |     | | |   | |     | | | | | | |       | | |   | |     |     | | | |         |
+ + +-+ + + + +-+-+ + + + +-+ + + +-+ +-+-+-+ + + +-+ + + +-+ + + + + + + + + + + + +-+-+-+-+-+-+-+ +
| |   | | | |     | | | | |   | |   |   |     | |   | | | |   | | | | | | | | | | |       |         |
+-+ + + + + +-+ +-+-+ + +-+ + + +-+-+ + + + + + +-+-+ +-+ + +-+-+-+ +-+ + +-+ +-+ +-+ +-+ +-+ + + + +
|   | | | | |       | |   | | | |     | | | | |   |     | |       |   | | |     |   | |     | | | | |
+-+-+-+-+ + + + + + +-+ + +-+-+-+ +-+-+-+ + + +-+-+ +-+ + + + +-+-+-+-+-+-+-+ +-+ +-+ + + +-+ + + + +
|         | | | | |   | |       |     |   | |   |   |   | | | |               |     | | | |   | | | |
+ +-+-+ + + +-+ + + +-+-+ + + + +-+ +-+ + + + + + +-+ + + + + + +-+ + + + + + + + +-+-+-+-+ + + +-+ +
|     | | |   | | | |     | | | |     | | | | | | |   | | | | |   | | | | | | | | |         | | |   |
+ +-+ +-+ +-+-+ + + + +-+-+-+ + + + + +-+ +-+ +-+ + + + + +-+ +-+ + + +-+ +-+-+ +-+ + + + +-+-+-+ + +
| |   |   |     | | |       | | | | |   |   | |   | | | |   |   | | | |       | |   | | |   |     | |
+ +-+ + +-+ +-+ +-+-+ +-+ + +-+ + + +-+ +-+-+ + + + + + + + +-+ +-+-+-+ +-+-+ +-+-+ + + +-+-+-+-+ + +
| |   | |     | |       | | |   | | |       | | | | | | | | |       |       |     | | |   |       | |
+ + + + + +-+ + +-+ +-+ +-+ + + + + + + +-+ +-+ + + +-+-+ + + + + + +-+ +-+-+ +-+-+ + +-+ +-+ + + + +
| | | | |   | |   | |     | | | | | | |   |   | | |     | | | | | | |   |         | |   |   | | | | |
+ +-+ + + +-+ + +-+ + + +-+-+ + + + + + +-+ +-+-+ +-+-+ + +-+ + + + +-+ + +-+ + + + +-+-+ +-+ + + + +
| |   | |   | | |   | |     | | | | | |   | |     |     | |   | | |   | |   | | | | |     |   | | | |
+-+ + + + + + + + + +-+ +-+-+-+-+ + + +-+ + + + + +-+ +-+ + + +-+ +-+ + +-+ +-+-+ + + +-+ + + + +-+ +
|   | | | | | | | | |   |         | | |   | | | |   | |   | | |   |   |   |     | | |   | | | | |   |
+-+ +-+ + + + +-+-+-+ +-+-+ +-+-+-+-+ + + + + + + + + + + +-+ + + +-+ + + + + + +-+ + + + + + +-+ + +
|     | | | |   |         |     |     | | | | | | | | | |   | | |   | | | | | | |   | | | | |   | | |
+ +-+ +-+ +-+ + + + + + +-+-+-+ +-+ + +-+-+-+ + + + + + + +-+-+ +-+-+-+ + + + +-+ + + + +-+ + +-+ +-+
| |     | |   | | | | |       | |   |     |   | | | | | |     |     |   | | |   | | | | |   |   |   |
+ + +-+-+ +-+ +-+ + + +-+ + +-+ +-+-+ + + +-+ + +-+ +-+ + +-+ +-+ + + + +-+-+-+-+ +-+ +-+ +-+ + + + +
| | |       | |   | |   | |   |   |   | | |   |   |   | | |     | | | |   |       |   |   |   | | | |
+-+ + + + + + + + +-+ + +-+-+ + + +-+-+ +-+ + + +-+ + +-+ + +-+ +-+-+-+ + + +-+-+ +-+-+-+ +-+ +-+ +-+
|   | | | | | | |   | | |     | |     |   | | | |   | |   | |         | | | |           |   |   |   |
+ + +-+-+ + + + + +-+-+ +-+ + + +-+ +-+ +-+-+-+-+ +-+ + + + + + + + + +-+ + + +-+ +-+-+-+-+ +-+ +-+ +
| | |     | | | | |     |   | | |   |       |     |   | | | | | | | |   | | | |     |         |   | |
+ + + +-+-+ +-+ + + + + +-+ +-+-+ + + +-+ +-+-+ + + + + +-+-+ + + + + + +-+ +-+ + + +-+ + +-+ +-+-+ +
| | |   |   |   | | | |   |     | | |   | |     | | | | |     | | | | | |   |   | |   | | |   |     |
+-+ +-+ + + + +-+ +-+ + + + + + + + + + +-+ +-+-+ +-+-+ + + + +-+-+ + + + +-+ +-+ + +-+-+ + +-+-+ + +
|     | | | | |   |   | | | | | | | | | |   |     |     | | |   |   | | |   | |   |     | |   |   | |
+ + +-+-+ + +-+-+ +-+ + + +-+ +-+ +-+ + + + + + + + + +-+ + +-+ + +-+ + + + + + + +-+-+ + + + + + +-+
| | |     |     |   | | |   |   |   | | | | | | | | | |   | |   | |   | | | | | |     | | | | | |   |
+ + + + +-+-+-+-+-+ + +-+-+-+ + + + + + + + + + +-+ + + +-+-+-+ + + + + + + +-+ +-+-+ + +-+ +-+ + +-+
| | | | |           |       | | | | | | | | | |   | | | |       | | | | | | |       | | |     | |   |
+ + + + +-+-+-+ + +-+ + +-+ + + + + + + +-+ +-+ + + +-+ + + + + +-+ + + + +-+-+ + + + +-+ + + + + +-+
| | | |     |   |   | |   | | | | | | | |     | | |   | | | | |   | | | |     | | | |   | | | | |   |
+ +-+ + + + +-+-+ +-+ + +-+ + + +-+ +-+ +-+ +-+-+ +-+-+-+ +-+ + + + + + + +-+ + + + +-+ +-+ +-+ + +-+
|   | | | |     |   | |   | | | |   |   |     |   |         | | | | | | | |   | | |   |   | |   |   |
+ + + +-+ + +-+ +-+-+-+ + +-+ +-+ +-+ + + + +-+ + + + + + + + + + +-+ +-+-+ +-+-+ +-+-+ + + +-+-+ + +
| | |   | | |   |       |   | |   |   | | |   | | | | | | | | | |   |     |     | |     | |     | | |
+-+ + + +-+ +-+ +-+ +-+ + + +-+-+-+-+-+ +-+ +-+-+-+ + +-+-+ + + + +-+-+ + +-+ +-+ + + +-+-+ +-+ + + +
|   | | |   |   |   |   | | |           |       |   |   |   | | |   |   |   | |   | |   |   |   | | |
+ + + +-+ +-+ + + + + + + +-+ + + + + + +-+ + + +-+ +-+-+-+ + + + +-+ + + + +-+ + + + +-+-+ + + + + +
| | | |   |   | | | | | | |   | | | | |   | | | |         | | | | |   | | | |   | | | |     | | | | |
+ + + +-+ +-+ +-+ + + + + + + +-+ +-+ +-+-+-+ + +-+-+ + + +-+-+ + +-+ +-+ + +-+ +-+-+ + + +-+-+ +-+ +
| | | |     | |   | | | | | | |     |       | |     | | | |     |   |   | | |   |     | |   |   |   |
+ + + + + + +-+ +-+ +-+ + + +-+ + + + + +-+-+-+ + +-+ +-+ +-+ + + + +-+ + +-+ + + + + + + + + +-+ + +
| | | | | | |     |   | | | |   | | | |   |     |   | |   |   | | |   | | |   | | | | | | | |   | | |
+ + +-+ +-+ + + + + + +-+ + +-+-+ +-+ + + + +-+ + +-+ + + +-+ + + +-+ + +-+-+ + + + + + + + +-+ + + +
| |   | |   | | | | |   | |   |   |   | | | |   | |   | | |   | | |   | |     | | | | | | | |   | | |
+-+-+-+ + + + + +-+ + +-+ +-+-+ + +-+ + + +-+ +-+ + + +-+-+ + + + +-+ + + + +-+ + + +-+-+-+ +-+-+ + +
|       | | | | |   | |     |   |   | | | |     | | |     | | | | |   | | |   | | |     |       | | |
+ +-+ + + + + +-+-+-+-+ +-+ + + + +-+ +-+ +-+-+-+-+ +-+ +-+ + + + + + +-+ +-+ + + + + +-+-+ +-+-+ + +
|   | | | | |     |     |   | | |   |   | |         |     | | | | | | |     | | | | | |       |   | |
+ + +-+ + + +-+ +-+-+ + +-+ + + +-+ +-+-+ + + +-+-+-+ + + + + + +-+ +-+-+ +-+-+-+ +-+-+-+-+ + + +-+ +
| |   | | |   | |     | |   | | |       | | | |       | | | | | |     |   |               | | | |   |
+ + + + +-+-+-+ + +-+-+ +-+ + + + + + + +-+ + +-+ + + +-+-+ +-+ + + + + +-+ + + + + +-+ +-+ + +-+ + +
| | | |       | | |       | | | | | | |   | |   | | |     |   | | | | | |   | | | |   | |   | |   | |
+ +-+ +-+-+ + + + +-+ +-+ +-+ + + + + + + + + + + + +-+-+ +-+-+ + + + + + + + + + + + + + + +-+-+-+-+
|   | |     | | | |     | |   | | | | | | | | | | | |         | | | | | | | | | | | | | | |         |
+ + + + + + + + + + + + + + + + +-+-+-+ + + +-+ + + + + + +-+ + + + + + +-+ + + + +-+ + +-+ + + + + +
| | | | | | | | | | | | | | | |       | | | |   | | | | | |   | | | | | |   | | |   | |   | | | | | |
+ + + + + + + +-+ +-+ + + +-+ + + +-+ + + +-+ +-+ +-+ + + + +-+ + + +-+-+ +-+ + + + + + + + + + + + +
| | | | | | | |     | | | |   | |   | | | |     | |   | | |   | | |     | |   | | | | | | | | | | | |
+ + +-+-+ +-+-+-+ + + +-+ + + + + +-+ + +-+-+ +-+ +-+-+ + +-+ +-+-+ + + + +-+ +-+ + + +-+ + +-+ +-+ +
| | |           | | | |   | | | |   | | |       | |     | |     |   | | |   |   | | | |   |   | |   |
+ + + +-+ + + + + + + + +-+ + + + + + +-+ + + +-+ + +-+ +-+-+ +-+-+ +-+-+-+ +-+ +-+-+ + + +-+-+ + +-+
| | |   | | | | | | | | |   | | | | |   | | |   | | |   |         |   |       |   |   | | |     |   |
+ +-+ +-+ + + + + + +-+ + + + + + + + +-+-+ + +-+ +-+ +-+-+-+-+ + + + + +-+-+ + + +-+ +-+ + + + + + +
| |     | | | | | |   | | | | | | | |   |   | |     |   |       | | | |   |   | |   |   | | | | | | |
+-+ + +-+ + +-+ + + + +-+-+ +-+ + + + + +-+ + + +-+ +-+-+-+ + +-+ + + +-+ + + + + + +-+ + + + +-+ + +
|   | |   |   | | | | |     |   | | | | |   | | |         | |   | | |   | | | | | | |   | | |   | | |
+-+ + + + +-+ +-+ + +-+ + +-+ +-+ +-+-+ +-+ + +-+-+ + + +-+ + +-+-+ +-+ +-+ + + + + + + + + + +-+ + +
|   | | | |   |   | |   | |     |     |   | | |     | |   | | |       | |   | | | | | | | | | |   | |
+ + + + + +-+ + + +-+ +-+ + +-+ + +-+-+ + +-+ +-+ + + + +-+-+ + +-+-+ + +-+ + + + +-+ + + +-+-+-+ + +
| | | | |   | | |   |   | |   | | |     | |   |   | | | |     |     | |   | | | |   | | |   |     | |
+ +-+ + + +-+-+-+-+ + + +-+ + + + +-+-+-+-+ + + + + + +-+ + + +-+ + + +-+-+ + +-+-+ +-+ +-+ +-+ +-+ +
|   | | | |         | | |   | | |     |     | | | | | |   | |   | | |     | |   |   |     | |   |   |
+ +-+ +-+ +-+ + +-+-+ +-+ +-+-+ + + +-+ +-+ + + + + +-+ + + + + + + + + +-+ + + + +-+ +-+ +-+ + +-+ +
|   | |   |   | |     |     |   | | |   |   | | | | |   | | | | | | | |   | | | |   |   |   | | |   |
+ + + + + + +-+ +-+-+ +-+ + + + +-+ + + + + +-+ + +-+ +-+ + + + +-+ + +-+ + + +-+ + + +-+-+ +-+ + + +
| | | | | |   | |       | | | | |   | | | |   | | |     | | | | |   | |   | |   | | | |     |   | | |
+ + +-+-+ +-+ + + +-+-+ + + +-+ +-+ +-+ +-+-+-+ + + + +-+ +-+ + + + +-+ + + + + +-+ + + + + +-+-+-+ +
| |   |   |   | | |     | | |     | |       |   | | |   |   | | | |   | | | | |   | | | | |   |     |
+ +-+-+-+ + +-+-+ + +-+ +-+ + + + + + + + + + +-+ + + + + + + +-+ + +-+-+ + + + +-+-+ + +-+ + + +-+ +
| |       | |     | |   |   | | | | | | | | |   | | | | | | |   | |     | | | |     | | |   | | |   |
+ +-+ + +-+-+ + + +-+ + + +-+-+ + +-+ + +-+ + + + + + + + +-+ + +-+-+ +-+ + + + +-+-+ + +-+ + +-+ +-+
|   | | |     | | |   | |   |   | |   |   | | | | | | | | |   |   |     | | | |   |   |   | | |     |
+ + + + +-+ + +-+ + + +-+-+ + +-+ + + + + +-+-+ + + +-+-+ +-+-+ +-+ + + + +-+ +-+-+ + + +-+-+-+ + +-+
| | | | |   | |   | |     | |   | | | | | |     | |     | |       | | | |   |   |   | |       | |   |
+-+-+-+-+-+-+-+-+-+-+-+-+-+-+-+-+-+-+-+-+-+-+-+-+-+-+-+-+-+-+-+-+-+-+-+-+-+-+-+-+-+-+-+-+-+-+-+-+-+-+