+-+-+-+-+-+-+-+-+-+-+-+-+-+-+-+
|                             |
+ +-+ + +-+-+-+-+ +-+-+ + +-+ +
|   | |         |     | |   | |
+ + +-+-+ +-+-+-+-+-+-+-+ +-+-+
| |     |               |     |
+ +-+-+-+-+-+ + +-+-+-+ + + +-+
|           | |       | | |   |
+ +-+ +-+ + + +-+ +-+ + + + + +
|   |   | | |   |   | | | | | |
+ + + + +-+ + +-+ +-+-+ + +-+ +
| | | |   | |   |     | |   | |
+ + + +-+ +-+ +-+ + + + + + +-+
| | |   |   |   | | | | | |   |
+ +-+-+ + +-+ +-+-+ + +-+ +-+ +
|     | |   |     | |   |   | |
+ +-+-+-+-+ +-+-+-+ +-+ +-+-+-+
|         |       |   |       |
+ + +-+-+ + +-+ +-+ +-+ + +-+-+
| |     | |   |   |   | |     |
+ +-+ +-+-+-+-+-+-+ + + +-+ +-+
|   |             | | |   |   |
+ +-+ +-+-+-+ + + + + +-+ + +-+
|   |       | | | | |   | |   |
+ +-+ + + + +-+ +-+ +-+ + +-+ +
|   | | | |   |   |   | |   | |
+ +-+-+ +-+-+-+-+-+ + + + + + +
|     |           | | | | | | |
+ + + +-+ + +-+ + + +-+-+ + +-+
| | |   | |   | | |     | |   |
+-+-+-+-+-+-+-+-+-+-+-+-+-+-+-+