+-+-+-+-+-+-+-+-+-+-+-+-+-+-+-+-+-+-+-+-+-+-+-+-+-+-+
|                                                   |
+ + +-+ + + +-+ + + + +-+ + +-+ +-+ +-+ + + +-+ + + +
| | |   | |   | | | | |   |   | |   |   | |   | | | |
+ + +-+ + +-+ + + + + + + + + + + + + + + + +-+ +-+ +
| |   | | |   | | | | | | | | | | | | | | |   | |   |
+ +-+-+ + + + +-+ + + + + + + + + + + + +-+ + + + + +
|   |   | | | |   | | | | | | | | | | | |   | | | | |
+ +-+-+ + +-+-+-+ + +-+ +-+ + +-+ + + + + + + + + + +
| |     |   |     |   | |   |   | | | | | | | | | | |
+ +-+ + + +-+ + + +-+-+ +-+ + +-+ +-+-+-+ + +-+-+ + +
| |   | |   | | |     | |   | |       |   | |     | |
+ + + + + + +-+ + + + + + +-+ + + + + +-+ + +-+ + + +
| | | | | | |   | | | | | |   | | | | |   |   | | | |
+ + + +-+-+-+ + + + +-+ +-+ +-+-+ + +-+ + + +-+ + +-+
| | |   |     | | |   |   |     | | |   | |   | |   |
+ +-+ + +-+ + + + + + + + + + +-+-+ + +-+ +-+ +-+ + +
|   | | |   | | | | | | | | |     | |   |   | |   | |
+ +-+ + +-+-+ + +-+ + +-+-+ +-+-+ +-+-+ +-+ +-+ + +-+
|   | | |     |   | |   |   |         | |     | |   |
+ + + + + +-+ + + +-+ +-+ + +-+ + + +-+-+ + + + +-+ +
| | | | | |   | | |   |   | |   | | |     | | |   | |
+ +-+ + +-+ +-+-+ + + +-+-+ + + + +-+ + +-+-+ + +-+ +
|   | |   |   |   | |   |   | | |   | | |     |   | |
+ + +-+ + +-+ + +-+ +-+ +-+ +-+ + + + +-+-+ + +-+ + +
| | |   |   | | |     | |   |   | | |   |   |   | | |
+ + + + + + + + + + + + + + +-+ + + +-+ + + + + +-+ +
| | | | | | | | | | | | | | |   | |   | | | | |   | |
+ + +-+ + + + + +-+ + + + +-+ + +-+ + +-+-+ +-+-+-+-+
| | |   | | | | |   | | | |   | |   | |             |
+ + +-+ +-+ +-+ + +-+-+-+-+ + + + +-+-+-+ +-+ + + + +
| |   | |   |   | |         | | |       | |   | | | |
+ + + + + +-+ + +-+ + + + + + +-+ + +-+ +-+ + +-+ + +
| | | | |   | |   | | | | | |   | | |   |   |   | | |
+ + + +-+ + + + +-+ + + +-+ + + +-+-+ +-+-+ +-+ + + +
| | | |   | | | |   | | |   | |     |   |     | | | |
+ +-+-+ +-+ +-+ +-+ + + +-+ +-+ + +-+-+-+-+-+ +-+ +-+
|   |     | |   |   | |   |   | |         |   |     |
+ + +-+ + + +-+ + + + + + + + +-+ + + + +-+ + +-+ + +
| |   | | | |   | | | | | | |   | | | | |   | |   | |
+ + +-+ + + + + + + + + + + + + + +-+ + + +-+-+ +-+ +
| | |   | | | | | | | | | | | | | |   | | |     |   |
+ + + +-+ + + + + +-+ + + +-+ + + + +-+-+ +-+ +-+ + +
| | |   | | | | | |   | |   | | | | |     |   |   | |
+ + +-+ + +-+ + + + +-+-+ +-+ + +-+ +-+-+-+-+ + + + +
| |   | | |   | | |     | |   | |   |         | | | |
+ +-+ + + +-+-+ +-+-+-+ + +-+-+-+ + + + +-+ + +-+-+ +
| |   | |   |   |       | |       | | |   | | |     |
+ +-+ +-+ + +-+ + +-+-+ + +-+-+ + + +-+-+ +-+-+ + + +
|   | |   | |   |   |   |     | | |   |     |   | | |
+ + +-+-+ +-+-+-+-+ + + + + +-+ + + + +-+ + + + + +-+
| | |     |         | | | |   | | | | |   | | | |   |
+-+-+-+-+-+-+-+-+-+-+-+-+-+-+-+-+-+-+-+-+-+-+-+-+-+-+