+-+-+-+-+-+-+-+-+-+-+-+-+-+-+-+-+-+-+-+-+-+-+-+-+-+-+-+-+-+-+-+-+-+-+-+-+-+
|     |   |   | |   |   | | | | | |           |     |     |   |     |   | |
+-+ +-+ +-+ +-+ +-+ +-+ + + + + + + +-+-+ +-+-+ + +-+-+-+ +-+ + +-+-+ + + +
|     | |       | | | | |     |     |           | |   |   |     |   | |   |
+-+-+ + +-+-+ + + + + + + +-+-+-+ + +-+-+ +-+-+-+-+ +-+ +-+-+ + + +-+ +-+-+
|     |   |   |   |   |     |   | |     | |       | |   | |   |     |   | |
+ + +-+ +-+-+-+ +-+-+ +-+ +-+ +-+ + +-+ +-+-+ + + + + +-+ +-+-+-+ +-+ + + +
| |     |           |         |   | |         | |         |   |     | |   |
+-+-+-+ + +-+-+-+-+-+-+ +-+-+-+-+-+-+-+-+-+ + +-+ +-+ + +-+-+ +-+ + + + +-+
|             | |   |     | |   |   |   |   | | |   | |     |   | | | |   |
+ + +-+ + +-+-+ + + + +-+-+ +-+ +-+ + +-+ +-+-+ +-+ + + +-+ + +-+-+ + + +-+
| | |   |     | | |   |   | |         | |   |       | |   | |   |     | | |
+-+-+ +-+-+-+-+ + +-+ +-+ + + + +-+-+-+ + +-+-+-+-+-+-+-+ + + +-+-+ +-+-+ +
| |   | |   | |   |       |   | | | | | |   | |   |     | | | |   |       |
+ +-+ + + + + + +-+-+-+-+ + + + + + + + + +-+ + +-+-+-+ +-+ + +-+ +-+ + +-+
|         |   | | | |     | | |   | |   |         | | | |     |     | | | |
+ + +-+-+ + +-+ + + + +-+-+ +-+-+-+ + +-+-+-+ +-+ + + + +-+ + +-+-+ + +-+ +
| | | |   |     |   | |         | |     |       | |     |   | |   |     | |
+-+-+ + + +-+-+ +-+ + + +-+ + + + +-+-+ + +-+-+-+ +-+ +-+ +-+-+ +-+ +-+ + +
| |   | |   |   |         | | | |   |     |     |   |   | |   | | | |     |
+ + +-+-+ + +-+-+-+-+-+ + +-+-+-+-+ +-+ +-+-+ +-+-+-+ + +-+ +-+ + +-+-+ + +
|       | | |     |     |   | | | |             |   | |   |         |   | |
+ +-+-+-+-+ + + +-+-+-+ + + + + + +-+-+-+ + +-+ + +-+-+ +-+ + +-+ +-+-+ + +
|     |   |   | |       | |   |   |       | |       | |   | | | |     | | |
+ + +-+ + + +-+-+-+-+-+-+-+ +-+-+ +-+ + +-+-+-+-+ +-+ + + + + + + + +-+-+ +
| |     |         | | |     | |   |   |   |   |       | |   | | | |   |   |
+-+ +-+-+ +-+-+-+ + + + + +-+ + + + +-+-+ +-+ +-+-+-+-+-+ + + + +-+ +-+ +-+
|     | | | |     |   | |   | | |   |       | | |       | | |     |   | | |
+ +-+-+ + + +-+-+-+-+ +-+ +-+ + +-+-+ + +-+ + + +-+ + +-+-+-+-+ + +-+ + + +
| |   | | |   | |     | | | |       | |   |       | |   |     | | |       |
+ +-+ + + + +-+ + +-+-+ + + + + +-+-+-+ + + +-+-+ +-+-+ + + + +-+ +-+-+ + +
|     |           |         | | | |   | | | |   | | | |   | |   |   | | | |
+-+-+ +-+-+-+ +-+-+-+-+-+-+-+ + + + +-+-+-+ + +-+-+ + +-+-+ +-+-+ +-+ + +-+
|     | |     |   |   |     | |   |     |       |         | | |   |   |   |
+-+ + + + + +-+ +-+ +-+ +-+-+ + +-+-+ + + +-+-+-+-+-+ + +-+ + +-+ +-+ + +-+
|   | | | |     |     |       | |   | | | |     | |   |     |   | | |     |
+ +-+ + +-+-+-+-+-+ + +-+-+-+-+ + +-+-+ + +-+ + + +-+-+-+ + +-+ +-+ +-+ +-+
| |   | | |   | | | | |     |   |       | |   |       |   | |   |         |
+-+-+ + + + + + + + +-+-+ +-+-+ + +-+-+-+ + +-+ +-+-+ + +-+-+ + + +-+-+-+-+
|         | |     |         |     |   |     |   |       | |   |           |
+ +-+ +-+ +-+ + +-+-+-+-+-+ + +-+-+-+ + + +-+ + +-+-+-+ + + + +-+-+ +-+-+-+
| |   |   |   |   |   |     |   | | | | |   | |     | | |   |   |   | | | |
+-+ + +-+ + +-+-+ +-+ +-+-+ +-+ + + + +-+-+-+-+ +-+-+ +-+-+ +-+ + + + + + +
| | | | | | | | |       |       |   | |   |   |   |   |   | | | | |     | |
+ +-+ + + +-+ + +-+-+-+ +-+-+ + + + + + +-+-+ + +-+-+ + + + + +-+ + + +-+ +
|   | |         |           | | | | |   | |         |   | |   | | | |     |
+-+ +-+-+ + +-+ + +-+ +-+ +-+ +-+-+ +-+ + +-+ +-+-+-+-+ +-+ + + + + +-+-+-+
|   |     | | |   |     |     | | | |         |       |   | | | | |       |
+ + +-+ +-+ + + +-+ +-+ + + +-+ + + +-+-+ + +-+-+-+ + + +-+ +-+ +-+ + + +-+
| |       | | | |   |   | |         |     |       | |       |     | | |   |
+-+ +-+-+ +-+ + +-+-+ + +-+ +-+ +-+-+-+ +-+-+-+ +-+ +-+-+ +-+ + +-+ +-+-+-+
|       | | | | |   | | | |   |       | |   | | |   | |   |   |           |
+-+-+ +-+-+ + + + +-+-+-+ +-+ +-+-+-+-+-+ +-+ + +-+ + +-+ +-+ +-+ + +-+-+ +
| |       |   |     |   |     |   |   |   |           |     | |   | |     |
+ + + + +-+ + + +-+ +-+ +-+-+ + +-+ +-+-+ + + + +-+-+ +-+-+ +-+-+-+-+-+-+ +
|   | | |   | | | | | |   | |   |           | | |   |     | |         | | |
+-+ +-+-+-+ +-+ + +-+ + +-+ + +-+-+-+-+-+-+-+ +-+ +-+-+-+ +-+-+-+-+ +-+ +-+
|     | |   |       |   |   |   |     | | | |     | |       |   |       | |
+ +-+ + + + + +-+-+ + +-+-+ + + +-+ +-+ + + + +-+ + +-+ + + +-+ + +-+-+-+ +
| |       | |     |         | | | | | | |   | |     | | | |             | |
+-+ +-+ + +-+-+ + +-+ +-+-+ +-+-+ + + + + +-+-+-+-+-+ +-+-+ + +-+-+-+-+-+ +
|   | | |     | | |   |   | | |       |     | |   | |       | |         | |
+-+ + +-+-+-+ +-+ +-+ +-+ + + + +-+ + +-+ + + + + + +-+-+-+-+ + +-+-+ + + +
|   |       | |   | |   |     | |   | |   | |   | | |     | |     |   | | |
+-+-+ +-+-+-+-+-+-+ + +-+ +-+-+-+-+ +-+-+-+ +-+ +-+ +-+ +-+ +-+ +-+-+-+-+ +
|   |   |   |     |     |   |     |   |     |         | |     | |   |     |
+ +-+ +-+ + + +-+ + +-+-+-+-+ +-+-+ +-+-+ + +-+-+-+ +-+ + + +-+ +-+ +-+ + +
| |     | | | |   | |   |   |   | |   | | |           |   |   |   |     | |
+ + + +-+-+ + + + + +-+ +-+ + + + +-+ + + +-+-+ +-+-+ +-+-+-+ + + + +-+-+-+
| | | | |   | | |             |             |     |     | | |   |         |
+ + + + + +-+-+ +-+ +-+ +-+-+-+-+ +-+ +-+ + + +-+-+ +-+ + + +-+ + +-+ +-+ +
|   |             | |         |   |   |   | |   |   |     |     | |   |   |
+ + + + + + +-+ +-+ +-+ +-+-+-+ +-+ + + +-+ + +-+-+-+ +-+ +-+-+-+-+ +-+ + +
| | | | | | |   |     | |       |   | |   | | |       |           | |   | |
+-+-+-+-+-+-+-+-+-+-+-+-+-+-+-+-+-+-+-+-+-+-+-+-+-+-+-+-+-+-+-+-+-+-+-+-+-+