+-+-+-+-+-+-+-+-+-+-+-+-+-+-+-+-+-+-+-+-+-+-+-+-+-+-+-+-+
|                                                       |
+-+-+ + + + +-+-+-+ + +-+ +-+ +-+ + +-+ + + + + + + + + +
|     | | |     |   |   |   | |   |   | | | | | | | | | |
+ + + + +-+ +-+-+-+-+ + + +-+ + + + +-+ + + + + +-+ +-+ +
| | | |   |   |       | | |   | | |   | | | | |   |   | |
+ + + + +-+ + +-+ +-+ +-+ +-+ + + + +-+-+-+ +-+ + +-+ + +
| | | | |   |   |   | |     | | | |   |       | |   | | |
+ + +-+ +-+ + + +-+ + +-+-+ +-+ +-+ + + + + +-+ + +-+ + +
| |   | |   | | |   |     |   | |   | | | |   | |   | | |
+ + +-+ +-+ + + + +-+ +-+ + + + +-+ + + + +-+-+ + + + + +
| | |     | | | |   |   | | | |   | | | |     | | | | | |
+ +-+ + + +-+ +-+ + + + +-+ + + +-+ + + +-+-+ + + + + + +
|   | | |   |   | | | | |   | |   | | | |     | | | | | |
+-+ + + + +-+ + + +-+-+-+-+-+-+ + +-+ + + + + +-+ + +-+ +
|   | | |   | | | |             |   | | | | | |   |   | |
+ + + +-+ + + + + + +-+ + + +-+ + + + + +-+ +-+ + +-+ + +
| | | |   | | | | |   | | | |   | | | | |     | | |   | |
+ + + +-+-+-+ + +-+ +-+ + + + + +-+ + +-+ +-+-+ + + +-+ +
| | |   |     | |   |   | | | |   | |   |   |   | |   | |
+ + + +-+ +-+-+ + + + + + +-+ + + +-+ +-+ + + + + +-+ + +
| | | |       | | | | | |   | | |   | |   | | | | |   | |
+ + + + +-+ +-+-+ +-+ +-+-+ + +-+ + + +-+ + + + + + +-+ +
| | | | |     |   |     |   | |   | |   | | | | | |   | |
+-+ + + + + + +-+ +-+ +-+ + + +-+ + +-+ + + +-+-+ +-+-+ +
|   | | | | |   |   | |   | |   | | |   | |   |   |     |
+ + +-+ + +-+ + + + + + + + + + + + + + + +-+ + +-+ + + +
| | |   | |   | | | | | | | | | | | | | | |   |   | | | |
+ +-+ + +-+-+ + +-+ + + + + +-+-+ +-+ +-+ +-+ + +-+ +-+ +
|   | |     | | |   | | | |     |   |   | |   |   | |   |
+ +-+-+ +-+ + + + +-+ + + + + +-+ + + + + +-+-+ + +-+ +-+
|   |     | | | |   | | | | |   | | | | |     | | |     |
+ + +-+-+ + +-+-+-+-+ +-+ + +-+-+ + +-+-+ +-+ +-+ + + +-+
| |     | | |           | | |     |   |     |   | | |   |
+ + +-+ +-+-+ + +-+ + + +-+ +-+ +-+ + + +-+-+-+ + +-+ + +
| |   | |     |   | | | |   |     | | |       | |   | | |
+-+ + + + +-+-+ + +-+-+ + +-+ + +-+ + + +-+ +-+ +-+-+-+ +
|   | | |   |   |     | | |   | |   | | |     | |       |
+ + + + + + +-+ +-+ + + + +-+ + + + + + + + + +-+ + + + +
| | | | | | |     | | | |   | | | | | | | | |   | | | | |
+ + + + + + + + +-+ + + + + + + + +-+ + + +-+ + +-+ + + +
| | | | | | | | |   | | | | | | |   | | | |   |   | | | |
+-+ + + +-+-+ + + + +-+ +-+ + + +-+ + + + + +-+-+ + +-+ +
|   | | |     | | |   | |   | |   | | | | |   |   |   | |
+ + + + + + + +-+ + + + + + + + + + + + + + +-+ + +-+ + +
| | | | | | | |   | | | | | | | | | | | | | |   |   | | |
+-+ + +-+ + +-+ +-+ + + +-+ +-+-+-+-+ +-+ + +-+ + + +-+-+
|   | |   | |     | | | |         |   |   |   | | |     |
+-+ +-+ +-+ + + +-+-+ + +-+ + + + +-+-+-+ + + +-+ + +-+ +
|     | |   | | |     |   | | | |     |   | |   | |   | |
+ + +-+-+ + + + + +-+ + + + +-+-+ +-+ +-+ +-+-+-+ +-+ + +
| |   |   | | | | |   | | |     |   |   |   |       | | |
+ +-+ + +-+-+ + +-+ +-+-+ +-+ +-+ +-+-+ + + +-+ +-+-+-+-+
| |   | |     |   |   |   |     | |     | | |           |
+ + +-+ + + + +-+ +-+ +-+-+ + +-+-+-+-+ + + +-+ +-+ + +-+
| | |   | | |   |   | |     |         | | | |     | |   |
+-+-+-+-+-+-+-+-+-+-+-+-+-+-+-+-+-+-+-+-+-+-+-+-+-+-+-+-+