+-+-+-+-+-+-+-+-+-+-+-+-+-+-+-+-+-+-+-+-+-+-+-+-+-+
|             | | |             |   |   |       | |
+ + +-+-+-+ + + + + + +-+-+ +-+-+ + + +-+-+-+ +-+ +
| |     |   | |     |     | | |   |   |     | |   |
+-+ +-+-+-+ + +-+-+-+ + +-+ + +-+ + + + + + + + +-+
|         | |     |   |   |       | | | | |       |
+ +-+ + +-+-+ + + +-+-+ + +-+-+ +-+-+ + + + +-+ +-+
| |   | | |   | | | |   |     | |   |   | |   |   |
+ +-+ +-+ +-+-+-+ + +-+ +-+-+-+ +-+ +-+-+-+-+ +-+-+
| |   |                 |   | |   |       | | |   |
+-+-+-+ +-+-+ + +-+ +-+-+ +-+ + + + +-+-+-+ +-+ + +
|   |       | | |   | |         | |   |         | |
+ + + + +-+ +-+ +-+-+ + +-+ + +-+-+ +-+-+-+-+ +-+ +
| |   |   |   | | |   |   | |   |     |   | | |   |
+-+ + +-+ +-+ +-+ +-+ +-+ +-+ +-+-+-+ + +-+ +-+-+ +
|   | |     |     | |       |   |     | | |       |
+-+ +-+-+-+-+-+-+-+ +-+ + +-+ +-+ + +-+ + +-+-+ +-+
|     | | | |   |   |   | | |   | |           | | |
+-+ +-+ + + +-+ + +-+-+ +-+ +-+ + + +-+ +-+-+ + + +
|           |         |     | | | | |   | |       |
+ +-+-+-+ + + +-+ +-+ + +-+ + + + + +-+-+ +-+ + +-+
| | |   | |     | | | |   |   |   |       | | | | |
+-+ +-+ +-+ +-+-+-+ +-+-+ + + +-+ +-+-+ + + +-+ + +
|         |     |   | | | | | |   |     |   |     |
+ +-+-+ +-+ +-+-+-+ + + + +-+-+-+-+-+ +-+-+-+-+-+ +
| | | |         |     |         |   | |   |   |   |
+-+ + + +-+ +-+-+ +-+ + +-+-+ +-+ + + + + +-+ + +-+
| |   | |       |   |   |   | | | |     |   | |   |
+ +-+ +-+-+-+-+-+-+ +-+ + + +-+ + +-+ + +-+-+ +-+-+
| | |   |       | | |   | |     |   | | |         |
+ + +-+ +-+-+-+ + + +-+ +-+ + +-+-+-+-+ + + +-+-+-+
| |       | | |     |   |   |         | | | |     |
+ + +-+-+ + + +-+ +-+ + + +-+-+ +-+-+-+-+-+ +-+ +-+
|   |     |   |   |   |   |       | |   |       | |
+ +-+-+ +-+ +-+-+ + + +-+ +-+ +-+-+ + +-+-+-+ +-+ +
| | | |     |   | | |   | | | | |       | |     | |
+-+ + +-+ + + +-+ +-+-+ + + +-+ + +-+-+-+ +-+ + + +
| |     | | |       |   |           |   | |   | | |
+ +-+-+ + + +-+ +-+ +-+-+-+-+ +-+-+ +-+ + + +-+ + +
|   | |   | |     | |   | |       |   |     |     |
+ + + + + +-+ +-+-+-+ +-+ +-+ +-+ + + +-+-+ +-+-+ +
| |     |   | |       | |     |   | |   |       | |
+-+ + +-+-+-+ +-+ +-+ + + +-+ + + +-+ +-+-+ +-+-+ +
| | |             | | | |   | | | |   |   |   |   |
+ +-+ +-+-+-+-+ +-+ + + +-+-+ +-+-+-+ + +-+ +-+ +-+
| | | |   |     | | |   |     |               |   |
+ + + + +-+-+-+-+ + +-+-+-+ +-+ +-+-+ +-+-+ +-+ + +
|   |           |             | |   | |   |   | | |
+-+ + + +-+ + + + +-+ +-+ +-+-+ + +-+-+ + + + +-+ +
|     |   | | | |   | |       |       | |   | |   |
+-+-+-+-+-+-+-+-+-+-+-+-+-+-+-+-+-+-+-+-+-+-+-+-+-+