+-+-+-+-+-+-+-+-+-+-+
|     |   |         |
+-+-+ + +-+ + +-+-+ +
| |   |     | |   | |
+ + +-+ +-+-+ +-+ + +
| | |       |   | | |
+ + +-+-+-+-+ + + + +
| |   |     | | |   |
+ +-+ + +-+ +-+ +-+ +
|   | |   |   |   | |
+ +-+ + + +-+ +-+ + +
| |   | | |   |   | |
+ + +-+ + + +-+ +-+-+
| |   | | |   |     |
+ +-+ + + +-+ +-+-+ +
|   | | | | |       |
+ + + +-+ + +-+-+-+ +
| | | |   |     |   |
+ +-+ + +-+ +-+ + +-+
|       |     |     |
+-+-+-+-+-+-+-+-+-+-+