+-+-+-+-+-+-+-+-+-+-+-+-+-+-+-+-+-+-+-+-+-+-+-+-+-+-+-+-+-+-+-+-+-+-+-+-+-+-+-+-+-+-+-+-+-+-+-+-+-+-+
| |   |     |   |       |     |         |               |     |               |                 |   |
+ + + + +-+ + + +-+-+ + +-+-+ + +-+-+-+ + + +-+-+-+-+-+-+ +-+ + +-+-+ +-+-+-+ + +-+-+-+-+ +-+-+ +-+ +
| | |   |   | |       |     |   |       | |     |   |   |   |   |   | |     | | |       | |   |     |
+ + +-+-+ +-+ +-+-+-+-+-+-+ +-+-+ +-+-+ + +-+-+ + + + + +-+ +-+-+ + + +-+ + + + + +-+-+ + + + +-+-+ +
|   |   |     | |     |     |     |     | |   | | |   |   |   | | | |   | | | | |     | | | | |   | |
+-+-+ +-+-+-+-+ + +-+ + +-+-+ +-+-+ +-+-+ +-+ + + +-+-+ +-+-+ + + + +-+ + +-+ +-+-+-+ + + + +-+ + + +
|   |               | |   | |   |   |     |   |       | |       | |   | |   |         |   |     | | |
+ + + +-+-+-+-+-+-+-+ +-+ + + + +-+ + +-+-+ + +-+-+-+ + + +-+-+-+ +-+ + +-+ +-+-+-+-+-+-+-+-+-+-+ + +
| |   |         |       | |   |   | |   |   |   |   | |       |   | | |   |           |   |       | |
+ +-+-+-+ +-+-+-+ +-+-+ + +-+-+-+ +-+-+ + +-+-+ + + +-+-+-+ +-+ +-+ + + + +-+-+-+-+ + + + + +-+ +-+ +
| |       |       |   | | |     |     | | |     | |       | |   | |   | |         | |   |   |   |   |
+ +-+ +-+ + +-+-+-+-+ + + + +-+ +-+-+ + + + +-+-+ +-+-+-+ +-+ +-+ + +-+-+-+-+ +-+ + +-+-+-+ +-+-+ +-+
|   | |   | | |       | |   | | |     | | | |   |     | |   |   |           | |   |   |     |     | |
+-+ + +-+ + + + + +-+-+ +-+-+ + + +-+-+ + + +-+ +-+-+ + +-+ + + +-+-+-+-+-+ + + +-+-+ + +-+-+ +-+-+ +
|   |   | | |   |       |     | | |       |       |   |   | | |     |     | | |   |   |     |   |   |
+ +-+-+ + + +-+-+-+-+-+ + +-+-+ + + +-+-+-+-+-+ +-+ +-+ + + +-+-+-+ + + + + + +-+ + +-+ +-+-+-+ +-+ +
|   |   | |           |   |   | | | |   |     | |   |   |   |     | | | | | |   | |   | |     |   | |
+-+ + +-+ +-+-+-+-+-+ + +-+ + + + + + + + +-+ +-+ +-+-+ +-+-+ +-+ + + + +-+ +-+-+ +-+ +-+ + +-+-+ + +
| |   | | |   |     | | |   |   |     | |   |   |     |       | |   | |   |     |   |     |       | |
+ +-+-+ + +-+ + +-+ + + + +-+-+-+-+-+ +-+-+ +-+ +-+-+ +-+-+-+-+ +-+-+ +-+ +-+-+ +-+ +-+-+ +-+-+-+-+ +
|     | |   | |   |   | | |         | |     | | |     |   |         |   |     |   |     |     |   | |
+ +-+ + +-+ + +-+ +-+-+ + +-+ +-+-+ + + +-+-+ + + +-+-+ + + +-+-+-+ +-+ +-+ +-+-+ + +-+ +-+-+ + + + +
|   |     | |   | |   | |   | |   | | |   |     | |   | | | |     |   |   |     | |   |     |   | | |
+ + +-+-+ + + + + + + + +-+ + +-+ + + +-+ + +-+-+ + + +-+ + + +-+-+-+ +-+ +-+-+ + +-+-+-+-+ +-+-+ + +
| | |     |   | |   | |   | | |   | |   | |   |   | |     | |     |   |   |     |           |   |   |
+ + +-+-+-+-+-+ +-+-+ +-+ + + + +-+ +-+ + +-+ + + + +-+-+-+ +-+-+ + +-+ +-+ +-+-+-+-+-+-+-+-+ + +-+ +
| | |         | |   | |   |   |     |   | |   | | |       |       |   |   |                 | |   | |
+ + + +-+-+-+ + + + + +-+-+-+-+ +-+-+ +-+ + +-+-+ +-+-+ + +-+-+-+ +-+ +-+ +-+-+-+ +-+-+-+-+-+ + +-+ +
| | |   |   | | | | |         |   |   |   | |     |   | |     | |   |     |     |       |     | |   |
+-+ +-+ + +-+ + + + +-+-+ +-+ +-+ + +-+ +-+ + +-+-+ + + +-+ + + +-+ +-+-+-+ +-+ +-+-+-+ + +-+-+ + +-+
|   | | |   |   | |   |   |   |   |   | |     |     | | |   |     | |   |   |   |     | |     | | | |
+ + + + +-+ +-+-+ +-+ + +-+-+-+ +-+ +-+ +-+-+-+ +-+ + +-+ +-+ +-+-+ + + +-+ + +-+ +-+ + +-+-+ + + + +
| |   |         |   | |   |     | | |   |   | |   | |     |   |     | |   | |     |   |       | | | |
+ +-+-+-+-+-+-+ +-+-+ +-+ + +-+-+ + + + + + + +-+ + +-+ +-+-+-+ +-+-+ +-+ + +-+-+-+ +-+-+-+-+-+ + + +
|             |     | |   |   |   | | | | | | |   |   | |     |   |   |     |   |   | |       | |   |
+ +-+-+ + +-+-+-+-+ + + +-+-+ + +-+ + +-+ + + + +-+-+ + + +-+ +-+ + + +-+-+-+-+ + +-+ + +-+-+ + +-+ +
| |     | |       |   |       |     |     | |   |     | | |   |   | | |     |   |   |       | |     |
+ + +-+-+-+ +-+ +-+-+ +-+-+-+-+ +-+-+-+-+-+ + +-+ +-+-+-+ + +-+ +-+ + + +-+ + +-+-+ +-+-+-+-+ +-+-+-+
| |     |   | |     |   |   |   |     |   | |   |     |   |   |   | |     | |     |       |   |     |
+ +-+-+ + +-+ +-+-+ +-+ + + + +-+ +-+ + + + +-+-+-+-+ + +-+-+ +-+ +-+-+-+-+ +-+-+ +-+-+-+ + + +-+ + +
|   | |   |       |     | | |   |   | | | | |       |       |   |           |   | |     |   |   | | |
+-+ + +-+-+ + + +-+-+-+-+-+ +-+ +-+ +-+ + + + +-+-+ + +-+-+-+ + +-+-+-+-+-+-+ + + + +-+ +-+-+-+ + + +
| | |     | | | |     |   |         |   |   | |   | |   |     |   |           | |   |         |   | |
+ + + +-+-+ + + + + + + + +-+ +-+-+-+ +-+-+-+ + + + +-+ + +-+-+-+ + +-+-+-+-+-+ +-+-+ +-+-+-+-+-+-+ +
| | |       | | | | |   |   | |     |     |   | | |   | |     |     | |       |     |     |       | |
+ + +-+-+-+ + +-+ + +-+-+-+ +-+ +-+ +-+-+ + +-+ +-+-+ + +-+-+ +-+-+-+ + +-+-+ +-+-+ +-+-+ + +-+-+ + +
| |       | |   | | |           |       |       |   | |     |   |     |     |       |     | |     | |
+ +-+-+-+ + +-+ + + +-+-+-+-+-+-+-+-+-+ + +-+-+ + + + +-+-+-+-+ + +-+ +-+-+ +-+-+-+-+ + +-+ + +-+-+ +
|       | | |   | | |     |     |   | | | |   | | |   |   |     |   |       |   |     | |   | |   | |
+ +-+-+ + + + +-+ + + +-+ + +-+ + + + + +-+ + +-+ +-+-+ + + + +-+-+-+ +-+-+ + + + +-+-+ + +-+ + + + +
| |   | | | |     | | | |     |   | | |   | |     |     |   | |     | |   | | | | | |   |   |   |   |
+ + + +-+ + +-+-+-+ + + +-+-+-+-+-+ + +-+ + +-+-+-+ +-+-+-+ +-+ +-+ +-+ + + + + + + + +-+-+ +-+-+-+-+
|   | |   |     | |   | |         | |   |   |   |   |       |   | | |   | |   |   |   | |   | |     |
+ +-+ + +-+-+-+ + +-+-+ + +-+-+-+ + + +-+-+-+ + + + +-+ +-+-+ +-+ + + +-+ +-+-+-+-+-+ + + +-+ + + + +
| |   | |     | |       | |     |   |       | |   |   | |   |   | | |   | |     |   | | | |     | | |
+ + +-+ +-+-+ + + + +-+-+ + +-+ +-+-+ +-+ +-+ +-+-+-+ + + +-+-+ + + + +-+ + +-+ + + + + + +-+ +-+ +-+
| |     |     | | | |     |   |     |   | |   |       | | |   |   |   |   |   |   | |   |   |   |   |
+ +-+-+-+ + +-+ + +-+ +-+-+-+ +-+-+ +-+ + + +-+ +-+-+-+ + + + +-+ +-+-+ +-+-+ +-+-+ +-+-+-+ + +-+-+ +
|   |     | |   |   |     |     | |     |   |   |       |   |   |   | |         |   |       | |     |
+-+ + +-+-+ + +-+ + +-+-+ +-+-+ + +-+-+-+-+-+ + +-+-+-+ + +-+ + +-+ + +-+-+-+-+-+ +-+ +-+-+-+-+ +-+ +
| | | |   | |   | |     |     | |     |     | | |     | | |   | | |     |     |   |   |   |   |   | |
+ + + + + +-+-+ + + +-+ +-+-+ + + +-+ + +-+ + +-+ +-+ + +-+ +-+ + +-+-+ + + +-+ + + +-+ + + + +-+ + +
| | |   | |     | | |     |   |   | | | |   |       | | |   |       |   | | |   | | |   | | |     | |
+ + +-+-+ + +-+-+-+ + +-+-+ +-+-+-+ + + + +-+-+-+-+-+ + + +-+ +-+-+ + +-+ +-+ +-+-+ + +-+ + +-+-+-+ +
|   |     |   |   | |   |   |       | | | |       |   | | |   |   | |     |   |     |   |   |     | |
+ +-+ + +-+-+ + + + +-+-+ +-+ +-+ + + +-+ + +-+ +-+ +-+ + +-+-+ + + +-+ +-+ +-+ +-+-+ + +-+-+-+ +-+ +
| |   | |     | |   |     |   |   | |   |     |   |   |   |     | | |   |   |   |   | |   |     |   |
+ + +-+ + +-+-+ +-+ + +-+-+-+-+ + +-+-+ + +-+-+-+ +-+ +-+-+ +-+-+ +-+ +-+ +-+ +-+ + +-+-+ +-+ +-+ +-+
| | |   |       |   |     |   | | |     |   |       |       |   |     | |     |   |     |   |     | |
+ + +-+-+-+-+-+-+ +-+-+-+ + + + +-+ +-+-+-+ + +-+-+-+-+-+-+-+ + +-+-+-+ +-+-+-+ +-+-+-+ +-+ + +-+-+ +
| |             | |     | | | |     | |     |           |     |         |       |           | |     |
+ + +-+-+-+-+ + + +-+-+ + + + +-+ +-+ + +-+-+-+-+-+ +-+ + +-+ +-+-+-+-+ + +-+ +-+-+-+-+-+-+-+ + +-+ +
| | |     | | | |       |   |   |   |   |       |   | | | |   |     |   |   |     |       | | | | | |
+ + +-+ + + + +-+-+-+-+ +-+-+-+ +-+ + +-+-+ +-+ + +-+ + + + +-+-+-+ + +-+-+ +-+-+ + +-+-+ + + + + + +
| |   | |   |       |   |   |   |   |     | |   | |     | | |   |   |     |     | |     | |   | | | |
+ +-+ + +-+ +-+-+-+ + +-+ +-+ +-+ +-+-+-+ + + +-+ + +-+-+-+ + + + +-+-+-+ +-+-+ + +-+-+ + + +-+ + + +
| |     | |     |   |     |   | | |     | | | |   | |     |   | |     |   |   | | |     | | |   | | |
+ +-+-+-+ + +-+-+ + +-+ +-+ +-+ + + +-+-+ +-+ + +-+ + + + +-+-+ + +-+ + +-+ + +-+ + +-+-+ + + +-+ + +
| |   |     |     |   | |   |   | |   |   |   | |   | | |       | | | |     |   |   |   | | | |     |
+ + + +-+ +-+ +-+-+-+-+ + +-+ + + +-+ + +-+ +-+ + +-+ + +-+-+-+-+ + + +-+-+-+-+ + +-+ + + + + +-+ +-+
|   |   |   |   |   |   | |   | | |   |     |   |   | | |         | |         | |   | | | | |   |   |
+-+-+-+ +-+-+ + + + + +-+ +-+ +-+ + +-+-+-+ + +-+-+ +-+ + +-+-+-+-+ +-+-+-+ +-+ +-+ + + + + +-+ +-+-+
|     | |   | |   |     |   |     |         |   |       |   |           | |   |   | | |   |   |     |
+ +-+ + + + +-+-+-+-+-+-+-+ + +-+-+ +-+-+-+-+-+ +-+-+-+-+-+ +-+-+ +-+-+ + +-+ +-+ + + +-+-+-+ +-+-+ +
| |   |   | |               |     | |       | |   |       |       |   |   | |     | | |   |       | |
+ + +-+-+-+ + +-+-+-+-+-+-+-+-+-+ + + +-+ + + +-+ +-+ +-+-+-+-+-+-+ +-+-+ + +-+-+-+ + + + +-+-+-+ + +
| | |   |   | |       |   |     | | | |   |     |   |     |     |         |       | |   |   |       |
+ + + + + +-+ + +-+-+ +-+ + +-+ + + +-+ +-+-+ +-+-+ + +-+ + + +-+ +-+-+-+-+ + +-+ +-+-+ +-+ +-+-+-+ +
| | | | | |   | |         | | |   |     |   | |     |   | | | |   |       | | |   |   |   |     |   |
+ + + + + + +-+ +-+-+-+ +-+ + +-+-+-+-+-+ + + + + +-+-+-+ + + + +-+ +-+-+ + + + +-+ + + +-+-+-+ +-+-+
| |   |   |   |   |   | |   |             |   | | |   |   | |   |     |   | | |     | | |     |     |
+ +-+-+-+-+-+ + + + + + + +-+-+-+ +-+-+-+-+-+ + +-+ + + +-+ +-+-+-+-+ +-+-+ + +-+-+-+ +-+ +-+ +-+-+ +
| |     |     | |   | | |   |   |   |   |   | |     | | |   |       |       | |     | |   |         |
+ + +-+ +-+ +-+ +-+-+ + +-+ + + + +-+ + + + + +-+-+ + + + +-+ +-+-+ + +-+-+-+ + +-+-+ + +-+-+-+-+-+ +
|   | |   | |       | |   |   | | |   |   | | |   | | | | |   | |   | |       |       |       |   | |
+-+-+ +-+ + +-+-+-+ + +-+-+-+-+ +-+ +-+-+-+ +-+ + +-+ + + + +-+ + +-+-+ +-+-+-+ +-+-+-+ +-+-+ + +-+ +
|       | |   |   | |   |     | |   |       |   |     |   | |   |     | |     |   |   | |     |     |
+ +-+-+ + +-+ + + + +-+ + +-+ + + +-+ +-+-+-+ +-+-+-+-+ +-+ + +-+-+-+ + + +-+-+-+ + + +-+ +-+-+ +-+-+
|     |       | |     |     |     |           |             |           |           |     |         |
+-+-+-+-+-+-+-+-+-+-+-+-+-+-+-+-+-+-+-+-+-+-+-+-+-+-+-+-+-+-+-+-+-+-+-+-+-+-+-+-+-+-+-+-+-+-+-+-+-+-+