+-+-+-+-+-+-+-+-+-+-+-+-+-+-+-+-+-+-+-+-+-+-+-+-+-+
|*|*****|    *****| |      *****|                 |
+*+*+-+*+ +-+*+-+*+ + +-+-+*+-+*+ +-+ + +-+-+-+-+-+
|*|***|*| |***|***|   |*****|***| |   | |     |   |
+*+-+*+*+ +*+-+*+-+-+-+*+-+-+*+-+ + +-+-+ +-+ + + +
|*|***|*| |*|  *********|   |***| |   |   | |   | |
+*+*+-+*+ +*+-+-+-+-+-+-+ + +-+*+-+ + + +-+ +-+-+ +
|*|*| |*| |***|   |       | | |***| | | |   |***| |
+*+*+ +*+-+-+*+-+ + +-+ +-+ + +-+*+ + + + + +*+*+ +
|*|*| |*****|*|   | | |   | |   |*| |     | |*|*| |
+*+*+ +-+-+*+*+ + + + +-+ + + + +*+-+-+-+-+ +*+*+ +
|*|*|     |***| | |     | |   | |***|*****| |*|*| |
+*+*+-+ +-+-+-+ +-+-+-+ + +-+-+ +-+*+*+-+*+-+*+*+ +
|*|*|   |       |       | |   | | |*|***|*****|***|
+*+*+ +-+ + +-+-+ +-+-+-+ + +-+ + +*+-+*+-+-+-+-+*+
|*|*|     | |     |       |       |***|***| |*****|
+*+*+-+-+-+ + +-+-+ +-+-+-+ +-+-+-+-+*+ +*+ +*+-+-+
|*|*|***|   |   | |   |   |     |***|*| |*| |*|   |
+*+*+*+*+ +-+-+ + +-+ + +-+-+ +-+*+*+*+ +*+ +*+-+ +
|*|***|*|     |   |   | |     |***|***| |*|  *****|
+*+-+ +*+ +-+ +-+ + +-+ + +-+-+*+-+-+-+ +*+-+-+-+*+
|***| |*| | |     |   |   |*****|       |*****| |*|
+-+*+-+*+ + +-+-+-+-+ + +-+*+-+-+ +-+-+-+-+-+*+ +*+
| |*****|     |       |   |*****|     |***|***| |*|
+ +-+-+-+-+-+-+ +-+-+-+ +-+-+-+*+-+-+-+*+*+*+-+ +*+
|   |       |   | |     |*****|***|*****|*|*|   |*|
+ + + + +-+ + +-+ + +-+-+*+-+*+-+*+*+-+-+*+*+ +-+*+
| | | |   | |   | | | |***|***  |***|*****|*|*****|
+ + + +-+ + +-+ + + + +*+-+*+-+-+-+-+*+-+-+*+*+-+-+
| |     | |     |     |***|*******|***|    *|***| |
+ +-+-+-+ +-+-+-+ +-+-+-+*+-+-+-+*+*+-+-+ +*+-+*+ +
| |       |       |     |*| |   |***|***| |*|***| |
+ + +-+-+-+ +-+-+-+ + +-+*+ + + +-+-+*+*+-+*+*+-+ +
| | |   |   |   |   | |***|   |      *|*****|*****|
+ + + +-+ +-+ + + +-+ +*+-+-+ +-+-+-+*+-+-+-+-+-+*+
| | | |   |   |   |   |*|***| |     |*****|    ***|
+ + + + +-+ +-+-+-+ + +*+*+*+ +-+ +-+-+-+*+-+-+*+-+
| | | | |   | |     | |***|*|     |*****|*****|***|
+-+ + + + +-+ + +-+-+ +-+-+*+-+-+ +*+-+*+ +-+*+-+*+
|   |   | |   | |   | |*****|     |***|*|   |***|*|
+ +-+-+-+ +-+ + + + + +*+-+-+-+ +-+-+*+*+-+ +-+*+*+
|             | | | | |*|  ***|     |*|***| | |*|*|
+ +-+-+-+-+-+-+ + +-+ +*+ +*+*+-+-+-+*+-+*+ + +*+*+
|   | |         |     |*| |*|***|*****| |*|   |*|*|
+-+ + + +-+-+ +-+-+-+ +*+ +*+-+*+*+-+-+ +*+-+ +*+*+
| | | |     | |     | |*| |*| |*|*****|***|   |*|*|
+ + + +-+-+ + + +-+ + +*+-+*+ +*+ +-+*+*+-+-+-+*+*+
|   |   |   | | |   | |*****|***|   |*|*******|*|*|
+ +-+ + + +-+-+ + +-+-+-+-+-+*+-+-+-+*+-+-+-+*+*+*+
|     | |       |            *********|      ***|*|
+-+-+-+-+-+-+-+-+-+-+-+-+-+-+-+-+-+-+-+-+-+-+-+-+-+