+-+-+-+-+-+-+-+-+-+-+-+-+-+-+-+-+-+-+-+-+-+-+-+-+-+-+-+-+-+-+-+-+-+-+-+-+-+-+-+-+-+-+-+-+-+-+-+-+-+-+
| |     |           |               |       |     |   |                   |           |           | |
+ +-+-+ + +-+-+-+ +-+ +-+-+-+-+-+ + + +-+ +-+ + + + + + +-+-+-+-+-+-+-+ + + +-+ +-+ +-+ + +-+-+-+ + +
|     | |   |   |   |   |     |   | | | |   | | | | | |         | |     | |   |   | |   | |     | | |
+-+-+ + +-+ + +-+-+ +-+ + +-+-+ +-+ + + +-+ + + + +-+ + +-+-+-+ + + + +-+-+ +-+-+ + + +-+ + + +-+ + +
|   | |     |     |   | |     | |   |     |   | |   |   |   |     | | |     |   | | | |   | | |   | |
+-+ + +-+-+ +-+-+ +-+ + +-+-+ + +-+ +-+-+-+-+-+ +-+ +-+ + + +-+-+ + + + +-+-+ + + +-+ + +-+ +-+ +-+ +
|   |     |       |   |       |   |             | |   | | |   |   | | | | |   |   |   |   |   | |   |
+ +-+-+-+ +-+-+-+ + + +-+-+-+ +-+ +-+-+-+-+-+-+-+ +-+ +-+ +-+ + +-+ +-+ + + + +-+-+ +-+-+ + + + + + +
|       |     |   | | |     | | | |   | |         |   |   |   |   |       | | |     |   | | | |   | |
+-+ +-+ +-+-+ + +-+ +-+ + +-+ + + + + + + +-+-+ + + +-+ +-+ +-+-+-+-+-+-+ + + + +-+-+ + + +-+ +-+-+ +
|   |     |   |   |     |       | | |   |     | | | |   | | |         | | | | | |     | | |       | |
+ +-+-+-+-+ +-+-+-+-+-+-+-+-+-+-+ + +-+-+-+ +-+ + + +-+ + + +-+ +-+-+ + + + +-+ +-+-+ +-+ + +-+-+-+ +
|       |   |                     |         |   | |     |   |   |     |   |   |       |   |   |     |
+ +-+-+ + +-+-+ +-+-+-+-+-+-+-+-+-+ +-+-+-+-+ +-+ +-+-+-+ +-+ +-+-+ +-+ +-+-+ + +-+-+-+ +-+-+ + +-+-+
|     | |     | |   |   |         | |     |   | |     | | |   |   | |   |   |   |   |   |     |   | |
+ +-+-+ +-+-+ + + + +-+ + +-+ +-+-+ +-+ + + +-+ +-+-+ + + + + + + + +-+ + + + +-+ + + +-+-+ + +-+ + +
| |       |   |   |   |   |   |     |   | |   |         | | |   | |   | | | |   | |   |     | |     |
+ + +-+-+ + +-+-+-+-+ + +-+ + + +-+-+ +-+-+-+ + +-+-+-+-+ + +-+-+ +-+ +-+ + +-+ + +-+-+ + +-+-+ +-+-+
| | |   | | |   |     | |   | | |   |       | | | |       | |     | |     | |   | |     |       |   |
+ + + + +-+ + + + +-+-+ + +-+-+ + + +-+-+ + + + + + +-+-+-+-+ +-+-+ +-+-+-+ +-+-+ + +-+-+-+ +-+-+ + +
| |   |     | |   |   | |     |   | |   | | | |   | |         |   |       |   |   |   |   | |     | |
+ +-+-+-+-+-+ +-+-+ + + +-+-+ +-+-+ + + + + + +-+ + + +-+ +-+-+ + + + +-+ +-+ + +-+-+-+ + +-+ +-+-+ +
| |           | |   | | |   |     |   |   | |   | | | |   |   | | | | |   | | |   |   | |   |     | |
+ +-+ +-+-+-+-+ + + + + + + +-+ + +-+-+-+-+ +-+ +-+ + + +-+ + + + + + +-+ + + + + + + + +-+ + +-+-+ +
|   | |       |   | | |   |   | |   |   |   | | |   | |     | | | | |   |   | | |   |     | | |     |
+-+ + + + +-+ + +-+ +-+-+ +-+-+ +-+ + + + +-+ + + +-+ +-+-+-+ +-+ + +-+ +-+-+ + +-+-+-+-+-+ + + +-+-+
| | | | |   | | | |       |   | |     | |   | | | |   |     |   |   |   |   | | |         |   |     |
+ + + +-+-+ + + + +-+-+-+-+ + + +-+-+-+-+-+ + + + + +-+ +-+ +-+ +-+-+ + + + + + + +-+-+-+ + +-+-+-+ +
| |   |   | | | |   |       |   |         | | |   | |   | |   |   |   | | |   | | |   |   | |       |
+ +-+-+ + + +-+ +-+ + +-+-+ +-+-+ +-+-+ +-+ + +-+-+ + +-+ +-+ +-+ + +-+-+ +-+-+ + + + + +-+-+ +-+-+ +
|   |   | |   |   | | |     |   |     |     |         |     | |   |   |   |     | | | |     |   |   |
+ + + + + +-+ +-+ + + +-+-+ + + +-+-+ +-+-+-+ +-+-+-+-+-+ +-+ + +-+ + + +-+-+-+-+ + +-+-+-+ +-+ + +-+
| | | | |       |   |     | | |       | |   | | |       | |   |   | |             |       |     |   |
+-+ + + +-+-+-+-+-+ +-+-+ + + +-+-+-+-+ + + + + + +-+-+ + + +-+-+ +-+-+-+-+-+-+-+-+ + +-+-+-+-+-+-+ +
|   | |           |   |   | | |     |   | | |   |     | |   |   |   |   |       |   | |             |
+ +-+ +-+-+-+ +-+ +-+ + +-+ + +-+ + +-+ + + +-+ +-+-+ + + +-+ + +-+ + + + +-+-+ +-+-+ + +-+-+-+-+-+-+
| |     |   |   |     | |   |     |   | | |   |   | | | | |   |   | | | | |   |   |   | |       |   |
+ + +-+-+ + +-+ +-+-+-+ +-+-+-+-+-+-+ + + + + +-+ + + + +-+ +-+-+ + + + + + +-+-+ + + + +-+-+ + + + +
|   |     | |     |     |         |   |   | |   |   | |   | |   |   | |   |     | | | | |   | |   | |
+ +-+ +-+-+ +-+-+ + +-+ + +-+-+ + + +-+ +-+ +-+-+ +-+ +-+ + + + +-+-+ +-+-+-+ +-+ + + + + + + +-+-+ +
|   |   | |     | | |   |   | | | | | | |   |     |   | |   | |   |   |       |   | | |   | |     | |
+-+-+-+ + +-+-+ + + + +-+-+ + + +-+ + + + +-+ +-+-+ +-+ +-+ + +-+ + +-+ +-+ + + +-+ +-+-+-+ +-+-+ + +
|       |   |   | | | |   | | | |   | | | |   |     |   |   | | | | | |   | | | | |     |   |   | | |
+ +-+-+-+ + + +-+-+ +-+ + + + + + +-+ + + + +-+ +-+-+ +-+ +-+ + + + + + +-+ + + + + +-+ + +-+ + +-+ +
| |       | |   |   |   |   | |   | |   | | |   |   |   | | | | |   |   |   | | |     |       |     |
+ +-+ +-+-+-+-+ + + + +-+-+-+ +-+-+ + +-+ + + +-+ +-+ + + + + + +-+-+-+ + +-+ + +-+-+-+-+-+-+-+-+-+ +
|   | |       | | | | |             | |   | |   |     |   | |     |   | | |   |           |     |   |
+-+ + + +-+ + + + +-+ + +-+ +-+-+ +-+ + +-+ +-+ +-+-+ +-+-+ +-+-+ + + +-+ + +-+-+-+-+-+-+ + + +-+ +-+
|   | | |   | |   |   | |   |     |   |       |     |         | |   | |   | |           | | |   | | |
+ +-+ + + +-+ +-+ + +-+-+ +-+ +-+-+ +-+-+-+-+-+-+-+ +-+-+-+-+ + +-+-+ + +-+ +-+ +-+-+-+ + +-+ + + + +
| |     |   |   | | |   | |   |   | |       |       |           |     | | |     |   |   |   | | |   |
+ + +-+-+-+ +-+-+ + + + + + +-+ + + + + +-+ + + +-+-+-+-+-+-+-+-+ +-+-+ + +-+-+-+ +-+ +-+-+ + + +-+ +
| | |   | |       | | |   |     | | | |   | | | |         |   |   |     |       |     |   | | |     |
+ + + + + +-+-+-+-+ + +-+-+-+ +-+-+ +-+-+ +-+ +-+ +-+-+-+ + + + +-+-+-+ + +-+-+ + +-+-+ + + + +-+-+-+
| |   | |       |   | |     | |   | |   |   | |   |     |   | |   |   | | | |   | |   | | | |       |
+ +-+-+ +-+ + +-+ +-+ + +-+ +-+ + + + + +-+ + + +-+ + +-+-+-+ +-+ + + + + + + + + + + + +-+ +-+-+-+ +
| |   |   | | |   |   |   |     |   | |   | |   |   |     | |   | | |   |   | | |   | |   | |     | |
+ + + +-+ + + + +-+ + +-+ +-+-+-+-+-+ +-+ + +-+-+ +-+-+ + + +-+ + + +-+-+-+ + +-+-+-+ +-+ + + +-+-+ +
| | |   |   | |   | |   |           |   |     |       | |   |   |   |     | |   |     |   | |       |
+ + +-+ + +-+-+-+ +-+-+ +-+-+-+-+-+ +-+ +-+-+ +-+-+-+ + +-+-+ +-+-+-+ + + +-+ + + +-+-+ + + +-+-+-+-+
| | | | | |       |     |         |   | |   |     |   |     |         | |   | | | |     | |         |
+ + + + +-+ +-+-+-+ +-+ +-+ +-+-+-+-+ + + + +-+-+ +-+-+-+-+ +-+-+-+-+-+ +-+ +-+ + +-+ +-+ +-+-+-+-+ +
| |   |   | |         |     |           | |   |   |         |   | |     | | |   |   | |   |     |   |
+ +-+ +-+ + +-+-+-+-+ +-+-+-+ +-+-+-+-+-+-+-+ + +-+ +-+-+-+ + + + + +-+-+ + + + +-+ + + +-+ +-+ + + +
|   |   | |   |     |         |     |         |   | |   |   | |   |   |       | |   | | |   |   | | |
+ +-+-+ + +-+ + +-+ +-+-+-+-+-+ +-+ +-+ +-+-+ +-+ + + + + +-+ +-+ +-+ +-+-+ +-+-+ +-+ + +-+ +-+-+ + +
|       |   |   | |       |     | | |   |       | | | |   |   | |   | |   | |     |   |     |     | |
+-+-+-+-+ + +-+-+ +-+-+-+ + +-+-+ + + +-+-+-+-+-+ + + +-+-+ +-+ +-+ + + + +-+ +-+-+-+ +-+-+ + +-+-+ +
|   |     | |       |     |   |     |     |       | | |     |     | | | |   |         |     |     | |
+ + + +-+-+-+ +-+ +-+ +-+-+-+ + +-+-+ +-+ + +-+-+-+ + + +-+ + +-+ + + + +-+ +-+-+-+ +-+-+-+ +-+-+ +-+
| |   |       | |   |   |     |   | | | | |   |     | | |   |   |   |   | |       | |     |     |   |
+ +-+ + +-+-+-+ +-+ +-+ + +-+-+-+ + + + + +-+ +-+-+ + +-+ +-+ +-+-+ +-+-+ +-+-+-+ + + +-+ +-+ +-+-+ +
| |   |         | |   | |     |   | | | |   |   |   |     |   |   | |   | |     |   |   |   | |     |
+ +-+-+-+-+-+-+ + +-+ + + +-+ + +-+ + + + +-+-+ + +-+ +-+-+-+-+ + + + + + + +-+ +-+-+ + +-+ +-+ +-+ +
| |         | | |   |   | |   | |     | | |       |   |     |   | |   |   |   |     | | |     | |   |
+ + +-+-+ + + + + + +-+-+ + +-+ + +-+-+ + + +-+-+-+-+ + +-+ + +-+ +-+-+-+-+-+ +-+-+ + + +-+-+ + + +-+
|     |   | | |   | |   | | |   |       |     |     | |   |   | |             |     | |   |     |   |
+ +-+-+ +-+ + +-+-+ + + + + +-+ +-+-+-+-+ +-+-+ +-+ +-+-+ +-+-+ +-+-+-+-+-+-+-+ +-+-+ +-+ +-+-+-+-+ +
| |   | | |       |   | | |   |   |     | |   |   |       |     |             | | |   | |     |   | |
+-+ + + + + +-+-+-+-+-+ +-+ + +-+ + +-+ +-+ + +-+ +-+-+-+-+ +-+-+ + +-+-+-+-+-+ + + +-+ +-+-+ + + + +
|   |   | | |         |   | | | |   |   |   |   |       |   |     | |           |     |     |   | | |
+ +-+-+-+ + + +-+-+-+ +-+ + + + +-+-+ +-+ +-+-+ +-+-+-+ +-+ + +-+-+ + +-+-+-+-+-+-+-+ +-+ +-+-+ + + +
|   |       |   |   |     | | |     | |   |   |         |   | |   |   |       |     |     |   | | | |
+ + +-+-+ +-+-+ + + +-+-+-+ + +-+ +-+ + +-+ + +-+-+-+-+-+ +-+ + + +-+-+ + +-+ + +-+ +-+-+-+ + +-+ + +
| |     | |   | | |   |     |   |     | |   | |     |       |   | |   | |   | | |           |   | | |
+ +-+-+ + +-+ + +-+ + +-+-+ +-+ + +-+-+ + +-+-+ +-+ + +-+-+ +-+-+ + + + +-+ + + + +-+-+-+-+-+-+ + + +
| |   | |   | |   | | |   |   | | |     |     |   | |   |     |   | |   |   |   | |     |       | | |
+ +-+ + +-+ + +-+ + + + + + +-+ + + +-+-+ +-+ + +-+ +-+ + +-+-+ +-+-+-+ + +-+ +-+-+ +-+ + +-+-+-+ +-+
|     |   |     |   |   | | |   |   | |   | |   |     | |   |   |     | |   | |     | | |   |   |   |
+-+-+ +-+ +-+-+ +-+-+-+-+ +-+ +-+-+-+ + +-+ +-+-+ +-+-+ +-+ + +-+ +-+ + +-+ +-+ +-+-+ + +-+ + + +-+ +
|   | |   | |   |   |     |   |       | |       | |       | | |   | | | | | |   |     |   |   |   | |
+ + + + +-+ + +-+-+ + +-+-+ +-+-+ +-+-+ + +-+ + + + +-+-+-+ + +-+ + + + + + + +-+-+ + +-+ +-+-+-+ + +
| |   | |   |       | |     |     |     |   | | |       |   |     |   |   |       | |   | |     |   |
+-+-+-+ + + +-+-+-+ + +-+-+ + +-+-+ +-+-+-+-+ + +-+-+-+-+ + +-+-+-+ +-+ +-+-+-+-+ +-+ + + + +-+ +-+ +
|       | |         |       |     |   |       |   | |     | |     |   | |     | |   | | |   | |   | |
+ + +-+-+-+-+-+-+ +-+-+-+-+-+ +-+ +-+ + + +-+-+-+ + + +-+-+ + + +-+-+ +-+ +-+ + +-+ +-+ +-+-+ +-+ +-+
| | |   |       |   |     |   | |   | | | |     |   | |     | |     |   |   | |                 |   |
+ +-+ + + +-+-+ +-+-+ + +-+ +-+ +-+ + +-+ + +-+-+-+ + +-+-+-+ +-+ +-+-+ +-+ + +-+-+-+-+-+-+-+-+-+-+ +
|     |       |       |           |       |         |           |           |                       |
+-+-+-+-+-+-+-+-+-+-+-+-+-+-+-+-+-+-+-+-+-+-+-+-+-+-+-+-+-+-+-+-+-+-+-+-+-+-+-+-+-+-+-+-+-+-+-+-+-+-+