+-+-+-+-+-+-+-+-+-+-+-+-+-+
|                         |
+-+-+ +-+ + + + + +-+ + + +
|       | | | | |   | | | |
+ + + + + + + + + + + + + +
| | | | | | | | | | | | | |
+ + + + +-+ + + + +-+-+ + +
| | | | |   | | |     | | |
+ + + + + + + + +-+ + +-+ +
| | | | | | | | |   |   | |
+ + + + + +-+ + +-+ + + + +
| | | | |   | |   | | | | |
+ + + +-+-+-+-+ +-+ +-+ +-+
| | |     |       | |     |
+ +-+ + +-+ +-+ +-+ + + + +
| |   | |   |   |   | | | |
+ + + + +-+ + +-+-+ +-+ + +
| | | |   | |   |     | | |
+ + +-+-+ +-+ + +-+ + +-+ +
| | |       | |   | |   | |
+ + + +-+-+-+-+ +-+ +-+ +-+
| | |     |     |   |     |
+ + +-+ + + +-+-+ + + + + +
| |   | | |     | | | | | |
+-+ + +-+ + +-+ +-+ + + + +
|   | |   | |   |   | | | |
+-+-+-+-+-+-+-+-+-+-+-+-+-+