+-+-+-+-+-+-+-+-+-+-+-+-+-+-+-+-+-+-+-+-+-+-+-+-+
| | |       |     |   |     |                   |
+ + + +-+ + + +-+ + + + + + + +-+-+-+-+-+-+-+-+ +
| |     | |   | | | | | | |   |               | |
+ +-+-+ + +-+-+ + + +-+ + +-+-+ +-+-+-+-+-+-+ + +
|     | | |   |     |   | |       |           | |
+-+-+ +-+ + +-+ +-+-+ +-+ +-+-+-+ + +-+-+-+ +-+ +
| |   |   |     |       | |     | |     | | |   |
+ + +-+ +-+ +-+-+ +-+-+-+ + +-+ + +-+-+ + + + +-+
|   |   |   |   |   |   |   |   | | |   |   |   |
+ +-+-+ +-+-+ + + +-+ + +-+-+ +-+ + + +-+-+-+-+ +
|     |       |   |   |     |   | | |           |
+-+-+ + +-+-+-+-+-+ +-+-+-+ +-+ + + +-+-+-+-+-+-+
| |   |   |     |   |     |     |     | |       |
+ + +-+-+-+ +-+ + +-+-+ + +-+-+-+-+-+ + + +-+-+ +
| |     |   |   | |   | |       |   | |   |   | |
+ +-+-+ + +-+ +-+ + + + +-+-+-+ +-+ + +-+ + +-+ +
|     |   | |   | | |   |           |   |   |   |
+ +-+-+-+-+ +-+ + + + +-+-+ +-+-+-+-+-+ +-+-+ + +
| |     |       | | | |   |   |         |     | |
+ + + +-+ +-+-+-+ + +-+ + +-+-+ +-+-+-+-+ +-+-+ +
|   |   | |       |   | |     |   |       |   | |
+ +-+-+ + +-+ + +-+ + + +-+-+ +-+ +-+-+-+ + +-+ +
| |   | |   | |   | |   | |     | |       |   | |
+ +-+ + +-+ + +-+ +-+-+ + + +-+-+ + +-+-+-+-+ + +
|     | |   | |   |   | | |       |         |   |
+ +-+-+ + +-+-+ +-+ + + + +-+-+-+-+-+-+-+-+ + +-+
| |   | |     | |   | | |         |         |   |
+-+ + + +-+-+ + + +-+ + +-+ +-+ + + +-+-+-+-+-+ +
|   |   |   | |     | |   | |   |   |     |     |
+ +-+-+-+ + + +-+-+ + +-+ +-+ +-+-+-+ + + + +-+-+
|         | |     | |   | |   |   |   | | | |   |
+ +-+-+-+-+ +-+-+ + +-+ + + +-+ + + +-+ +-+ + +-+
| |     |   |   | |   | |   |   |   | |     |   |
+ + +-+ + + + + + +-+-+ +-+-+ +-+-+-+ +-+-+-+-+ +
| | |   | | | | | |     |       |             | |
+ + + +-+ +-+ + + + +-+-+-+-+-+ +-+-+-+ + +-+ + +
| | |   | |   |   |     |     |       | |   | | |
+ + +-+ + + +-+-+-+-+-+ + +-+ +-+-+-+ + +-+ + + +
|   |   | | | |       | | | | |     | |   | | | |
+-+-+ +-+ + + + +-+ + + + + + + +-+ + +-+-+ + + +
|   |   |   | | |   | |   | | | | | |   |   |   |
+ + +-+ +-+-+ + + +-+ + +-+ + + + + +-+ + +-+-+-+
| |   |   |     | | | |   | | |   |   | |       |
+ + +-+-+ +-+-+-+ + + +-+ + + +-+ +-+ + +-+-+ + +
| | |   |       | |   |     | | | | |   |   | | |
+ +-+ + +-+-+-+ + + +-+-+-+-+ + + + +-+-+ + +-+ +
|     |           |           |           |     |
+-+-+-+-+-+-+-+-+-+-+-+-+-+-+-+-+-+-+-+-+-+-+-+-+