+-+-+-+-+-+-+-+-+-+-+-+-+-+-+-+-+-+-+-+-+-+-+-+-+-+-+-+-+-+
|       |   |     |       |         |       |     |       |
+-+-+-+ + + + + + +-+ +-+ +-+-+ +-+ + +-+-+ + + + +-+-+ +-+
|     | | |   | | |   | |     |   |       |   | |     |   |
+-+-+ + + +-+-+ + + +-+ +-+-+ +-+-+-+-+-+ +-+-+ +-+-+ +-+ +
|     | |   |   |   |   |   | |   |     | |     |   |   | |
+ +-+ + +-+-+ +-+-+-+ + +-+ + + + + +-+ +-+ +-+-+ +-+-+ + +
| |   |       |   |   |     | | |   |       |     |     | |
+ +-+-+-+-+-+-+-+ + + +-+-+-+ + +-+-+-+-+-+-+ +-+ + +-+-+ +
|               |   |   |   | |         |     | | | |     |
+ +-+-+-+ +-+-+ + +-+-+ + + + + +-+-+-+ +-+ +-+ + + + +-+ +
|     |   |   | | |   |   | | | |     |   |   | |   | | | |
+-+-+ + +-+ + + +-+ + + +-+ + + + +-+ +-+ +-+ + +-+-+ + + +
| |   | |   | |   | | | |   | | | |   | | |     |     |   |
+ + +-+ + +-+ +-+ + + +-+ + + + + + +-+ + +-+-+ + + +-+ +-+
| |   | |   |     | |     | | |   | |   |   |   | | | |   |
+ +-+ + +-+ +-+-+-+ +-+-+-+ + +-+-+ + + +-+ +-+ +-+ + +-+ +
|     | | | | |     |       |     |   | | |   | |   |     |
+ +-+-+ + + + + +-+ +-+ +-+-+-+-+ +-+-+ + +-+ + + +-+-+-+ +
| | |   | | |     |   |   |     | |   |     | | |   |   | |
+ + + +-+ + +-+-+-+ + +-+-+ + +-+ +-+ +-+-+ + + +-+ + + + +
|   | |   |   |   | | |     |   | |       | | |     | | | |
+-+-+ + + +-+ + + +-+ + +-+-+-+ + + +-+-+ + + + +-+-+ + + +
|     | | | | | | |   | | |     | |     | | | | |     | | |
+ +-+-+ + + + + + + + + + + +-+-+ +-+-+ +-+ + +-+ +-+-+ +-+
|     | |   |   | | | | | |     |     |     |         |   |
+ +-+ + + +-+-+-+ + + + + +-+-+ +-+-+ +-+-+ +-+-+-+-+-+-+ +
| | | | | |         | |     | |     |     |   |     |     |
+ + + + + + +-+-+-+-+-+-+-+ + +-+ +-+-+-+ +-+ + +-+ + +-+ +
| | | | | | |   |         |     |   |   | |   |   |   | | |
+ + + + +-+ + + + +-+ +-+ +-+-+ +-+ + + + +-+-+-+ +-+-+ + +
|   | |     | |   | | |     |   | |   | | |       |   |   |
+-+ + +-+-+ + +-+-+ + + +-+-+ +-+ +-+-+ + + +-+-+-+ +-+ +-+
|   |     | | | |   | | |     |       | |   |     |     | |
+-+-+ +-+ +-+ + + + + +-+ +-+-+-+ +-+-+ +-+-+ + +-+ +-+-+ +
|   | |   |   |   | |   | |       |       |   |   | |     |
+ + +-+ + + +-+ +-+ +-+ + + +-+ +-+ +-+ +-+ +-+-+ + + +-+ +
| |   | | | |   |     |   | |   |   |   |   |   | |   | | |
+ +-+ + +-+ +-+-+ +-+-+-+-+ + +-+ +-+-+-+ +-+ +-+ +-+-+ + +
|   |   |   |     |       | | |   |           |   | |     |
+ + + +-+ +-+ +-+-+ + +-+ +-+ + +-+ +-+-+-+-+ + + + + +-+-+
| | | |   |     |   | | |   | |         |   | | |   | |   |
+ + + + +-+-+-+ + +-+ + +-+ + +-+-+-+-+-+ + + + +-+ + + + +
| | | | |     | | | | |     |     |       | | |   | | | | |
+ + +-+ + +-+ + + + + +-+ +-+ +-+ + +-+-+-+ +-+-+ +-+ + + +
| | |   | |     |   |   |   |   | |   |   | |     |   | | |
+-+ + +-+ +-+-+ + +-+-+ +-+ +-+-+ +-+ + + + + +-+ + +-+ + +
|   | |     |   | |     | | |     | | | | |   |   | |   | |
+ +-+ +-+-+ +-+-+ + +-+-+ + + +-+ + + +-+ +-+-+ +-+ + + + +
|   | |     |     |   |     |   |   |   |       |   | | | |
+ + + + +-+-+ +-+-+ + +-+ +-+-+ +-+-+-+ + +-+-+-+ +-+-+ + +
| |   |       |   | |   | |     |       |       |       | |
+ +-+-+ +-+-+-+ + + +-+ + + +-+-+ +-+-+-+-+-+-+ +-+-+-+-+ +
| |       |   | | |   | | |   |   |         |       |     |
+ + +-+-+-+ + + + +-+-+ + +-+ + +-+-+-+-+ + + +-+-+-+ +-+-+
| | |   |   |   |     | |   | | |       | |   |       |   |
+ +-+ + + +-+-+-+-+-+ + +-+ + + + +-+-+ +-+-+-+ +-+-+-+-+ +
|     |   |             |     |       |                   |
+-+-+-+-+-+-+-+-+-+-+-+-+-+-+-+-+-+-+-+-+-+-+-+-+-+-+-+-+-+