+-+-+-+-+-+-+-+-+-+-+-+-+-+-+-+-+-+-+-+-+-+-+-+-+-+-+-+-+-+-+-+-+-+-+-+-+-+-+-+-+-+-+-+-+-+-+-+-+-+-+
|***  |   | |   |   | | |   | |   |             | |     | | |   |       |   |     |     | |   |   | |
+-+*+ +-+ + + +-+-+ + + + +-+ + +-+-+-+ + + + + + +-+-+ + + + +-+-+-+ +-+-+ +-+-+ + +-+ + + +-+ +-+ +
| |*|   |     | |         |       |     | | | |     |   |   |                     | |   | |   |     |
+ +*+-+-+ +-+-+ + + +-+-+-+ + + +-+ + +-+-+-+-+-+ +-+-+ + +-+-+ +-+-+ + +-+-+-+ +-+-+ +-+ + +-+ + +-+
| |*********|   | | |   |   | | | | |   |   |*******|   |   | |   |   |     |   |     |     | | |   |
+ + + + + +*+ +-+ + +-+ + + +-+-+ +-+-+-+-+ +*+-+ +*+ +-+ + + +-+-+ +-+-+-+ +-+ +-+-+ + +-+-+ +-+ + +
| | | | | |***    |   |   | | |   | |***|*****  | |*|     | |   | |       | | |     |       |     | |
+ + +-+ +-+-+*+-+-+-+-+ +-+ + + +-+ +*+*+*+ +-+ +-+*+-+-+ +-+ +-+ +-+ +-+ +-+ +-+-+-+-+ +-+-+-+ +-+-+
|     |   |  *****|       |     |*****|***| | | |  *    |*******  |   |     |   |   |   | |       | |
+ +-+ +-+-+-+ +-+*+-+ +-+-+ +-+-+*+-+-+ + +-+ + +-+*+-+-+*+-+-+*+-+ + + +-+-+ +-+ + +-+ + + +-+-+-+ +
| | | | |   | |  ***  | | | |    *    | |   |   | |*******|  ***|   | |   |   |   | |     | | |     |
+ + +-+ +-+ + +-+ +*+-+ + +-+ +-+*+ +-+ +-+-+-+ + +-+-+ +-+-+*+-+-+-+ +-+-+-+ +-+ +-+-+ +-+ + +-+ + +
| | |     |     | |*********| | |*|   |   | | | |     | | |  ***| | |   |*****    |*********      | |
+ + +-+-+ + +-+ +-+ +-+-+-+*+-+ +*+-+ +-+ + + + +-+ + +-+ + +-+*+ + + + +*+ +*+-+-+*+ +-+-+*+-+-+-+ +
|       | | | |   | |     |*******  | |   |   | |   |     | | |***  | | |*| |*******| |   |*      | |
+-+ +-+ + +-+ + +-+-+ + +-+-+ + +-+ + + + + +-+ + + +-+ + + + +-+*+-+ +-+*+-+ +-+ + + +-+ +*+-+-+ +-+
| | | | | |   | |   | |     | | |   | | |   |   | | |   | |   |***|   |***  | | | | | |   |***|     |
+ + + + + + +-+-+-+ +-+ +-+-+-+-+-+-+-+ + +-+-+-+-+-+ +-+ + + +*+-+ +-+*+ + +-+ +-+ +-+-+ + +*+-+ + +
|   | |   | | |         |   |     |   | |   | | |   | |   | | |*****  |*| |   | | | | |     |*|   | |
+-+ + + +-+ + +-+-+ +-+-+-+ +-+ +-+-+ +-+-+-+ + +-+ +-+ + + + + + +*+-+*+-+ +-+ + +-+ +-+-+-+*+-+-+ +
| | |       |       |   |       | |   |         | | |   |   | | | |*****  | |         |   |***| |   |
+ +-+-+-+-+ + + + +-+-+ + +-+-+ + +-+ +-+-+ +-+-+ + +-+-+ +-+-+ +-+-+-+-+ +-+-+-+-+ +-+-+ +*+-+ +-+-+
| | |         | |     | |   |     |           |   |       |   | |         |         | |    *    |   |
+ + +-+-+ +-+-+-+ + +-+ +-+ +-+ +-+ + + + +-+-+ + +-+-+-+ + + + +-+-+ +-+-+-+ +-+-+ + +-+-+*+ +-+-+ +
|           |     |   | |   | |     | | |   |   | |     | | | | |         |     | |   | | |*|       |
+-+-+-+-+ +-+ +-+ +-+ + +-+-+ +-+ +-+-+-+-+ + + +-+ + +-+ + +-+ + +-+ + + +-+-+ + +-+ + + +*+-+ + + +
|     | |   | | |   |     |           |     | |     | | | |   | | |   | |     |   |   |*****|   | | |
+ +-+-+ + +-+-+ + + + +-+-+ +-+-+-+-+ +-+ +-+-+-+ +-+ + +-+-+ + +-+ +-+-+ +-+-+ +-+ +-+*+-+-+-+-+-+ +
|             | | | |     |         | |     |   | | |     | | | | |   |   |       |  ***  | | | |   |
+-+ +-+ + +-+ + +-+-+ +-+-+-+ + + +-+-+-+-+ + + + + + +-+-+ + +-+ +-+-+-+ +-+-+-+-+-+*+-+-+ + + +-+-+
|     | | |   |         | |   | |   |   |     |   | | | | |     |   | | | |         |*| |         | |
+ + +-+-+ + +-+-+ +-+-+-+ + +-+-+-+-+-+ +-+ + +-+ + + + + +-+ +-+-+ + + + + +-+ + +-+*+ + +-+ +-+ + +
| |   | | | |     | | |     |     |       | |   |   |   | | |   | |         |   | | |***  |   | | | |
+ + +-+ +-+-+ +-+-+ + + + +-+ +-+ +-+ +-+-+-+-+ +-+ +-+-+ + + + + + + +-+ +-+-+-+ + + +*+-+-+ + + + +
| | |           |     | | |     | |       |   |   |         | | |   | | | | |   | |   |*    | |     |
+-+-+-+-+ +-+-+ +-+ +-+ +-+-+ +-+-+ +-+-+-+ + + +-+-+-+-+-+-+ +-+ +-+-+ + + +-+ +-+-+ +*+-+ +-+-+ + +
| |     | | | | |   | |     |   | |     |   |           |   |     |       |     |   | |*  | |     | |
+ +-+ +-+ + + +-+ +-+ +-+ +-+ +-+ + +-+-+-+-+-+ +-+-+-+-+ +-+ +-+-+ +-+-+-+ +-+-+-+ +-+*+-+ +-+-+ +-+
|     |   |           | | | |   |   |     |           |   |     |     | |       |*******  | |   |   |
+-+ +-+-+-+-+-+ +-+ + + +-+ +-+ + + +-+ +-+ + + +-+-+-+ + +-+ +-+-+-+-+ +-+ +-+ +*+-+-+-+-+ + + + + +
|         |     | | | |   |     | | | |     | | | |   | |       |   | |   | |   |*|     |   | | | | |
+-+ +-+ + +-+-+ + + +-+ + +-+ +-+ +-+ + +-+ +-+ + + +-+-+-+-+-+ + +-+ +-+ + +-+-+*+-+ + + +-+ + +-+-+
|   |   | |     | | |   | |               | |   |     | |   | |     |     |   |  *****| | |   |     |
+ +-+-+-+-+ +-+-+ +-+-+-+ +-+-+ +-+-+ +-+-+ + + +-+ + + +-+ + + + + +-+-+ + + +-+ +-+*+-+ + + +-+-+-+
| | | |   | | | |   | | |     |   | | | | | | | |   | |       | | |   |     | |   | |*| |   | | | | |
+ + + + +-+ + + + +-+ + + +-+-+-+ + +-+ + + +-+-+ +-+ +-+ +-+-+-+-+-+ +-+-+-+ +-+-+ +*+ + +-+-+ + + +
|         | |     |     |     |   |       |   | |   | |   |         |             |  ***| | | |   | |
+-+ +-+-+ + +-+ +-+-+-+ + + + + +-+-+ + + + + + + + +-+ + +-+ +-+ +-+ + +-+-+ + + +-+ +*+-+ + + +-+ +
| |     | | | |     | | | | |     | | | |   |     | |   | | |   | | | |     | | | | | |***| |  *****|
+ + + + + + + +-+ + + + + + + + +-+ + + + +-+-+ + +-+-+ +-+ + +-+-+ + +-+ +-+ +-+-+ + +-+*+ +-+*+-+ +
|   | | | |     | | |   | | | | |     | | |   | | |   | |             | | | |   |   |   |*******  | |
+-+ +-+-+ +-+-+ + +-+ + + +-+-+-+-+ +-+-+-+ + + +-+-+ + + + +-+-+-+-+ + +-+ +-+-+-+ +-+-+-+-+-+*+-+-+
|   | |         |     | |   |   |       |   | |   | | |   |   |     |       | |       | |   |  *|   |
+-+ + +-+-+-+ + +-+-+-+ +-+ + + +-+-+-+-+ +-+-+ +-+ + + + +-+-+ +-+-+ + +-+-+ +-+-+ +-+ + +-+-+*+ + +
|     |       | |         | | | |         | |           |   | |   |   |     | |  *********  | |*  | |
+ +-+ +-+ +-+-+ + + +-+-+-+ + +-+ +-+-+ +-+ + + +-+ + +-+ +-+ + +-+-+ +-+-+-+ + +*+ +-+ +*+-+ +*+-+-+
|   |   | |   |   |   |     | | | |       | | | | | |   |   | |     |     |     |*| |   |*******| | |
+-+-+-+-+-+-+ +-+-+ + + +-+-+ + + +-+ + +-+ + +-+ +-+ +-+ + + +-+ +-+-+ +-+-+-+ +*+-+-+-+-+-+ +-+ + +
| | |   |     |     |   |       |   | |     | |   |   |   | |     |     |       |*|   | | |       | |
+ + + +-+ + +-+-+ +-+-+ + +-+ +-+-+-+-+-+ +-+-+ +-+-+ +-+ +-+-+ + + +-+-+-+-+-+-+*+ +-+ + +-+ + +-+ +
| |   | | | |       |   | | | | | |         | | |   | | | | |   |       |     |***| |   |     |   | |
+ +-+ + +-+ +-+-+-+ + +-+ + + + + +-+ + + + + + + + +-+ +-+ + +-+-+ +-+ + + +-+*+-+ + +-+-+ + +-+-+ +
| | |       |   |   | |   | | |   |   | | | |   | | |     |   |     |     | | |***      |   |   |   |
+ + + + +-+ + + + +-+-+-+ + +-+-+ +-+-+-+-+ + + + +-+ +-+-+ + +-+ +-+-+-+ + + +-+*+-+-+ +-+-+-+ + +-+
|     | | | | |   |       |   |       |     | |       |   | |   | |   |   |   | |*  |     |       | |
+ + +-+-+ + + +-+ + +-+ +-+ + +-+ +-+-+ +-+ +-+-+-+ +-+-+ +-+ +-+-+ +-+ +-+ + + +*+-+-+ +-+ + +-+-+ +
| |   | |   | | | | |       |       |   | | |   |       | |   |       | |   |   |*    |   | | | |   |
+-+ +-+ +-+-+-+ + +-+ +-+ +-+-+-+ +-+-+ + + + +-+-+ +-+ + +-+ + +-+-+-+ +-+-+-+-+*+-+-+ +-+-+-+ + +-+
|         |   | | |     | |     |   | | |       | | |       |     |     |     | |*****| |   | |     |
+-+-+-+-+ +-+ + + +-+ + +-+-+ +-+-+-+ +-+ +-+ +-+ +-+-+ +-+ +-+ +-+-+-+-+ + +-+ + +-+*+-+ +-+ + + + +
|   |       |   |   | |   | |   | | | |   |     |       |     |         | |     | | |*|   |     | | |
+ + +-+ +-+ +-+ +-+ + +-+ + + +-+ + + +-+ + + +-+ +-+-+-+-+ +-+-+-+-+ +-+ +-+ + +-+ +*+ +-+ +-+-+ +-+
| |       |           |   |   |     |     | |   | | |       |     |   |   |   | |*****|     |   | | |
+-+-+ +-+-+-+ +-+ + + +-+-+ +-+-+-+ + +-+ + +-+-+ + +-+-+-+-+ +-+ + + + +-+-+-+-+*+-+ + +-+-+ +-+-+ +
|   | |         | | |       | |       |   | |     |   |   |   |   | |       |   |*| | |       |   | |
+ + + +-+-+-+ +-+ +-+-+ +-+ + +-+-+ +-+ +-+ + +-+ + +-+ +-+ +-+ +-+ + +-+ +-+-+ +*+ + + +-+-+ + +-+ +
| |     | | | |   |   | |       |   | | |   |   |     |     |     | |   |   |   |***|       |     | |
+-+-+ + + + +-+-+ +-+ +-+ +-+ +-+ +-+ +-+-+-+-+ +-+-+ +-+ +-+ +-+ +-+ + + + +-+ + +*+-+ +-+ +-+-+-+ +
|   | | |           |     | |   |   | | | |     |     |   |     |   | | | | | | | |*  |   |     |   |
+ +-+-+ +-+-+ +-+ + + + +-+ + +-+ +-+ + + + + +-+ +-+ +-+-+ + +-+-+-+ +-+-+-+ + +-+*+-+ +-+ +-+-+ + +
|       |   |   | | | |     |           | | |   | |       | | | |   | | |     | |***  |   | |     | |
+-+ +-+-+ + +-+-+ +-+ +-+-+-+-+ +-+ +-+-+ +-+-+ +-+-+-+ +-+-+ + +-+ +-+ +-+ + + +*+ +-+ + + +-+-+ +-+
|         | |       | |         |     |   |   | |   | |     |     | |   | | | |***| | | | | | |   | |
+ +-+-+-+ + + + + + +-+-+ +-+ + +-+ +-+ +-+-+ + + + + + +-+ +-+ +-+ +-+ + + + +*+ + + +-+ +-+ +-+ + +
|   |   | | | | | | | |   |   |   | |           | | | |   | | | | |         | |*| |     |   | |     |
+ +-+ +-+-+-+ +-+-+-+ + + +-+-+-+-+ +-+-+ + + +-+ + + +-+ +-+ + + + +-+ + +-+ +*+-+-+ + +-+-+ + +-+ +
| | |       |   | | | | |       | |       | | |   |   |   |   |   | |   | |   |*|   | |         |   |
+ + +-+-+-+ +-+ + + + +-+-+ +-+ + +-+ +-+ +-+ + +-+ +-+ + +-+ +-+ + +-+-+-+-+-+*+ + + + +-+-+ +-+-+-+
|   |   |   |   |         |   | |   | | | |     |     | |           | | | |    *| |   | |       |   |
+-+-+-+ +-+ + + + +-+-+-+ +-+-+-+ + + + +-+-+ +-+-+-+-+-+ +-+-+-+ +-+ + + + +-+*+-+-+ +-+-+-+-+ +-+ +
|             |     | | | | |   | |       |     | |         |   | | |   | | |  *****| |       |     |
+-+-+-+-+-+-+-+-+-+ + + + + +-+ +-+-+ + + + + +-+ +-+-+ +-+ + +-+-+ +-+ + + +-+ +-+*+-+-+-+ +-+ + +-+
| | |       | |     | |   |       |   | | | |         | |   |     |         | | |  *****|       |   |
+ + +-+-+ + + +-+ +-+ + +-+ +-+-+-+-+-+-+-+ +-+-+-+ +-+-+ + + +-+-+ +-+ +-+ + +-+-+ +-+*+-+-+ + +-+-+
| |       |       |     |     |     |   |   |         | | |   | | |   |   | |     | |  ***| | | |   |
+ + +-+-+-+-+-+ +-+ +-+-+ +-+-+-+ +-+ +-+-+-+ +-+ + +-+ +-+-+ + + +-+ +-+-+ + +-+-+ +-+ +*+ +-+-+ +-+
| | |           |   | |   | | |     |   |   | |   |         |     |     |         | | | |***********|
+ + + +-+ + +-+ +-+ + + +-+ + +-+ + + +-+ +-+-+-+-+ + +-+-+-+-+ +-+-+-+ +-+ +-+-+-+ + +-+ +-+-+-+ +*+
|   | |   |   |   |               | |               |     |     |         |   |         |       | |*|
+-+-+-+-+-+-+-+-+-+-+-+-+-+-+-+-+-+-+-+-+-+-+-+-+-+-+-+-+-+-+-+-+-+-+-+-+-+-+-+-+-+-+-+-+-+-+-+-+-+-+