+-+-+-+-+-+-+-+-+-+-+-+-+-+-+-+-+-+-+-+-+-+-+-+-+-+-+-+-+-+-+-+-+-+-+-+-+-+-+-+-+
|   |   | |   |   |   |       |       |         |     |       |         |     | |
+-+ +-+ + +-+ + + + +-+-+-+ +-+-+ +-+ +-+ +-+-+-+-+ + +-+-+-+ +-+ + +-+ +-+-+ + +
|   |         | | |   | |         | |       |   | | |     | |   | | |   |   |   |
+ +-+-+ +-+ +-+-+ +-+ + +-+-+-+-+ + +-+ +-+-+-+ + +-+-+-+ + +-+ +-+ +-+ + +-+ + +
|     | |     |   | | |   | |     |         |           |     |     |         | |
+-+ +-+ +-+-+ +-+ + + +-+ + + +-+-+ +-+-+ + + +-+ +-+-+ + +-+-+-+ + + + + +-+-+-+
|     |     | |   |       |   |   |     | |   |     | |   |       | | | | |     |
+ + +-+-+-+-+ + +-+-+-+-+ + +-+ + +-+ +-+-+-+-+ +-+-+ +-+-+ +-+-+-+ + +-+-+ +-+-+
| | |       |   |   |     |   | | | |     | |       | | | |   | |   |   |   |   |
+-+ + + +-+-+ +-+-+ +-+ +-+-+-+ +-+ +-+ +-+ +-+-+-+ + + + +-+-+ + +-+-+ + + + +-+
| |   | |       |         |     |     | |               | |   |   |   |   |     |
+ + + + + +-+ + +-+-+-+ + +-+ +-+-+ +-+ +-+-+-+ + + + + + + + + +-+ +-+ + + +-+-+
|   | | |   | |       | |   | |   |       |     | | | |   | | | |   |   | |     |
+-+-+-+ + +-+-+-+-+-+-+ +-+ + + +-+ +-+-+-+-+ +-+-+ +-+ +-+ +-+ +-+ +-+-+-+-+-+ +
|     |     | | | |       | |             |   | |   | |   | |     |     |     | |
+-+ + +-+-+ + + + +-+ +-+ +-+-+-+-+ + +-+ +-+-+ +-+-+ +-+-+ + +-+-+ + +-+ + +-+-+
|   | |     |   | | | |   | | |   | | |   |     |       |   |       | |   |   | |
+ +-+ + +-+-+ + + + +-+ +-+ + +-+ +-+ + +-+ +-+ +-+-+ +-+ +-+-+ + +-+ + +-+ + + +
| |     |     |       |         |     | |     |         |     | | |   | |   |   |
+ +-+-+ +-+-+-+-+-+ +-+-+-+ + +-+ +-+-+-+-+-+-+ +-+-+ + + +-+ + +-+-+ + +-+ + + +
| | | | |     |   | |   |   |   |   |   | | | | |     | | |         |     | | | |
+-+ + + + + + +-+ + + + +-+ +-+-+ + +-+ + + + +-+ + +-+-+-+-+ +-+-+ + +-+-+-+-+ +
|       | | |     |   |   |   |   | |             |     |     |   | |   |   |   |
+ + +-+ + +-+-+ + +-+-+ +-+-+ +-+ +-+ +-+ + +-+-+-+-+-+-+-+-+ +-+ +-+ +-+-+ +-+-+
| | | |     |   | |   |     | |   | | | | |   |   |     |           |   | |     |
+-+ + +-+ +-+-+-+-+-+ + +-+ + + +-+ +-+ + + +-+ +-+-+-+ +-+-+-+-+ +-+ + + +-+ +-+
|       | |       | |     |   | |   |     |   |   |     |       |   | | |   |   |
+ +-+-+-+ + +-+-+-+ +-+ +-+-+-+ + +-+-+ +-+-+-+-+ + +-+ + + + + + +-+-+ +-+ +-+ +
| |   |       | |   |   |   | |     |   | |     |   |   | | | |   |         |   |
+ +-+ + +-+-+-+ + +-+ + + + + + +-+-+ + + +-+ + +-+-+-+ + +-+-+ +-+-+-+ + + +-+ +
| | |   |     | |   | |   | |         |     | | |         |         | | | | |   |
+-+ +-+ +-+ +-+ +-+ + +-+-+-+-+ +-+-+ +-+ +-+-+ + +-+ +-+-+ +-+ +-+ + +-+ + + +-+
|             | |       |           | |   | |     |     |     | | |     | | | | |
+ + +-+ + +-+ + +-+ +-+-+-+-+-+ +-+-+-+-+-+ +-+ +-+ +-+ +-+-+ +-+ +-+ + + +-+ + +
| |   | | |           |                 |     | | | |   |   | | |   | | |       |
+ + +-+ +-+-+-+-+-+ +-+-+-+ + +-+ +-+-+-+ +-+ +-+ +-+ + + + +-+ +-+ + +-+-+-+-+ +
| | | | | |     |           | |   |     |   |   |   | | | | |             | |   |
+-+-+ +-+ + + + +-+-+-+ +-+ +-+-+ + +-+-+-+-+-+ +-+ + +-+ +-+-+-+ +-+-+ +-+ + + +
|   |       | | |   |   | |     |   |     |             |           | | | | | | |
+-+ +-+-+ + + + + + +-+ + +-+ + +-+ + +-+-+-+ + +-+ +-+-+-+-+-+-+ + + +-+ + +-+ +
| | |     | | | | |         | | | | |   |   | | | |   |   | |     | |   |   | | |
+ + +-+-+ +-+ +-+ + +-+-+-+ +-+-+ + + + + + +-+-+ +-+-+ +-+ +-+-+-+ + +-+ + + +-+
|       |   |   | | |   |   |   |     |   |   | | |       | |   | |   | | |     |
+-+ +-+ + +-+ +-+-+-+-+ + +-+ +-+ + + +-+-+ + + + +-+ + +-+ + +-+ + + + +-+-+-+ +
|   | | | |     | |           |   | | |   | |     |   |   | |       |   |   |   |
+-+ + +-+-+ +-+ + +-+-+ + +-+-+-+ +-+-+ + +-+-+ + + +-+-+ + +-+-+-+ + + +-+ +-+ +
|     |   |   |     |   |   | | | | |   |   |   | | | |   | |       | |         |
+ +-+-+ +-+ +-+-+-+-+-+ +-+ + + + + + +-+ +-+ +-+-+ + +-+-+ + +-+ +-+-+ +-+-+-+-+
|   | |               |   |     | |   | |     |       |     | |   | | | | | |   |
+ +-+ + +-+-+ + +-+ +-+ +-+-+-+ + +-+-+ +-+ +-+-+ +-+-+-+ +-+-+-+-+ + + + + +-+ +
| |     |   | | | |       | | | | |         | |     | |   | |       |       |   |
+ + +-+-+ +-+-+ + +-+ +-+-+ + + +-+-+ +-+-+-+ +-+ +-+ + +-+ + +-+ +-+ + + + +-+ +
|   |           |   |   |   |     |     | |   |     | | | |   |   | | | | |     |
+ +-+-+-+-+ +-+ +-+ + +-+-+ + +-+-+-+ + + + + +-+ + + + + +-+ + + + +-+-+ +-+ + +
|   | | |     | | | |   |     | |   | | |   | |   |   |   | | | |     |     | | |
+ +-+ + + +-+-+-+ + +-+-+ +-+-+ +-+ +-+ +-+ + +-+-+ +-+ +-+ + +-+-+-+ +-+-+-+ +-+
| |   |     |     |     | | |       | |     | | | |           |   | |         | |
+-+ +-+-+-+ +-+-+ + +-+ + + +-+-+-+ + +-+ + +-+ + +-+ + + +-+ +-+ + +-+-+ +-+ + +
|         |   |     |   |     |           | |   | |   | |   |   | |         |   |
+ + +-+ + + + + + +-+ + + +-+-+-+ + + +-+-+ + +-+ + +-+ +-+-+-+ + +-+ + + +-+-+ +
| |   | |   |   | |   | |     | | | |   | |   |     | | | |         | | | | |   |
+-+-+-+-+ + +-+-+ +-+-+ +-+-+ + +-+-+ +-+ +-+ +-+-+ + + + +-+ +-+-+-+ +-+-+ +-+ +
| |     | |   |   |     |         | | |       |       | |       | |   | |   |   |
+ + +-+-+-+-+ + +-+ +-+ +-+-+-+-+-+ +-+-+ +-+ +-+-+ +-+-+-+ + + + +-+ + +-+ +-+ +
|           | |   | | |   | | |       | |   |       |   |   | | | | | |       | |
+-+ +-+-+-+-+-+-+ + + + +-+ + +-+ + +-+ + +-+-+ +-+ + +-+-+-+-+-+ + +-+-+ +-+-+ +
| |     |       | | |   |         | | |       | | |   |         |           |   |
+ + + + + +-+ +-+-+ +-+ + +-+-+-+ +-+ + +-+-+ + + + +-+ + +-+ +-+ +-+ + +-+ + +-+
|   | |   | | | |     |   |     | |         | | | | |   |   |     |   |   | | | |
+-+ +-+ +-+ +-+ + +-+-+ +-+-+-+ + + +-+ +-+ +-+-+ +-+-+ +-+ +-+-+-+ +-+-+-+-+-+ +
| |   | | | | |   |   | |         | |   |   |   |   |     | |   |         |     |
+ + +-+-+ + + +-+ +-+ +-+-+ +-+ +-+-+ +-+ + + +-+ + +-+ +-+-+ + +-+-+ + +-+ +-+-+
|     | |       |         | |     |   |   |   | | |     |     |       |   |   | |
+ +-+ + +-+ +-+ +-+ + +-+-+-+ +-+ + +-+-+ +-+ + + +-+ +-+-+ +-+ + +-+-+-+ + + + +
|   | |   | |       | |   |   | | |   |   |   |   | | |   |   | | | |     | | | |
+-+-+ + +-+ +-+-+-+-+ +-+ +-+-+ + +-+-+ +-+ +-+-+ + + +-+ +-+-+-+-+ +-+-+ + + + +
|         |     |             | | |     |   |   | |         |   |           |   |
+ +-+-+-+ + + +-+ +-+ +-+-+-+-+ + + +-+-+-+ + + + + +-+ + + + + +-+-+ +-+ + +-+-+
| |         | |   |         |     | |         |   |   | | |   | |     |   |     |
+-+-+-+-+-+-+-+-+-+-+-+-+-+-+-+-+-+-+-+-+-+-+-+-+-+-+-+-+-+-+-+-+-+-+-+-+-+-+-+-+