+-+-+-+-+-+
|       |.|
+-+-+-+-+-+
|.|.|.|.|.|
+-+-+-+-+-+
|.|.|.|.|.|
+-+-+-+-+-+
|.|.|.|.|.|
+-+-+-+-+-+
|.|.|.|.|.|
+-+-+-+-+-+
|.|.|.|.|.|
+-+-+-+-+-+
|.|.|.|.|.|
+-+-+-+-+-+
|.|.|.|.|.|
+-+-+-+-+-+
|.|.|.|.|.|
+-+-+-+-+-+
|.|.|.|.|.|
+-+-+-+-+-+
|.|.|.|.|.|
+-+-+-+-+-+
|.|.|.|.|.|
+-+-+-+-+-+
|.|.|.|.|.|
+-+-+-+-+-+
|.|.|.|.|.|
+-+-+-+-+-+
|.|.|.|.|.|
+-+-+-+-+-+
|.|.|.|.|.|
+-+-+-+-+-+
|.|.|.|.|.|
+-+-+-+-+-+
|.|.|.|.|.|
+-+-+-+-+-+
|.|.|.|.|.|
+-+-+-+-+-+
|.|.|.|.|.|
+-+-+-+-+-+
|.|.|.|.|.|
+-+-+-+-+-+
|.|.|.|.|.|
+-+-+-+-+-+
|.|.|.|.|.|
+-+-+-+-+-+
|.|.|.|.|.|
+-+-+-+-+-+
|.|.|.|.|.|
+-+-+-+-+-+
|.|.|.|.|.|
+-+-+-+-+-+
|.|.|.|.|.|
+-+-+-+-+-+
|.|.|.|.|.|
+-+-+-+-+-+
|.|.|.|.|.|
+-+-+-+-+-+
|.|.|.|.|.|
+-+-+-+-+-+