+-+-+-+-+-+-+-+-+-+-+-+-+
|     |       |   |     |
+-+ +-+-+ +-+-+-+ + +-+ +
| | |     | | | | | |   |
+ + +-+-+ + + + + + + +-+
| |     | | |     | |   |
+ +-+ +-+ + +-+-+ +-+ + +
|       |     |       | |
+-+-+ +-+-+-+ +-+ +-+ +-+
|   |       |     |     |
+-+ +-+ +-+-+ +-+ +-+-+ +
| |         |   | | |   |
+ +-+ +-+ +-+ +-+-+ + +-+
|     |     | |     |   |
+-+-+ +-+-+ + +-+ +-+-+-+
|       |       |     | |
+ +-+ +-+-+ +-+-+ +-+ + +
|   | |   |     |   |   |
+ +-+-+ +-+-+ + + +-+ +-+
|   |       | |     |   |
+-+-+-+-+ +-+-+-+ +-+ +-+
| | |   |   |   | |     |
+ + + +-+-+ + +-+-+ + +-+
|                   |   |
+-+-+-+-+-+-+-+-+-+-+-+-+