+-+-+-+-+-+-+-+
|   | | | | | |
+ +-+ + + + + +
| |   |   | | |
+ +-+ + +-+ + +
|     |       |
+ + +-+-+ + +-+
| | |     | | |
+ + + + +-+ + +
| | | |   |   |
+-+ +-+ +-+ +-+
|     | |   | |
+ +-+-+-+ +-+ +
|             |
+-+-+-+-+-+-+-+