+-+-+-+-+-+-+-+-+-+-+-+-+-+-+-+-+-+-+-+-+-+-+-+-+-+-+-+-+-+-+-+-+-+-+-+-+-+-+-+-+-+-+-+-+-+-+-+-+-+-+
| |     |             |       |         |     |     |       | |             |   |       |           |
+ +-+ + +-+-+ +-+ +-+ +-+-+ + +-+ + +-+ + +-+ + + + + +-+-+ + + +-+-+ +-+-+ +-+ + +-+-+ + +-+-+-+ +-+
|     |     | |   | |       |   | |   | | | |   | | |     |   |     | | |       | |   | | |     |   |
+-+-+-+-+-+ +-+ +-+ +-+-+-+-+-+ +-+-+ +-+ + +-+-+ + + +-+ + +-+-+-+ + + + +-+-+-+ + + + + +-+-+ +-+ +
|         |   | |       |     |     |   |     | | | |   | | |       | |   |       | |   |     | |   |
+-+-+ + + +-+ + + + +-+ + +-+ +-+-+ + + +-+-+ + + + +-+-+ +-+ +-+-+-+ +-+-+ +-+-+-+ +-+-+-+-+ + + + +
|   | | | | |   | |   | | |   |   | | |     | | | |     |           |   |   |     |             | | |
+ + +-+ + + +-+-+ +-+ +-+ + + + + + +-+ +-+-+ + + +-+-+ +-+ +-+-+-+-+-+ + +-+-+ + +-+-+-+-+-+-+ + + +
| |     |   |     | |     | |   | |   |         | |   |   |   |       | |       | | |   |   |   | | |
+ +-+-+-+-+ + +-+-+ +-+-+-+ +-+ +-+-+ +-+-+-+-+-+ + + +-+ +-+-+ +-+-+ + +-+-+-+-+ + + + + + +-+-+ + +
|       | | |       |     | |   |   |             | |   |       |   | |       |   |   | | |       | |
+ +-+-+ + + +-+-+-+ + +-+ + +-+-+ + +-+-+-+-+-+-+-+ + +-+-+-+-+-+-+ + +-+ + +-+ +-+ +-+ + +-+-+-+-+ +
| |   | |       |   |   | |       |     |   |   |   | |             |   | | |   | |   | |   |     | |
+ +-+ + +-+-+-+-+ +-+ + + +-+-+-+-+ +-+-+ + + + + +-+ + +-+-+-+ +-+-+-+ + + + +-+ +-+ + +-+ +-+-+ + +
| |   |   |     | |   | |   |   |   |   | |   |   |   | |   | |         | | | |       | |   |   |   |
+ + +-+-+ + +-+ + +-+-+ +-+ + +-+ +-+ + + +-+-+-+-+ + + + + + +-+-+-+-+-+ + + +-+-+-+-+ + +-+ + + +-+
|   |   | | |   |     | |     |   |   |   |   |   | | |   | |     |     | | | |         |     | |   |
+-+-+ + + + + + +-+-+ + +-+-+-+ + + +-+-+-+ + + + + +-+-+-+ +-+ + + +-+ + + + + +-+-+-+ +-+-+-+ +-+ +
|     |   | | |   |   | |     | | |     |   |   | | |     | |   |   |   | | | | |     |   |   | |   |
+ + +-+-+-+ + +-+-+ +-+ + +-+ + +-+-+-+ + +-+-+-+ + + + +-+ + +-+-+-+ +-+-+ + + + +-+-+ +-+ + + + +-+
| | |   |   | |     |   |   | |   |     |       | |   |     | |   |   |     | | |   |   |   |   |   |
+ + + + + +-+ + +-+-+ + +-+ + +-+ + +-+-+ +-+-+ + +-+-+-+-+-+ + +-+ +-+ + + + + +-+ + +-+ +-+-+-+-+ +
| | | | | | |   |     | |   |   |   |   | |   | |         |   |       | | | | |   | | |   |         |
+ +-+ + + + +-+-+ +-+-+ + +-+ +-+-+-+ + +-+ + + +-+-+-+-+ + +-+ +-+-+ +-+ + + +-+ + + + +-+ +-+-+-+-+
| |   | | |         |   | | | |       |   | | |   |     | | |   |   |     | | |   |   | |     |     |
+ + +-+ + + +-+-+-+-+ +-+ + + + + +-+-+-+ + + +-+ +-+ + + + +-+-+ + +-+ +-+-+ + +-+-+ + +-+-+ +-+ + +
|   |   | | |       |   |   | | | |     |   |     |   | | | |     | |   |     |     | | |   |     | |
+-+-+ +-+ + + +-+-+ +-+ +-+ + + + + +-+ +-+-+-+-+-+ +-+-+ + + +-+-+ + +-+ +-+-+-+ + +-+ + + +-+-+-+ +
|     |   | |   |     |     | | |   |   |       |       | |     | | | |   |     | |   |   | | |   | |
+ +-+ + +-+-+-+ +-+-+ +-+ +-+ + +-+-+ +-+ +-+-+ +-+-+ + + +-+-+ + + +-+ +-+ +-+ +-+-+ +-+-+ + + + + +
| |   | |     |   | |   | |   | |   |   | |   |     | | |     |   |   |   |   |     | |     |   | | |
+ +-+-+ +-+ + +-+ + +-+ + + +-+ +-+ +-+ + +-+ +-+-+ +-+ +-+-+ +-+ +-+ +-+ +-+ +-+-+ + + +-+-+-+-+ + +
|     |     | |   |   | | |           | |     |   |   | |   | |   |     |   |   |     | |       | | |
+ +-+ +-+-+-+ + +-+ +-+ + +-+-+-+-+-+ + +-+ +-+ + +-+ + + + + +-+-+ +-+ +-+ +-+ + +-+-+ + +-+-+ + + +
| | | |   |   |   |   | | |   |       | |   |   |   | |   | |     | |     | |   |   |   |   |   | | |
+ + + + + + +-+ + +-+ + +-+ + +-+-+-+-+ + +-+ +-+-+ + + +-+ +-+-+ + +-+-+-+ + +-+-+ + +-+ + +-+ + + +
| | | | |   | | |   |       |           | | |   |     |   |         |         |     | | | |   |   | |
+ + + + +-+-+ + +-+ + +-+-+-+-+-+-+-+ +-+ + +-+ +-+-+-+-+ +-+-+-+-+-+ +-+-+-+-+-+-+-+ + + +-+ +-+ + +
| | |   |     | | | |   |   |       | |   |   | |     |   |   |             |   |   | | | | |   | | |
+ + +-+-+ +-+-+ + + +-+-+ + +-+ + + + + +-+-+ + + +-+ + +-+ + + +-+-+-+-+-+-+ + + + + + + + +-+ + + +
|       |   |   | |       |   | | | | |       |   |   | |   |   |   | |       |   |   | |   | | | | |
+-+-+-+ + + + +-+ +-+-+-+-+-+ + + +-+ + +-+-+-+-+ + +-+ + +-+-+-+ + + + +-+-+-+-+-+-+-+ +-+ + + +-+ +
|     | | |   |         |   | | |     | |       | | |   |     |   |   |   |         |       | |     |
+ +-+ + +-+ +-+-+ +-+ + +-+ + +-+-+-+-+ + +-+-+ +-+ + +-+-+-+ + +-+ +-+-+ + +-+-+-+ + +-+-+-+ +-+-+-+
|   | |   |     | |   |   | |       |   |   |       |   |   | |   | |     | |   | | |   |         | |
+-+ + +-+ +-+-+ + + +-+-+ + +-+-+-+ + +-+-+ +-+-+-+-+-+ + + + +-+ +-+ +-+-+ + + + + +-+ +-+-+ +-+ + +
|   |   |     | | | | |   |       |   |   | |         | | | |   |   |   |   | |   |     |     |   | |
+ +-+ +-+-+-+ + +-+ + + +-+ +-+ +-+-+-+-+ + + +-+-+-+ + + + +-+ + + +-+ + +-+ +-+-+-+-+-+ +-+-+ +-+ +
| |   |     | |   | |     | | |       |   |   |     | |   |   | | |   | |   |       |     |   | |   |
+ +-+ + +-+ + +-+ + +-+-+ + + +-+-+ + + +-+-+-+ + + + +-+-+-+ + + + + + +-+ +-+-+ + + +-+-+ + + + + +
|   | | | |   | | |   | | |   |   | | |       | | | | |     | | | | | | |         |   |     | | | | |
+ + +-+ + +-+-+ + +-+ + + +-+ + + + + + +-+ + +-+ +-+ + +-+ + + +-+ + + + +-+-+-+-+-+-+ + +-+-+ + + +
| |     |             |     |   | | | | | | |     |   | |   | | |   | | | |           | |     | | | |
+ +-+-+-+ +-+-+-+-+-+-+-+-+ + +-+-+ + + + + + +-+-+ +-+ + +-+-+ + +-+ + +-+ +-+-+-+-+ +-+-+-+ + + + +
| |     |     |   |       | | |     | |   | | |   |     |       | | | |       |     |   |   | |   | |
+ + +-+ +-+-+ + + + +-+-+ + +-+ +-+-+ +-+-+ +-+ + +-+ +-+-+-+ +-+ + + +-+-+-+-+ +-+ + + + + + +-+-+ +
| | |   |   | | | |   |   |     | |   |     |   |   | |     |   | |       |     |   | | | | |       |
+ +-+ + +-+ + +-+ +-+ +-+ +-+-+-+ + +-+ +-+ + +-+-+ +-+ +-+ +-+ + +-+-+-+-+ +-+-+ +-+ + + + +-+-+-+-+
|   | |     |   |   |   | |     |   |   | | |   |   |   | |   |   |         |   | |   |   | |       |
+-+ + +-+-+-+-+ + + +-+ + +-+ + + +-+ +-+ + +-+ + +-+ +-+ +-+ + +-+ +-+-+-+-+ +-+ + +-+-+-+ + +-+-+ +
| | |         | | | |   |   | |   |   | |   |   |     |       | |   |       |   | |   |   |   |   | |
+ + + +-+-+-+ + + + + +-+-+ + +-+-+-+ + + +-+ +-+-+-+ +-+-+ +-+-+ +-+ +-+ +-+ + + +-+ +-+ +-+-+ +-+ +
| | | |   | |   | | |   |   |         | | | | |     | |   |       |     |     |   | |   |     | |   |
+ + + + + + +-+-+-+ +-+ + +-+-+-+-+-+-+ + + + + +-+ + + + +-+ +-+-+-+-+ +-+-+-+-+-+ +-+ + +-+ + + +-+
| | |   |   |         | | |       |     | | |   |   | | | |   |       | |   |         | | | |   |   |
+ + +-+-+-+ +-+ +-+-+ + + + +-+-+ + + +-+ + +-+-+ +-+ + + + +-+ +-+-+ + + + +-+-+-+-+ + + + +-+ +-+ +
| | |     | |   |     | | | |   | | |         |   |   | | | |   |   | |   |   |     |     |   | | | |
+ + + +-+ + + + +-+-+-+ + + + +-+ +-+-+-+-+-+ + +-+ +-+ + + + +-+ +-+ +-+-+-+ + +-+ +-+-+-+ + + + + +
|   |   | |   | |       |   |     |   |     | |   | |   | | | |   |   |     |   | |   |     | |   | |
+ +-+ + + +-+-+-+ +-+-+-+-+-+ +-+-+ + + +-+ + +-+ +-+ +-+ + + + +-+ +-+ +-+ +-+-+ +-+ +-+ + +-+ +-+ +
| |   | |       |       |   |       |   |   | |   |     | | | | |   |   | |     |   |   | | |   |   |
+ + +-+ +-+-+-+ +-+-+ + +-+ +-+-+-+-+-+-+ +-+-+ +-+ +-+-+ + + + + +-+ +-+ +-+-+ + +-+-+ + + + +-+ + +
| |   | | |   | |   | |   |     |     | | |     |   | |   | |   |     |   |     | |     | | |   | | |
+ +-+ + + + + + + + +-+-+ + +-+ + + + + + +-+ + + +-+ + +-+ +-+ +-+-+-+ +-+ +-+-+ + +-+-+ + +-+ + +-+
| |   | |   | |   | |     | |   | | |   |   | | |     | |   | | |       |   |   |   |     |     |   |
+ +-+-+ +-+-+ +-+-+ + +-+-+ + +-+-+ +-+-+-+ + + +-+-+ + +-+ + + + +-+-+ + +-+ + + +-+-+-+-+-+-+ +-+ +
| |     |         |   |     | |   | |       | |   |   |   |   | | |   | |     | |         |   |   | |
+ + +-+-+ +-+-+-+ +-+-+-+ +-+ + + + + +-+-+-+ +-+-+ +-+-+ +-+-+ + + + +-+-+ +-+ +-+-+-+-+ + + +-+ + +
|   |     |               | | | |   |     |     |   |   | |       | |     |   |     |       |   | | |
+-+-+ +-+-+-+-+-+-+-+-+-+-+ + + +-+ +-+-+ + +-+ + +-+ + + + +-+-+-+ +-+-+ +-+-+ +-+ +-+-+-+-+-+ +-+ +
|                       |       |       | | | |   |   | |   |     | |   |     |   |     | |   |   | |
+ +-+-+-+-+-+-+-+-+-+-+ +-+-+-+-+-+-+ +-+ + + +-+-+ +-+ + +-+ +-+ + + +-+-+-+ + +-+-+-+ + + + +-+ + +
| |         |         | |       |   | |   | | |     | | | |   | | | |       | | |   |   |   |   |   |
+ +-+-+-+ + + + +-+-+-+ + +-+-+ + + +-+ +-+ + + +-+-+ + +-+ +-+ + + + +-+ + + +-+ + + +-+ +-+-+ +-+ +
|     |   | | |     |   |   | |   |     |   | | |     |   |   | |   |   | | | |   |   |   | |     | |
+-+-+ + +-+-+ +-+-+ + +-+-+ + +-+-+-+-+-+ +-+ + + +-+ +-+ +-+ + +-+-+-+ + + + + +-+-+-+ +-+ + + +-+ +
|     |     |     | |     | |           |   | | |   |     |   |   |     | | |   |     |     | | |   |
+ +-+-+ +-+ +-+ +-+ +-+-+ + +-+ +-+-+-+ +-+ + + +-+-+-+ +-+ +-+ + + +-+-+ + +-+-+ +-+-+-+-+ + + + +-+
|     |   |   | |       | | |   |     |   | | |   |   |     |   |   |     |     |         | | | | | |
+-+-+ +-+ +-+ + + +-+-+-+ + + +-+ +-+ + +-+ + +-+ + + +-+-+-+ +-+-+-+ +-+-+-+-+ + +-+ +-+ + + +-+ + +
|   | | |   |   |       |   |       | | |   |   |   | |   |     |     |       | | | | |   | |   | | |
+ + + + +-+ +-+-+-+-+-+ +-+-+ +-+-+-+ +-+ +-+-+ +-+-+ + + + +-+-+ +-+-+ +-+ +-+ + + + +-+ + +-+ + + +
| |   |               |     | |     | |           | |   | | |   |   |     |     |   |   | |   |   | |
+ +-+-+-+-+-+-+-+-+-+ + +-+ +-+ +-+ + + +-+-+-+-+ + +-+-+ + + + +-+ +-+-+ +-+-+-+-+ +-+ +-+-+ +-+-+ +
|   |   |         |   | | | |   | | |     |   | |       | | | |     |   |     |   |   | |   | |     |
+-+ + + + +-+-+-+ +-+-+ + + + +-+ + +-+-+-+ + + + +-+-+-+ + + +-+-+-+ + +-+ +-+ + +-+ + + + + + +-+ +
|   | |   |     |     | |   | |   |   |     | |   |   |   | | |     | |   | |   |     |   | |   |   |
+ +-+ +-+-+ + +-+-+-+ + + +-+ + +-+-+ + +-+-+ +-+-+ + + +-+ + + +-+ + +-+ +-+ +-+-+-+-+-+-+ +-+-+ +-+
|     |     |           |     |         |           |   |   |     |     |                 |         |
+-+-+-+-+-+-+-+-+-+-+-+-+-+-+-+-+-+-+-+-+-+-+-+-+-+-+-+-+-+-+-+-+-+-+-+-+-+-+-+-+-+-+-+-+-+-+-+-+-+-+