+-+-+-+-+-+-+-+
|             |
+ + + +-+-+ +-+
| | |     |   |
+ + + +-+-+ +-+
| | |     |   |
+ + + +-+-+-+ +
| | |       | |
+ +-+ +-+-+ + +
|   |     | | |
+ +-+ + +-+ +-+
|   | |   |   |
+ + + +-+ +-+ +
| | |   |   | |
+-+-+-+-+-+-+-+