+-+-+-+-+-+-+-+-+-+-+-+-+
|                       |
+ +-+ +-+-+ + + + + + + +
|   | |     | | | | | | |
+ + + +-+-+ + + +-+-+-+ +
| | | |     | |     |   |
+-+ +-+ + + + + +-+ + +-+
|     | | | | |   | |   |
+ + +-+ + +-+ + + + + + +
| |   | |   | | | | | | |
+ + +-+ +-+-+ +-+ + + + +
| |   | |       | | | | |
+ + + + + + + +-+-+ + + +
| | | | | | |     | | | |
+ + + + +-+ + + + + +-+ +
| | | |   | | | | | |   |
+ + +-+ + + + + + + +-+-+
| |   | | | | | | |     |
+-+ + +-+-+ + + + + + + +
|   |   |   | | | | | | |
+ +-+-+ + + + + + + + + +
|     | | | | | | | | | |
+-+ + +-+ +-+ + + + + +-+
|   | |     | | | | |   |
+-+-+-+-+-+-+-+-+-+-+-+-+