+-+-+-+-+-+
|         |
+-+-+-+-+ +
|       | |
+ +-+-+ + +
| |   |   |
+ +-+ +-+-+
|     |   |
+-+-+ +-+ +
|   |     |
+ + +-+-+ +
| |       |
+ +-+-+-+-+
| |.|.|.|.|
+ +-+-+-+-+
| |.|.|.|.|
+ +-+-+-+-+
|   |.|.|.|
+-+ +-+-+-+
|   |.|.|.|
+ +-+-+-+-+
| |.|.|.|.|
+ +-+-+-+-+
|     |   |
+-+-+ + + +
|   | | | |
+-+ + + + +
|   |   | |
+ +-+-+-+ +
|     |   |
+ + + + +-+
| | | |   |
+-+ +-+-+ +
|   |   | |
+ +-+ + + +
|   | |   |
+ + + +-+-+
| |   |   |
+ +-+-+ +-+
| |       |
+ + +-+-+ +
| | |     |
+ +-+ +-+ +
|   |   | |
+-+ + + +-+
|   | |   |
+ +-+-+-+ +
| |     | |
+ +-+ + + +
| |   | | |
+ + +-+ + +
|   |.|   |
+-+-+-+-+ +
|.|.|.|   |
+-+-+-+ +-+
|.|.|.|   |
+-+-+-+-+ +
|.|.|     |
+-+-+ +-+-+
|.|   |.|.|
+-+-+-+-+-+