+-+-+-+-+-+-+-+-+-+-+-+-+-+-+-+-+-+-+-+-+
|                                       |
+ + +-+-+ + +-+ + + +-+ + + + + +-+ + + +
| | |     | |   | |   | | | | |   | | | |
+ + +-+-+-+-+-+ + + +-+ + +-+ + +-+ +-+ +
| |           | | | |   |   | |   |   | |
+ +-+ + +-+ + + + +-+-+-+ + +-+-+ + + + +
| |   |   | | | |       | |     | | | | |
+ +-+ +-+ + + +-+-+ +-+-+-+ + + + + +-+ +
|   |   | | | |         |   | | | | |   |
+ + + + + + + +-+ +-+ + + + + +-+ +-+-+ +
| | | | | | |   | |   | | | | |   |     |
+ + +-+ + + + +-+ +-+ +-+-+ +-+ + + +-+ +
| | |   | | |   |   |   |   |   | |   | |
+ + +-+ + +-+ + +-+ + +-+ +-+-+ +-+-+-+ +
| | |   | |   |   | | |     |     |     |
+ + + + + + +-+-+-+ + + + + + +-+ + +-+ +
| | | | | |   |     | | | | |   | | |   |
+-+-+-+ + +-+ +-+ + + + + + + + + + +-+ +
|       |   |   | | | | | | | | | |   | |
+ + +-+ + + +-+ + + +-+-+ +-+-+ +-+-+-+ +
| | |   | |   | | |     | |         |   |
+ + +-+-+ +-+ + + + + + + +-+ +-+-+ +-+ +
| |     | |   | | | | | | |       |   | |
+ + + +-+-+-+ + +-+ + +-+ +-+ + + + + + +
| | |       | | |   | |   |   | | | | | |
+ +-+ +-+ +-+ +-+-+ + + + + + + + + + + +
|   | |   |       | | | | | | | | | | | |
+-+ +-+ + + + + +-+ + + + + + + + +-+ + +
|   |   | | | | |   | | | | | | |   | | |
+ + +-+-+ +-+ +-+ + +-+ + +-+-+ +-+-+ +-+
| | |       |   | | |   |   |   |       |
+ + + +-+ +-+ + + +-+ + + + +-+ +-+-+ + +
| | | |   |   | | |   | | | |       | | |
+ + + +-+-+ +-+ +-+-+ +-+-+ + +-+ +-+-+ +
| | | |       | |       |   | |     |   |
+-+ +-+-+ +-+-+ +-+-+-+ +-+ + +-+ + +-+ +
|     |       |       | |   | |   | |   |
+ + + + +-+ +-+ +-+ + +-+ + + + + + + + +
| | | | |   |   |   | |   | | | | | | | |
+-+-+-+-+-+-+-+-+-+-+-+-+-+-+-+-+-+-+-+-+