+-+-+-+-+-+-+-+-+-+-+-+-+-+-+-+-+-+-+-+-+-+-+-+
|                                             |
+ + + + + + + + +-+ + +-+-+ +-+ + + +-+ + +-+-+
| | | | | | | | |   | |     |   | | |   |     |
+ +-+ + + + + +-+ + + +-+ + +-+-+ + + + + + + +
| |   | | | |   | | | |   |   |   | | | | | | |
+ + +-+-+-+-+-+ + + + +-+ + + + +-+ +-+ + + + +
| |       |     | | |   | | | | |     | | | | |
+ + + + + + + +-+ + +-+-+-+ + + + + +-+-+ +-+ +
| | | | | | | |   |       | | | | |     | |   |
+ +-+ + + +-+ + + +-+ + +-+-+ +-+-+ +-+ +-+ + +
|   | | |   | | |   | |   |   |       |   | | |
+ + + + + +-+-+ +-+-+ + + + + +-+ + + +-+-+ + +
| | | | | |       |   | | | |   | | |     | | |
+ + +-+ + + +-+ + + + + +-+-+ + +-+ + +-+-+ + +
| |   | | | |   | | | |     | | |   |   |   | |
+ + + + + + + + + +-+-+-+ +-+ + + + + + +-+ +-+
| | | | | | | | |       |   | | | | | | |     |
+ + +-+-+ + + + +-+-+ + + +-+-+ + + + + +-+ +-+
| |     | | | | |     | |     | | | | |   |   |
+-+ +-+ +-+ + + + +-+ +-+ + + + + + +-+-+ + + +
|   |   |   | | | |     | | | | | |     | | | |
+ + + + +-+-+ + + +-+ + + + +-+ +-+ +-+ + +-+ +
| | | | |     | | |   | | |   | |   |   |   | |
+ + +-+ +-+ + +-+ +-+ + + + + + + + + + + +-+ +
| |   | |   |   | |   | | | | | | | | | |   | |
+ + + + + +-+ + +-+ +-+ + + + + +-+ +-+ + +-+ +
| | | | |   | |   |   | | | | |   | |   |   | |
+ + + +-+ + + + +-+ + + + + + + + + + + + + + +
| | | |   | | |   | | | | | | | | | | | | | | |
+-+ + + +-+ +-+ + +-+ + +-+ + + +-+-+ +-+ + + +
|   | | |     | |   | | |   | |     |   | | | |
+-+ + + + + +-+-+-+-+-+ + + + +-+-+ + + + + +-+
|   | | | |         |   | | |     | | | | |   |
+ +-+-+-+-+ + + +-+-+-+ + +-+ + + +-+ +-+-+-+ +
|         | | | |       |   | | | |   |       |
+ + + +-+ +-+ +-+-+ + + + + +-+-+ +-+ +-+ + + +
| | | |     |     | | | | | |     |     | | | |
+ + + + +-+ + + + + + + + + + + + +-+ + + + + +
| | | | |   | | | | | | | | | | | |   | | | | |
+ +-+ + +-+ + +-+ + +-+ +-+-+ +-+-+ + + +-+-+ +
|   | |   | |   | |   |     |   |   | |     | |
+ + + + + +-+ + + + +-+-+ + + + + + +-+ +-+ +-+
| | | | |   | | | | |     | | | | | |     |   |
+ + + +-+ + +-+ + +-+ + + +-+ +-+ + + + + + +-+
| | | |   |   | | |   | |   |   | | | | | |   |
+-+-+-+-+-+-+-+-+-+-+-+-+-+-+-+-+-+-+-+-+-+-+-+