+-+-+-+-+-+-+-+-+-+-+-+-+-+-+-+-+-+-+-+-+-+-+-+-+-+-+-+-+-+-+-+-+-+-+-+-+-+-+-+-+-+-+-+-+-+-+-+-+
|   | | |   | |         |           |     |   |     |   | |       |   | | | |     |   |     | | |
+ +-+ + + +-+ +-+ + +-+-+ +-+ +-+-+ + +-+-+ + + +-+-+ +-+ + +-+-+-+-+ + + + +-+-+ +-+ +-+ +-+ + +
|   | |     |   | | |       |   |     |     |   |     |     |   |       |     |       |   | |   |
+ +-+ +-+ + +-+ + +-+-+ + +-+-+ +-+-+ + +-+-+ + +-+ + + + +-+ + + +-+-+ + +-+-+ +-+-+ + +-+ + +-+
|     |   |   |       | | |   | |     | | | | |     |   | |   | |   | |   |     | |     | | | | |
+-+-+ + + +-+-+ +-+-+-+-+-+ +-+ +-+ + +-+ + + + + + +-+-+-+-+ +-+-+-+ +-+ + +-+ + +-+-+ + + + + +
| |   | |     |     |     | |   |   | | |     | | | |     |       |   | | |   | |     | |       |
+ + + + +-+-+ + +-+-+-+ + + +-+ +-+ +-+ + +-+-+ +-+-+ + +-+-+ + +-+-+ + + +-+ + + + +-+ +-+-+ +-+
|   |     |   |         | | |     | | |       | | | | | |     |         |   | |   | |         | |
+-+ + +-+-+ + + +-+-+-+-+ + + +-+-+ + + + +-+-+-+ + +-+ +-+ + +-+-+-+ +-+-+ + +-+-+-+-+-+ +-+-+ +
|   | | |   | | |       |     |   |   | |   |       | |     | |     |     |     | |     |       |
+ + +-+ + +-+ +-+-+-+-+ +-+ + + + + +-+ + + +-+ + + + + + + + + +-+ + +-+ +-+ + + +-+ +-+-+-+ +-+
| | |   | | |   | | |   |   | | | |     | |   | | | | | | | | |   |   |   |   | |         | |   |
+ +-+-+ + + +-+ + + + + +-+ + +-+ +-+-+-+-+-+-+-+ + + + +-+ +-+ +-+-+-+-+-+-+ +-+-+-+ + +-+ +-+-+
|   |     |       | | | |   |   | |   |   |       | |   |   | | | |     |   | | |     |     | | |
+-+ +-+-+-+ +-+ +-+ + +-+ + +-+-+ +-+ + +-+-+ +-+-+ +-+-+-+ + +-+ + +-+ +-+ + + + +-+ +-+ +-+ + +
|   | | | | |   | | | | | |     |   | |   |   | | | |   | |     |   | | |   |     |     |   |   |
+-+-+ + + +-+-+ + + + + + +-+-+ +-+ + +-+ +-+-+ + + + +-+ + + + + +-+ + + + + + +-+-+-+-+ +-+ +-+
| |         |         |   | |     |         | |         |   | |     |   | | | | |   |   |       |
+ + + +-+ +-+-+-+ +-+-+-+ + + +-+-+-+ +-+ +-+ + +-+-+-+-+ +-+-+-+-+-+-+-+ + + +-+ +-+ + + +-+ +-+
| | | |   |   |         | |       |     | |   | | | |       | |   |       |       |   |   | | | |
+ +-+-+ +-+ +-+-+-+ +-+-+ +-+-+ +-+-+-+-+ + + + + + + +-+ +-+ +-+ +-+-+-+ +-+ +-+-+-+ +-+ + +-+ +
| |   | | |     |   | | |   |   | |         |       |   |         |       |   |         |       |
+ + +-+ + + +-+-+ +-+ + + +-+ + + +-+ +-+-+-+ + +-+ + +-+ +-+-+-+ +-+ + +-+-+ + + + +-+-+ +-+-+ +
|         |   | |     |   | | |   |   |   | | | | |   | | |   |   |   | | |   | | | | |     |   |
+-+-+ +-+ + +-+ +-+ +-+-+-+ + +-+ +-+ +-+ + + +-+ + + + + +-+ +-+ + + +-+ + +-+ +-+ + +-+ +-+-+-+
|   | | |           |   |     |         |   |     | |   | |   |   | |   |     |   |   |         |
+ + +-+ + +-+ +-+ + + +-+-+ + + +-+-+ +-+ +-+ +-+ +-+ + +-+-+ +-+-+-+-+-+ + +-+-+-+-+-+-+ + +-+ +
| |       |   |   |   |     | |     | |     | |   |   |     | |   | |   | |         |   | |   | |
+-+ +-+ +-+ + +-+-+-+ +-+-+ + +-+-+ +-+ +-+-+ + + +-+-+-+-+ + + +-+ +-+ +-+-+-+-+-+-+ + + + +-+ +
| | | | |   | |   |   | |   |   | | |   |     | |         | | |     |       | |     | |   | | | |
+ + + + + + + + +-+ +-+ + + + +-+ + +-+ + +-+-+-+-+-+-+ + +-+ + + +-+ +-+-+ + + + + + +-+-+-+ + +
|   |   | | | |         | | | | | | | |       |       | | |     | | | | |   | | | |         | | |
+-+-+-+ + +-+-+-+ +-+ +-+-+-+ + + +-+ +-+-+-+ +-+ + +-+-+-+ +-+-+-+ +-+ + +-+ +-+-+-+ +-+-+ + +-+
|     | | |   |   | |   |   |     |   | |       | |       |             |         |   |   |     |
+ + +-+ +-+ +-+-+ + + +-+-+ +-+-+ + + + + +-+ +-+-+-+ +-+-+ + +-+-+-+-+ + + +-+-+-+ +-+ +-+ +-+-+
| | | |   | |   |   | | |     |   | | | |   |   |       |   |         | | | |   |     |   | |   |
+-+ + + +-+ +-+ +-+ + + + + + +-+ +-+ + + +-+-+ +-+ +-+ + +-+ +-+ + +-+-+ +-+-+ + +-+-+ + + +-+ +
|   |     |   | |   |     | | | |   |     |   |     |     |     | | |     | | | |     | |     | |
+-+ +-+-+ + +-+ +-+-+-+-+ + + + + +-+-+ +-+-+ +-+-+-+ +-+-+-+-+ +-+ + +-+ + + + +-+ +-+-+-+-+ + +
|   | |   |     |         | |       |     |         |   | |   | |     |       |           | |   |
+-+ + + +-+-+ + + +-+-+-+-+ + + +-+-+-+ +-+ +-+ +-+-+-+ + + +-+-+-+-+-+-+ + +-+ +-+ +-+-+-+ +-+-+
| |       |   | |         | | |   |     |   |     |   |           |       | |   | |   |         |
+ +-+-+ +-+-+ + + + + +-+ +-+ +-+ +-+-+-+-+-+-+-+ +-+ + +-+-+ +-+-+ +-+-+ + +-+ + + +-+ +-+-+ +-+
|     | |   | | | | | |   | |   | |       |   |   |   | |     |   |   |   | |   | |     |     | |
+ +-+ +-+ +-+-+ +-+-+-+-+ + +-+ +-+ +-+-+ +-+ +-+ + +-+-+ +-+ + +-+ +-+ + +-+ + + +-+-+ +-+-+ + +
|   |     |               | | | | | |     |         | |   |       | |   | | | | |   | |   |     |
+ +-+-+ +-+-+ +-+-+-+-+-+ + + + + + + + +-+-+ +-+-+-+ +-+-+-+-+-+ +-+ +-+-+ + +-+-+ + +-+ + +-+ +
| |   |         |       | |     | | | |   |   | | | |     |     |   |     | | | | |   |   | |   |
+-+-+ + + +-+ +-+-+-+ +-+-+ +-+ + + +-+-+-+-+ + + + + +-+-+-+-+ +-+ +-+ +-+ +-+ + + +-+ +-+-+-+-+
|     | |   |       |     | |     |   |         |   |       |       |     |     | |   | | | |   |
+-+ +-+ +-+-+ + +-+-+ +-+ +-+-+ + +-+ +-+ +-+ +-+ + + +-+ +-+-+-+ +-+ +-+ + + +-+ +-+ + + + +-+ +
|   |   |     |     | | |       | |   |   |       |     |       |   | | | | |   |       | | |   |
+-+ + +-+-+ +-+ + +-+-+ +-+-+-+ + +-+ + +-+-+-+ +-+-+-+ +-+-+ + +-+-+ + + + + +-+ +-+ +-+ + +-+ +
| |   |     |   |     |   | |   | |   | | | | |     |   |   | |   |   |   | |   |   | |   | | | |
+ +-+ +-+-+ +-+-+-+ +-+ + + +-+ + + + +-+ + + + + + +-+-+-+ + +-+ +-+ + + + +-+-+-+ +-+ +-+ + + +
|   |   | |     |   |   | |   | |   | |   | |   | | | |       | | |   | | |                   | |
+ + + +-+ +-+-+-+ + +-+ +-+ +-+-+-+-+-+-+ + + + +-+-+ + +-+ +-+ +-+-+ + +-+-+ + + + + +-+-+ + + +
| | |     | |   | |   |   |         |     |   | |   |     | | |   |   |   |   | | | |   |   |   |
+ + + +-+ + + + +-+-+-+ + +-+ +-+ + +-+ + +-+ + + +-+-+-+-+ + + +-+ +-+-+ +-+-+-+ +-+ + + +-+-+ +
| |   |   |   | |     | | |   | | | | | |     | | |     |       | | |     |     | |   | |     | |
+-+-+ +-+ + +-+-+ +-+-+ +-+-+-+ +-+ + +-+ + +-+ + + + +-+-+ + +-+ + +-+-+-+-+ + + +-+-+ +-+-+-+ +
| |     |           |       | |     | |   |   |     |   | | |     |   | |   | | |     | | | |   |
+ + +-+ +-+ +-+-+-+ + + + +-+ +-+ + + +-+-+ +-+-+ +-+-+-+ +-+-+-+ + +-+ +-+ +-+ +-+ +-+-+ + +-+ +
| | |     | | |     | | | | | | | | |       |     |     | |     | | | | |       |         |     |
+ +-+ +-+-+-+ + +-+-+ +-+ + + + + +-+-+ + +-+ + + +-+-+ + +-+ +-+ + + + +-+-+-+ +-+ +-+-+-+ +-+ +
|     |   |   |       | |     |     |   | |   | | | | | |     |       | |       | | |     |   | |
+-+-+-+-+ + + + +-+-+-+ + + +-+ +-+-+ +-+ +-+-+ +-+ + + +-+-+ + +-+ +-+ + +-+ +-+ + + +-+ + +-+ +
| | |       |     |   |   |     | | | |   | | |   |   |     |     |     |   |   |       | |   | |
+ + +-+ +-+-+-+ +-+-+ + +-+-+-+-+ + +-+-+ + + +-+-+ +-+-+-+ + +-+-+-+-+ + + +-+-+ +-+-+ +-+ + +-+
|     |     |   |     |         |     | | | | | |     |       |   |   |   |   |   |   | | | | | |
+-+ +-+ +-+-+-+ +-+ +-+-+-+-+ +-+ +-+ + +-+ + + +-+-+ + +-+ + + +-+ + + + +-+ +-+ +-+ + + +-+-+ +
|   | |     |       |     |   | |   |           |   |   | | |   | | |   |   | |       |         |
+-+ + +-+-+ +-+ + + +-+ +-+ + + + +-+-+ +-+-+-+ + + + +-+ + +-+ + +-+-+ +-+ + + +-+-+ + +-+ +-+-+
|         |   | | |       | | | |   |       |     |     | |   |   |   |   | | |   | | | | |     |
+-+-+-+ + + +-+-+ + +-+-+-+ + + + + + +-+-+ + +-+ + +-+-+ +-+-+ + + +-+ + +-+-+-+ + + +-+ +-+ +-+
| |   | |   |   | | |   |   | |   | | |   | | |   | |     |   | | |     | |   | | |   |   |     |
+ + +-+ +-+ + + +-+-+-+ +-+-+-+ + + +-+-+ +-+ + +-+ + +-+-+-+ +-+ +-+-+ +-+ +-+ + +-+-+ +-+ + +-+
|   |   | |   | | |     |   |   | | |   | |   |   | |   | |         | |       |   |   |   | | | |
+-+ +-+ + +-+-+ + +-+ +-+ +-+-+-+-+-+-+ + + +-+ + +-+-+ + +-+-+-+ + + +-+ +-+ +-+ + +-+ + +-+-+ +
|   |   | |     |     | | | | | |   |   |   |   |   |   |   | |   | | |   |       | | | |       |
+-+ + + + +-+ +-+ + +-+ + + + + +-+ + + +-+-+-+ +-+-+-+ + +-+ + + +-+ +-+ +-+-+-+ + + + + +-+ +-+
|   | |     | |   |   |       | |     | |   | |           | | | | | |       |         | |   |   |
+ +-+ +-+-+ +-+ +-+-+-+-+-+-+ + + +-+ +-+-+ + +-+ +-+ +-+ + + +-+ + + +-+-+ +-+-+-+ +-+ +-+ +-+-+
|     |   | | |     | | |   |   | |       |       |   |   | |       |   | |   | |   |   |   |   |
+-+ +-+-+ +-+ + +-+ + + + +-+ + +-+-+-+-+ +-+ +-+ + +-+-+ + +-+-+ + +-+ + + + + + + +-+-+ +-+ +-+
| |   |     |   |       |     |   |     |     | | |   | | | |   | | | | |   | | | |         |   |
+ +-+ + +-+ +-+ + +-+-+ + + + +-+-+-+-+ +-+ +-+ +-+-+ + +-+ +-+ +-+ + + +-+-+ + +-+-+-+ +-+ +-+ +
| |   |   | | | | |   |   | | |   |           |       |     |         | | |   |     | |   | |   |
+ + + +-+-+ + + +-+-+ +-+-+ +-+-+ +-+-+-+ +-+ +-+ +-+-+ + +-+-+ +-+-+ +-+ +-+ +-+ + + +-+-+ + +-+
|   |         | |     |     |     |   |   | | |       | |     |   |     |         |   | |       |
+ +-+-+ + +-+ + +-+ + +-+ +-+-+ + + + +-+-+ +-+ +-+ + +-+-+ +-+-+ +-+-+-+ + + + + +-+-+ +-+ + +-+
|   |   |   |       |   | |     |   |   |     | | | |   |     | | |   | | | | | | |         |   |
+-+ +-+ +-+ +-+ +-+-+ +-+ + + + + +-+-+ +-+ +-+-+ + +-+ + +-+-+ + +-+ + + + +-+-+ +-+-+-+-+ + +-+
|     | |   |   |     |     | | |   |   |           |     |         |     |     |     |     |   |
+-+-+-+-+-+-+-+-+-+-+-+-+-+-+-+-+-+-+-+-+-+-+-+-+-+-+-+-+-+-+-+-+-+-+-+-+-+-+-+-+-+-+-+-+-+-+-+-+